5,3,2013,23,1,3,19,3,197,24,73,0.329,6,22,0.273,18,51,0.353,0.37,11,14,0.786,10,31,41,10,3,1,11,23
13,1,1985,22,1,3,10,1,143,4,13,0.308,0,0,-1,4,13,0.308,0.308,3,8,0.375,8,18,26,10,5,4,3,39
18,1,1990,24,1,3,82,49,1889,286,564,0.507,9,30,0.3,277,534,0.519,0.515,146,203,0.719,69,182,251,145,76,36,152,280
18,2,1991,25,1,3,62,56,1611,244,464,0.526,6,24,0.25,238,440,0.541,0.532,82,117,0.701,51,150,201,108,57,29,105,203
18,3,1992,26,1,3,81,81,2283,433,830,0.522,39,103,0.379,394,727,0.542,0.545,113,146,0.774,86,212,298,137,81,46,122,236
18,4,1993,27,1,3,82,81,2729,554,1083,0.512,37,106,0.349,517,977,0.529,0.529,237,300,0.79,123,259,382,214,129,45,175,242
18,5,1994,28,1,3,82,64,2322,382,800,0.478,38,106,0.358,344,694,0.496,0.501,151,189,0.799,104,225,329,171,83,27,146,235
18,6,1995,29,1,3,31,7,507,83,195,0.426,11,43,0.256,72,152,0.474,0.454,43,48,0.896,25,40,65,47,19,10,39,64
18,6,1995,29,1,3,36,0,605,98,198,0.495,11,32,0.344,87,166,0.524,0.523,32,42,0.762,25,40,65,30,24,6,42,79
18,6,1995,29,1,3,67,7,1112,181,393,0.461,22,75,0.293,159,318,0.5,0.489,75,90,0.833,50,80,130,77,43,16,81,143
18,7,1996,30,1,3,82,82,2773,401,956,0.419,84,245,0.343,317,711,0.446,0.463,157,208,0.755,98,248,346,212,118,46,170,243
18,8,1997,31,1,3,61,12,1439,182,458,0.397,25,89,0.281,157,369,0.425,0.425,89,109,0.817,49,140,189,114,38,20,81,135
18,10,1999,33,1,3,24,0,283,32,72,0.444,4,10,0.4,28,62,0.452,0.472,9,13,0.692,7,26,33,30,17,5,21,23
34,1,1991,27,1,3,30,0,624,77,152,0.507,3,8,0.375,74,144,0.514,0.516,74,87,0.851,46,63,109,44,19,10,27,83
34,1,1991,27,1,3,33,0,644,79,159,0.497,4,10,0.4,75,149,0.503,0.509,75,89,0.843,46,64,110,45,19,10,30,85
34,3,1993,29,1,3,82,7,1757,240,524,0.458,45,129,0.349,195,395,0.494,0.501,183,214,0.855,59,157,216,177,74,20,89,145
34,4,1994,30,1,3,67,8,1606,208,466,0.446,56,167,0.335,152,299,0.508,0.506,154,179,0.86,28,153,181,208,50,8,109,124
34,5,1995,31,1,3,81,13,1896,243,487,0.499,80,201,0.398,163,286,0.57,0.581,144,171,0.842,50,146,196,189,65,12,104,158
34,6,1996,32,1,3,45,16,1385,180,357,0.504,41,127,0.323,139,230,0.604,0.562,98,115,0.852,47,108,155,138,45,11,59,93
34,7,1997,33,1,3,78,77,2687,291,585,0.497,120,286,0.42,171,299,0.572,0.6,207,231,0.896,60,175,235,310,92,12,135,200
34,8,1998,34,1,3,73,59,1988,206,456,0.452,55,189,0.291,151,267,0.566,0.512,145,174,0.833,39,117,156,221,81,8,100,115
34,10,2000,36,1,3,79,79,2217,195,457,0.427,74,186,0.398,121,271,0.446,0.508,126,149,0.846,48,201,249,193,73,9,130,156
36,1,1990,21,1,3,81,69,2032,311,647,0.481,1,9,0.111,310,638,0.486,0.481,187,216,0.866,127,170,297,154,45,14,112,172
36,2,1991,22,1,3,82,82,3044,478,976,0.49,20,64,0.313,458,912,0.502,0.5,325,402,0.808,142,314,456,238,69,33,147,190
36,3,1992,23,1,3,82,82,3120,514,1040,0.494,25,82,0.305,489,958,0.51,0.506,285,331,0.861,143,296,439,214,84,29,152,149
36,4,1993,24,1,3,70,70,2604,451,918,0.491,37,104,0.356,414,814,0.509,0.511,268,337,0.795,85,237,322,265,68,28,152,132
36,5,1994,25,1,3,73,73,2409,360,791,0.455,26,87,0.299,334,704,0.474,0.472,139,173,0.803,68,195,263,197,54,27,129,174
36,6,1995,26,1,3,81,81,2858,502,1072,0.468,136,333,0.408,366,739,0.495,0.532,326,404,0.807,63,224,287,206,78,38,151,216
36,7,1996,27,1,3,77,77,2901,525,1127,0.466,161,392,0.411,364,735,0.495,0.537,326,423,0.771,69,327,396,211,69,33,198,178
36,8,1997,28,1,3,39,39,1393,196,464,0.422,42,126,0.333,154,338,0.456,0.468,148,196,0.755,48,142,190,124,24,24,89,105
36,9,1998,29,1,3,36,36,1012,122,303,0.403,34,90,0.378,88,213,0.413,0.459,56,78,0.718,16,108,124,62,24,14,57,92
36,10,1999,30,1,3,50,50,1509,208,507,0.41,39,119,0.328,169,388,0.436,0.449,106,140,0.757,35,178,213,117,26,17,71,104
36,11,2000,31,1,3,19,19,391,38,106,0.358,13,37,0.351,25,69,0.362,0.42,25,32,0.781,6,41,47,28,12,2,19,34
36,12,2001,32,1,3,52,34,1229,147,339,0.434,55,129,0.426,92,210,0.438,0.515,60,84,0.714,17,153,170,81,23,25,51,80
40,3,1996,25,1,3,45,28,1269,189,432,0.438,4,22,0.182,185,410,0.451,0.442,89,148,0.601,93,229,322,74,36,33,83,163
40,5,1998,27,1,3,76,71,2575,410,1007,0.407,57,201,0.284,353,806,0.438,0.435,206,256,0.805,146,398,544,213,65,49,173,226
40,9,2002,31,1,3,66,14,1684,189,452,0.418,38,124,0.306,151,328,0.46,0.46,53,84,0.631,107,180,287,56,30,37,73,196
42,1,1984,23,1,3,67,2,1059,225,493,0.456,12,29,0.414,213,464,0.459,0.469,87,121,0.719,106,144,250,56,41,9,78,118
42,2,1985,24,1,3,72,4,1314,274,603,0.454,42,109,0.385,232,494,0.47,0.489,77,104,0.74,100,138,238,56,46,7,58,131
42,3,1986,25,1,3,72,1,1086,193,470,0.411,63,173,0.364,130,297,0.438,0.478,59,82,0.72,86,82,168,37,40,9,38,78
42,9,1992,31,1,3,81,11,2191,485,1034,0.469,138,329,0.419,347,705,0.492,0.536,164,212,0.774,92,161,253,104,57,18,119,151
42,11,1994,33,1,3,77,75,2590,478,967,0.494,131,332,0.395,347,635,0.546,0.562,83,107,0.776,70,185,255,80,66,11,75,141
42,12,1995,34,1,3,81,3,1996,351,774,0.453,106,263,0.403,245,511,0.479,0.522,110,127,0.866,56,166,222,57,37,9,81,142
42,13,1996,35,1,3,81,52,2626,459,959,0.479,150,364,0.412,309,595,0.519,0.557,136,179,0.76,88,227,315,139,57,7,98,191
42,14,1997,36,1,3,82,51,2940,477,1151,0.414,192,528,0.364,285,623,0.457,0.498,215,263,0.817,99,194,293,165,60,7,146,178
42,15,1998,37,1,3,79,0,1939,348,700,0.497,127,274,0.464,221,426,0.519,0.588,111,142,0.782,51,133,184,89,60,5,74,128
42,16,1999,38,1,3,48,5,1232,174,395,0.441,94,217,0.433,80,178,0.449,0.559,53,70,0.757,25,90,115,38,25,3,45,77
57,1,1980,26,1,3,24,-1,875,207,427,0.485,2,3,0.667,205,424,0.483,0.487,96,126,0.762,102,123,225,82,28,29,90,78
57,1,1980,26,1,3,54,-1,1526,346,686,0.504,0,3,0,346,683,0.507,0.504,114,140,0.814,167,213,380,142,45,33,124,128
57,1,1980,26,1,3,78,-1,2401,553,1113,0.497,2,6,0.333,551,1107,0.498,0.498,210,266,0.789,269,336,605,224,73,62,214,206
57,2,1981,27,1,3,81,-1,3093,768,1555,0.494,3,5,0.6,765,1550,0.494,0.495,390,459,0.85,273,373,646,290,106,100,241,255
57,3,1982,28,1,3,82,82,3015,855,1553,0.551,0,8,0,855,1545,0.553,0.551,372,443,0.84,210,348,558,433,87,120,261,261
57,4,1983,29,1,3,82,82,2988,959,1857,0.516,2,12,0.167,957,1845,0.519,0.517,406,490,0.829,263,338,601,397,116,126,263,235
57,5,1984,30,1,3,82,77,2870,907,1714,0.529,1,7,0.143,906,1707,0.531,0.529,352,427,0.824,216,248,464,406,83,95,222,252
57,6,1985,31,1,3,81,81,2924,939,1812,0.518,1,5,0.2,938,1807,0.519,0.518,383,462,0.829,203,255,458,344,101,46,251,259
57,7,1986,32,1,3,81,81,3024,951,1888,0.504,1,5,0.2,950,1883,0.505,0.504,511,593,0.862,192,213,405,320,73,29,249,235
57,8,1987,33,1,3,82,82,3085,965,1920,0.503,4,15,0.267,961,1905,0.504,0.504,411,487,0.844,146,198,344,422,73,21,214,216
57,9,1988,34,1,3,80,80,2818,843,1704,0.495,0,6,0,843,1698,0.496,0.495,314,379,0.828,166,207,373,377,70,23,181,193
57,10,1989,35,1,3,82,82,2990,924,1881,0.491,2,8,0.25,922,1873,0.492,0.492,325,379,0.858,148,178,326,383,66,12,198,174
57,11,1990,36,1,3,80,80,2211,635,1293,0.491,2,5,0.4,633,1288,0.491,0.492,161,183,0.88,119,167,286,225,51,23,93,130
57,12,1991,37,1,3,79,26,1748,322,734,0.439,0,1,0,322,733,0.439,0.439,119,140,0.85,108,146,254,105,40,25,101,141
64,1,1980,29,1,3,78,-1,2812,838,1614,0.519,4,20,0.2,834,1594,0.523,0.52,420,534,0.787,215,361,576,355,170,140,284,208
64,2,1981,30,1,3,82,-1,2874,794,1524,0.521,4,18,0.222,790,1506,0.525,0.522,422,536,0.787,244,413,657,364,173,147,266,233
64,3,1982,31,1,3,81,81,2789,780,1428,0.546,3,11,0.273,777,1417,0.548,0.547,411,539,0.763,220,337,557,319,161,141,214,229
64,4,1983,32,1,3,72,72,2421,605,1170,0.517,2,7,0.286,603,1163,0.518,0.518,330,435,0.759,173,318,491,263,112,131,196,202
64,5,1984,33,1,3,77,77,2683,678,1324,0.512,7,21,0.333,671,1303,0.515,0.515,364,483,0.754,190,342,532,309,141,139,230,217
64,6,1985,34,1,3,78,78,2535,610,1236,0.494,3,14,0.214,607,1222,0.497,0.495,338,442,0.765,172,242,414,233,135,109,208,199
64,7,1986,35,1,3,74,74,2474,521,1085,0.48,9,32,0.281,512,1053,0.486,0.484,289,368,0.785,169,201,370,248,113,82,214,196
64,8,1987,36,1,3,60,60,1918,400,850,0.471,14,53,0.264,386,797,0.484,0.479,191,235,0.813,115,149,264,191,76,94,158,137
66,1,1998,24,1,3,28,1,332,46,106,0.434,17,42,0.405,29,64,0.453,0.514,6,9,0.667,18,34,52,24,7,5,14,44
66,1,1998,24,1,3,44,0,561,77,206,0.374,12,45,0.267,65,161,0.404,0.403,40,48,0.833,31,54,85,31,22,8,24,57
66,1,1998,24,1,3,72,1,893,123,312,0.394,29,87,0.333,94,225,0.418,0.441,46,57,0.807,49,88,137,55,29,13,38,101
66,2,1999,25,1,3,11,0,121,11,34,0.324,4,11,0.364,7,23,0.304,0.382,4,4,1,4,13,17,14,3,3,2,7
66,2,1999,25,1,3,16,0,145,13,44,0.295,4,13,0.308,9,31,0.29,0.341,4,4,1,6,13,19,15,5,3,2,8
68,1,2011,23,1,3,49,3,463,76,115,0.661,0,1,0,76,114,0.667,0.661,26,37,0.703,36,61,97,24,17,17,19,50
68,2,2012,24,1,3,29,0,217,27,42,0.643,0,1,0,27,41,0.659,0.643,8,16,0.5,19,31,50,13,6,24,5,23
68,4,2014,26,1,3,66,4,1209,175,332,0.527,0,2,0,175,330,0.53,0.527,51,75,0.68,120,190,310,44,42,46,40,139
72,5,2014,24,1,3,72,22,2028,391,897,0.436,21,95,0.221,370,802,0.461,0.448,239,310,0.771,76,265,341,363,84,21,175,155
72,6,2015,25,1,3,8,8,273,50,126,0.397,12,23,0.522,38,103,0.369,0.444,18,28,0.643,11,43,54,57,8,2,20,24
75,1,2011,21,1,3,44,18,947,130,306,0.425,25,91,0.275,105,215,0.488,0.466,18,28,0.643,27,96,123,35,34,28,47,78
75,2,2012,22,1,3,7,0,102,6,25,0.24,1,3,0.333,5,22,0.227,0.26,4,8,0.5,4,10,14,5,3,5,3,7
82,2,1998,21,1,3,82,82,2950,653,1347,0.485,21,51,0.412,632,1296,0.488,0.493,502,640,0.784,227,354,581,213,89,76,257,201
82,3,1999,22,1,3,50,50,2021,386,893,0.432,11,36,0.306,375,857,0.438,0.438,369,439,0.841,114,260,374,172,69,55,186,137
82,4,2000,23,1,3,82,82,3223,594,1277,0.465,29,96,0.302,565,1181,0.478,0.477,446,551,0.809,218,607,825,271,89,87,249,244
82,5,2001,24,1,3,81,81,3241,604,1280,0.472,12,64,0.188,592,1216,0.487,0.477,443,531,0.834,175,560,735,250,90,77,231,238
83,2,1981,26,1,3,29,-1,259,24,56,0.429,0,1,0,24,55,0.436,0.429,11,19,0.579,19,21,40,18,6,3,6,29
83,2,1981,26,1,3,39,-1,298,25,59,0.424,0,1,0,25,58,0.431,0.424,13,22,0.591,20,28,48,19,7,3,8,34
89,2,2014,23,1,3,56,0,786,60,127,0.472,2,10,0.2,58,117,0.496,0.48,30,45,0.667,67,134,201,24,19,23,28,114
89,2,2014,23,1,3,63,0,847,66,141,0.468,4,15,0.267,62,126,0.492,0.482,35,53,0.66,72,144,216,28,23,26,30,122
96,6,2013,27,1,3,64,64,2307,397,905,0.439,72,240,0.3,325,665,0.489,0.478,191,223,0.857,29,210,239,206,40,11,138,137
97,1,1982,22,1,3,51,20,1468,381,820,0.465,25,71,0.352,356,749,0.475,0.48,168,247,0.68,89,160,249,164,37,22,135,152
97,2,1983,23,1,3,81,75,2784,767,1589,0.483,16,76,0.211,751,1513,0.496,0.488,429,589,0.728,191,317,508,332,80,26,261,247
97,3,1984,24,1,3,79,79,2900,925,1765,0.524,15,56,0.268,910,1709,0.532,0.528,465,621,0.749,161,308,469,358,80,22,285,246
97,4,1985,25,1,3,80,79,2699,794,1569,0.506,27,85,0.318,767,1484,0.517,0.515,440,580,0.759,188,289,477,249,60,24,253,250
97,5,1986,26,1,3,74,73,2501,668,1327,0.503,16,56,0.286,652,1271,0.513,0.509,318,451,0.705,177,268,445,339,62,14,252,229
97,6,1987,27,1,3,80,80,2663,787,1590,0.495,53,150,0.353,734,1440,0.51,0.512,429,557,0.77,181,246,427,254,84,30,217,243
97,7,1988,28,1,3,77,77,2610,746,1571,0.475,52,172,0.302,694,1399,0.496,0.491,388,504,0.77,182,252,434,278,70,57,203,223
97,8,1989,29,1,3,36,32,1068,213,441,0.483,22,75,0.293,191,366,0.522,0.508,110,149,0.738,56,95,151,89,16,7,68,101
97,8,1989,29,1,3,44,44,1529,373,829,0.45,29,99,0.293,344,730,0.471,0.467,178,244,0.73,90,145,235,189,29,29,140,128
97,8,1989,29,1,3,80,76,2597,586,1270,0.461,51,174,0.293,535,1096,0.488,0.481,288,393,0.733,146,240,386,278,45,36,208,229
97,9,1990,30,1,3,78,40,2005,438,898,0.488,31,93,0.333,407,805,0.506,0.505,192,254,0.756,117,188,305,145,34,19,121,201
97,10,1991,31,1,3,78,13,2006,420,909,0.462,24,78,0.308,396,831,0.477,0.475,240,317,0.757,134,240,374,139,47,20,128,209
97,11,1992,32,1,3,75,12,1582,339,787,0.431,15,71,0.211,324,716,0.453,0.44,158,230,0.687,67,169,236,126,51,11,105,171
97,12,1993,33,1,3,51,15,1056,187,422,0.443,30,83,0.361,157,339,0.463,0.479,99,129,0.767,43,109,152,105,16,7,68,101
97,13,1994,34,1,3,39,0,859,163,348,0.468,37,93,0.398,126,255,0.494,0.522,50,72,0.694,28,88,116,104,21,8,70,98
113,1,2009,22,1,3,59,0,716,102,245,0.416,16,46,0.348,86,199,0.432,0.449,58,83,0.699,44,71,115,42,15,29,52,107
132,1,2011,20,1,3,81,14,1452,160,406,0.394,45,143,0.315,115,263,0.437,0.45,92,119,0.773,75,192,267,60,59,25,103,121
132,2,2012,21,1,3,66,21,1477,150,365,0.411,13,47,0.277,137,318,0.431,0.429,86,114,0.754,95,213,308,66,59,34,91,136
132,3,2013,22,1,3,76,71,2066,225,474,0.475,4,19,0.211,221,455,0.486,0.479,101,137,0.737,139,446,585,103,92,51,116,153
132,4,2014,23,1,3,80,65,2045,234,494,0.474,13,48,0.271,221,446,0.496,0.487,91,137,0.664,129,367,496,114,82,38,88,147
132,5,2015,24,1,3,10,0,155,20,40,0.5,4,16,0.25,16,24,0.667,0.55,3,6,0.5,9,29,38,6,8,8,6,18
139,1,1998,23,1,3,66,13,1839,239,586,0.408,17,84,0.202,222,502,0.442,0.422,275,315,0.873,55,132,187,227,86,13,128,136
139,10,2007,32,1,3,50,32,1190,126,294,0.429,54,152,0.355,72,142,0.507,0.52,93,106,0.877,29,84,113,133,52,7,56,115
142,1,1983,22,1,3,52,2,1154,182,357,0.51,0,3,0,182,354,0.514,0.51,99,172,0.576,115,167,282,66,62,21,74,147
142,1,1983,22,1,3,65,2,1202,190,379,0.501,0,4,0,190,375,0.507,0.501,100,175,0.571,119,175,294,67,63,21,79,153
142,2,1984,23,1,3,48,0,311,55,130,0.423,0,3,0,55,127,0.433,0.423,12,29,0.414,38,25,63,22,15,9,20,28
142,3,1985,24,1,3,44,0,457,61,149,0.409,0,2,0,61,147,0.415,0.409,27,45,0.6,29,53,82,21,29,9,32,70
143,1,2011,21,1,3,26,2,286,31,81,0.383,18,46,0.391,13,35,0.371,0.494,14,18,0.778,2,21,23,18,3,6,13,24
149,9,1998,30,1,3,58,44,1701,343,754,0.455,77,214,0.36,266,540,0.493,0.506,127,199,0.638,98,199,297,119,72,23,85,98
149,10,1999,31,1,3,47,39,1581,253,640,0.395,96,277,0.347,157,363,0.433,0.47,99,162,0.611,51,226,277,91,64,15,83,72
150,4,2000,26,1,3,82,82,2700,368,778,0.473,79,225,0.351,289,553,0.523,0.524,194,253,0.767,91,293,384,239,96,32,194,182
150,7,2003,29,1,3,82,9,1731,248,537,0.462,52,140,0.371,196,397,0.494,0.51,139,190,0.732,64,190,254,87,73,20,114,177
150,9,2005,31,1,3,65,5,1151,98,215,0.456,5,28,0.179,93,187,0.497,0.467,54,66,0.818,40,150,190,70,40,14,49,136
150,9,2005,31,1,3,66,5,1171,98,217,0.452,5,29,0.172,93,188,0.495,0.463,54,66,0.818,41,150,191,70,40,14,50,138
150,10,2006,32,1,3,48,1,638,54,126,0.429,5,19,0.263,49,107,0.458,0.448,13,18,0.722,18,63,81,30,17,6,24,75
151,1,1989,22,1,3,81,79,2738,640,1285,0.498,4,21,0.19,636,1264,0.503,0.5,224,289,0.775,152,265,417,372,150,62,261,295
152,1,1985,26,1,3,36,7,520,84,195,0.431,1,2,0.5,83,193,0.43,0.433,41,50,0.82,39,49,88,34,9,7,34,40
152,2,1986,27,1,3,17,3,207,37,74,0.5,0,1,0,37,73,0.507,0.5,12,16,0.75,5,21,26,8,1,0,6,20
152,2,1986,27,1,3,60,27,1469,273,554,0.493,2,8,0.25,271,546,0.496,0.495,73,111,0.658,125,123,248,136,55,6,76,105
152,2,1986,27,1,3,77,30,1676,310,628,0.494,2,9,0.222,308,619,0.498,0.495,85,127,0.669,130,144,274,144,56,6,82,125
152,3,1987,28,1,3,63,0,721,139,294,0.473,0,5,0,139,289,0.481,0.473,85,108,0.787,73,78,151,54,31,3,55,65
152,4,1988,29,1,3,74,1,1097,217,436,0.498,0,2,0,217,434,0.5,0.498,108,141,0.766,89,127,216,78,41,6,73,98
152,5,1989,30,1,3,82,12,2618,566,1152,0.491,2,11,0.182,564,1141,0.494,0.492,196,229,0.856,167,239,406,139,71,23,126,166
152,6,1990,31,1,3,78,3,2089,379,841,0.451,3,21,0.143,376,820,0.459,0.452,165,197,0.838,81,214,295,143,72,13,78,143
152,7,1991,32,1,3,82,13,2340,512,1055,0.485,9,43,0.209,503,1012,0.497,0.49,165,198,0.833,103,264,367,115,65,13,100,163
152,8,1992,33,1,3,82,11,2432,469,1008,0.465,42,127,0.331,427,881,0.485,0.486,143,163,0.877,96,182,278,135,86,11,109,128
152,9,1993,34,1,3,69,0,1263,225,544,0.414,39,120,0.325,186,424,0.439,0.449,72,89,0.809,62,122,184,93,31,5,63,75
152,10,1994,35,1,3,11,2,176,15,43,0.349,4,12,0.333,11,31,0.355,0.395,10,12,0.833,8,18,26,6,5,2,1,9
152,10,1994,35,1,3,10,0,180,20,43,0.465,3,14,0.214,17,29,0.586,0.5,9,11,0.818,8,19,27,11,3,1,9,7
152,10,1994,35,1,3,21,2,356,35,86,0.407,7,26,0.269,28,60,0.467,0.448,19,23,0.826,16,37,53,17,8,3,10,16
156,1,1990,22,1,3,72,5,1221,231,465,0.497,0,0,-1,231,465,0.497,0.497,164,227,0.722,187,175,362,40,24,17,50,152
156,2,1991,23,1,3,67,1,877,144,263,0.548,0,0,-1,144,263,0.548,0.548,91,127,0.717,122,131,253,25,27,7,32,125
159,1,2014,19,1,3,77,23,1897,173,418,0.414,41,118,0.347,132,300,0.44,0.463,138,202,0.683,78,261,339,150,60,61,122,173
164,1,2004,19,1,3,82,82,2995,624,1465,0.426,69,214,0.322,555,1251,0.444,0.449,408,525,0.777,183,315,498,227,97,41,247,225
164,2,2005,20,1,3,75,75,2608,530,1230,0.431,42,158,0.266,488,1072,0.455,0.448,456,573,0.796,141,285,426,194,68,30,224,229
164,3,2006,21,1,3,80,80,2941,756,1572,0.481,37,152,0.243,719,1420,0.506,0.493,573,709,0.808,122,272,394,216,88,42,218,229
164,4,2007,22,1,3,65,65,2486,691,1453,0.476,40,149,0.268,651,1304,0.499,0.489,459,568,0.808,143,248,391,249,77,23,234,203
164,5,2008,23,1,3,77,77,2806,728,1481,0.492,58,164,0.354,670,1317,0.509,0.511,464,590,0.786,178,393,571,259,98,39,253,253
164,6,2009,24,1,3,66,66,2277,535,1207,0.443,63,170,0.371,472,1037,0.455,0.469,371,468,0.793,106,344,450,222,75,24,199,195
164,7,2010,25,1,3,69,69,2634,688,1502,0.458,59,187,0.316,629,1315,0.478,0.478,508,612,0.83,152,302,454,222,88,30,209,225
164,8,2011,26,1,3,27,27,977,247,536,0.461,53,125,0.424,194,411,0.472,0.51,164,188,0.872,41,140,181,81,25,15,64,90
164,8,2011,26,1,3,50,50,1774,437,967,0.452,42,126,0.333,395,841,0.47,0.474,343,417,0.823,77,305,382,140,43,31,142,134
164,8,2011,26,1,3,77,77,2751,684,1503,0.455,95,251,0.378,589,1252,0.47,0.487,507,605,0.838,118,445,563,221,68,46,206,224
164,9,2012,27,1,3,55,55,1876,441,1025,0.43,68,203,0.335,373,822,0.454,0.463,295,367,0.804,88,256,344,200,62,24,144,156
164,12,2015,30,1,3,10,10,359,89,204,0.436,12,35,0.343,77,169,0.456,0.466,45,59,0.763,18,36,54,37,6,2,23,31
168,1,2005,19,1,3,80,12,1382,172,389,0.442,3,13,0.231,169,376,0.449,0.446,121,174,0.695,89,153,242,85,70,18,73,150
168,2,2006,20,1,3,21,0,290,32,80,0.4,0,2,0,32,78,0.41,0.4,35,50,0.7,29,52,81,15,14,2,16,22
168,2,2006,20,1,3,36,10,709,61,146,0.418,1,3,0.333,60,143,0.42,0.421,42,77,0.545,49,88,137,46,43,9,46,78
168,2,2006,20,1,3,57,10,999,93,226,0.412,1,5,0.2,92,221,0.416,0.414,77,127,0.606,78,140,218,61,57,11,62,100
168,4,2008,22,1,3,11,0,115,14,31,0.452,0,3,0,14,28,0.5,0.452,8,15,0.533,5,19,24,8,5,3,5,9
168,4,2008,22,1,3,24,3,431,55,105,0.524,5,15,0.333,50,90,0.556,0.548,41,60,0.683,25,59,84,36,26,8,18,36
168,4,2008,22,1,3,35,3,546,69,136,0.507,5,18,0.278,64,118,0.542,0.526,49,75,0.653,30,78,108,44,31,11,23,45
168,5,2009,23,1,3,82,20,1999,274,596,0.46,61,191,0.319,213,405,0.526,0.511,120,169,0.71,111,241,352,145,137,24,87,166
168,6,2010,24,1,3,72,71,2629,394,999,0.394,136,407,0.334,258,592,0.436,0.462,148,228,0.649,78,325,403,276,126,40,161,162
168,7,2011,25,1,3,75,75,2600,303,762,0.398,82,271,0.303,221,491,0.45,0.451,138,197,0.701,61,347,408,162,120,31,118,180
168,8,2012,26,1,3,41,41,1350,168,403,0.417,29,87,0.333,139,316,0.44,0.453,79,102,0.775,41,174,215,135,69,25,76,73
168,9,2013,27,1,3,56,15,1471,188,451,0.417,76,209,0.364,112,242,0.463,0.501,78,95,0.821,44,222,266,113,72,20,84,72
168,10,2014,28,1,3,77,77,2723,389,853,0.456,180,442,0.407,209,411,0.509,0.562,149,193,0.772,99,376,475,191,126,20,132,179
168,11,2015,29,1,3,9,9,319,45,99,0.455,26,59,0.441,19,40,0.475,0.586,18,21,0.857,10,45,55,23,18,0,18,20
183,1,1991,23,1,3,39,1,266,34,81,0.42,6,25,0.24,28,56,0.5,0.457,12,25,0.48,30,38,68,19,16,13,11,46
183,2,1992,24,1,3,59,4,843,84,205,0.41,25,73,0.342,59,132,0.447,0.471,26,37,0.703,65,77,142,38,40,15,47,109
183,3,1993,25,1,3,69,1,935,88,213,0.413,22,65,0.338,66,148,0.446,0.465,29,40,0.725,74,124,198,31,31,29,37,141
183,4,1994,26,1,3,37,0,319,36,88,0.409,4,21,0.19,32,67,0.478,0.432,9,10,0.9,33,49,82,13,11,1,21,57
183,5,1995,27,1,3,50,5,854,81,207,0.391,21,78,0.269,60,129,0.465,0.442,46,57,0.807,86,112,198,39,35,17,25,109
183,6,1996,28,1,3,75,14,1897,157,391,0.402,99,237,0.418,58,154,0.377,0.528,45,57,0.789,113,211,324,121,48,61,82,271
183,7,1997,29,1,3,78,30,1773,138,319,0.433,69,172,0.401,69,147,0.469,0.541,39,58,0.672,86,185,271,75,53,19,59,196
183,8,1998,30,1,3,46,12,681,39,122,0.32,21,74,0.284,18,48,0.375,0.406,12,19,0.632,28,73,101,29,27,12,26,107
183,9,1999,31,1,3,33,13,415,20,62,0.323,8,29,0.276,12,33,0.364,0.387,5,8,0.625,10,34,44,10,17,3,13,58
186,5,1996,27,1,3,77,49,2294,362,738,0.491,1,4,0.25,361,734,0.492,0.491,251,317,0.792,137,167,304,137,106,31,138,188
186,8,1999,30,1,3,48,21,874,78,174,0.448,0,2,0,78,172,0.453,0.448,52,76,0.684,47,78,125,58,57,18,30,81
186,13,2004,35,1,3,69,24,1416,143,347,0.412,1,7,0.143,142,340,0.418,0.414,110,139,0.791,52,122,174,85,55,15,76,114
186,14,2005,36,1,3,55,7,663,68,167,0.407,0,0,-1,68,167,0.407,0.407,57,77,0.74,45,54,99,36,23,8,31,83
186,15,2006,37,1,3,36,3,385,25,73,0.342,0,0,-1,25,73,0.342,0.342,21,30,0.7,18,35,53,23,12,6,11,40
199,1,2011,21,1,3,24,0,137,15,55,0.273,3,16,0.188,12,39,0.308,0.3,3,9,0.333,6,24,30,6,2,2,8,15
199,2,2012,22,1,3,40,4,537,71,173,0.41,43,100,0.43,28,73,0.384,0.535,17,20,0.85,16,79,95,16,10,4,27,46
209,1,2007,22,1,3,68,1,1064,139,275,0.505,5,27,0.185,134,248,0.54,0.515,51,90,0.567,97,197,294,44,57,44,49,146
209,2,2008,23,1,3,65,0,952,91,186,0.489,1,12,0.083,90,174,0.517,0.492,41,95,0.432,83,133,216,40,44,30,37,132
209,4,2012,27,1,3,14,0,115,16,32,0.5,2,9,0.222,14,23,0.609,0.531,8,11,0.727,6,20,26,5,4,3,6,14
211,1,1982,22,1,3,80,4,1700,311,652,0.477,0,8,0,311,644,0.483,0.477,145,212,0.684,157,254,411,147,55,17,106,199
211,4,1985,25,1,3,82,41,2091,289,493,0.586,1,3,0.333,288,490,0.588,0.587,199,257,0.774,133,312,445,234,65,13,140,220
211,5,1986,26,1,3,82,33,2139,356,688,0.517,0,19,0,356,669,0.532,0.517,183,255,0.718,178,182,360,251,81,10,139,212
211,6,1987,27,1,3,63,39,1822,249,462,0.539,0,5,0,249,457,0.545,0.539,112,146,0.767,115,193,308,170,52,17,113,173
215,1,1980,28,1,3,77,-1,2330,384,760,0.505,1,3,0.333,383,757,0.506,0.506,139,209,0.665,192,264,456,279,85,49,189,268
215,2,1981,29,1,3,76,-1,2375,431,882,0.489,0,6,0,431,876,0.492,0.489,199,281,0.708,150,277,427,240,80,85,197,284
215,3,1982,30,1,3,43,1,979,156,306,0.51,1,3,0.333,155,303,0.512,0.511,67,114,0.588,87,139,226,46,25,37,64,133
215,3,1982,30,1,3,39,37,1037,178,406,0.438,1,3,0.333,177,403,0.439,0.44,101,153,0.66,87,127,214,68,38,24,85,139
215,3,1982,30,1,3,82,38,2016,334,712,0.469,2,6,0.333,332,706,0.47,0.471,168,267,0.629,174,266,440,114,63,61,149,272
222,1,2013,20,1,3,81,81,2058,276,628,0.439,52,145,0.359,224,483,0.464,0.481,144,190,0.758,53,280,333,98,52,14,101,140
222,2,2014,21,1,3,78,24,2204,271,679,0.399,66,190,0.347,205,489,0.419,0.448,130,181,0.718,66,245,311,116,65,20,84,158
222,3,2015,22,1,3,9,9,262,36,66,0.545,11,24,0.458,25,42,0.595,0.629,21,27,0.778,6,40,46,14,3,1,10,13
230,1,2004,23,1,3,38,9,724,63,138,0.457,2,13,0.154,61,125,0.488,0.464,43,61,0.705,53,98,151,48,27,3,44,76
230,2,2005,24,1,3,43,9,715,62,151,0.411,5,22,0.227,57,129,0.442,0.427,35,58,0.603,49,84,133,57,30,7,45,80
230,7,2010,29,1,3,81,58,2097,271,557,0.487,66,207,0.319,205,350,0.586,0.546,108,146,0.74,106,339,445,134,59,30,112,185
230,8,2011,30,1,3,53,0,1020,131,279,0.47,34,107,0.318,97,172,0.564,0.53,60,77,0.779,73,155,228,71,39,22,58,127
230,9,2012,31,1,3,63,16,1440,175,387,0.452,46,138,0.333,129,249,0.518,0.512,95,128,0.742,97,247,344,126,35,48,73,152
230,10,2013,32,1,3,80,4,2058,312,675,0.462,111,325,0.342,201,350,0.574,0.544,87,117,0.744,111,255,366,123,82,63,90,233
230,11,2014,33,1,3,63,40,1735,231,527,0.438,97,283,0.343,134,244,0.549,0.53,66,90,0.733,60,232,292,125,56,28,85,185
230,12,2015,34,1,3,8,6,205,19,46,0.413,9,28,0.321,10,18,0.556,0.511,9,11,0.818,2,14,16,4,3,5,5,19
238,13,2008,36,1,3,31,1,554,77,160,0.481,48,112,0.429,29,48,0.604,0.631,19,20,0.95,12,43,55,54,17,3,18,43
245,1,2006,22,1,3,19,0,141,15,37,0.405,1,7,0.143,14,30,0.467,0.419,8,10,0.8,7,21,28,8,9,2,9,17
252,1,2002,23,1,3,78,78,3097,412,961,0.429,103,276,0.373,309,685,0.451,0.482,198,283,0.7,180,238,418,216,121,81,155,215
252,2,2003,24,1,3,78,47,2383,275,569,0.483,86,216,0.398,189,353,0.535,0.559,120,145,0.828,128,217,345,105,102,88,68,207
252,3,2004,25,1,3,79,1,1947,242,543,0.446,65,186,0.349,177,357,0.496,0.506,120,164,0.732,102,201,303,101,101,58,56,187
252,5,2006,27,1,3,81,81,2839,303,621,0.488,65,165,0.394,238,456,0.522,0.54,147,208,0.707,164,265,429,136,92,114,90,223
252,6,2007,28,1,3,82,82,2988,292,654,0.446,157,373,0.421,135,281,0.48,0.567,88,113,0.779,67,271,338,175,79,60,72,190
252,7,2008,29,1,3,80,78,2907,265,619,0.428,139,369,0.377,126,250,0.504,0.54,75,101,0.743,131,276,407,155,77,90,78,196
252,10,2011,32,1,3,23,0,557,43,101,0.426,14,42,0.333,29,59,0.492,0.495,15,17,0.882,32,60,92,32,16,10,16,31
252,10,2011,32,1,3,59,59,1818,186,408,0.456,88,225,0.391,98,183,0.536,0.564,49,76,0.645,58,223,281,153,53,71,63,127
252,10,2011,32,1,3,82,59,2375,229,509,0.45,102,267,0.382,127,242,0.525,0.55,64,93,0.688,90,283,373,185,69,81,79,158
252,11,2012,33,1,3,65,10,1499,113,292,0.387,62,183,0.339,51,109,0.468,0.493,23,37,0.622,56,100,156,82,64,33,37,105
252,12,2013,34,1,3,72,20,1786,152,362,0.42,136,316,0.43,16,46,0.348,0.608,32,38,0.842,37,128,165,72,41,55,34,149
252,13,2014,35,1,3,73,56,1468,105,275,0.382,73,210,0.348,32,65,0.492,0.515,15,23,0.652,34,104,138,63,50,39,21,124
257,1,2009,20,1,3,79,76,1454,161,361,0.446,62,168,0.369,99,193,0.513,0.532,42,52,0.808,84,136,220,74,50,40,50,139
257,2,2010,21,1,3,37,25,918,139,268,0.519,54,132,0.409,85,136,0.625,0.619,43,51,0.843,32,109,141,44,24,25,27,83
257,3,2011,22,1,3,80,67,2522,367,807,0.455,118,342,0.345,249,465,0.535,0.528,138,164,0.841,109,252,361,123,68,49,83,194
257,4,2012,23,1,3,59,34,1791,289,641,0.451,107,274,0.391,182,367,0.496,0.534,133,159,0.836,81,190,271,84,57,60,90,105
257,5,2013,24,1,3,73,73,2807,352,833,0.423,165,444,0.372,187,389,0.481,0.522,178,210,0.848,97,315,412,360,91,83,190,139
257,6,2014,25,1,3,82,82,2956,381,819,0.465,145,402,0.361,236,417,0.566,0.554,163,203,0.803,116,495,611,420,75,57,208,156
257,7,2015,26,1,3,7,7,235,22,60,0.367,10,29,0.345,12,31,0.387,0.45,9,10,0.9,8,46,54,40,7,6,16,18
274,3,2011,22,1,3,73,73,2361,561,1246,0.45,60,164,0.366,501,1082,0.463,0.474,219,291,0.753,118,291,409,158,54,52,195,222
274,4,2012,23,1,3,47,7,1087,221,497,0.445,38,101,0.376,183,396,0.462,0.483,61,95,0.642,39,168,207,45,18,19,80,83
274,5,2013,24,1,3,75,20,1554,310,766,0.405,45,144,0.313,265,622,0.426,0.434,94,126,0.746,52,230,282,111,31,34,144,107
274,6,2014,25,1,3,55,2,831,177,355,0.499,21,54,0.389,156,301,0.518,0.528,61,79,0.772,31,141,172,42,23,21,57,93
286,7,2014,27,1,3,80,25,2016,337,695,0.485,126,293,0.43,211,402,0.525,0.576,111,131,0.847,18,208,226,179,50,7,95,130
290,1,2014,20,1,3,52,0,663,80,225,0.356,13,53,0.245,67,172,0.39,0.384,44,69,0.638,49,106,155,17,21,8,47,93
295,1,1990,24,1,3,55,34,990,137,286,0.479,0,0,-1,137,286,0.479,0.479,64,96,0.667,84,104,188,54,23,10,62,133
295,2,1991,25,1,3,27,13,334,40,107,0.374,0,0,-1,40,107,0.374,0.374,35,47,0.745,30,34,64,28,8,2,20,50
295,3,1992,26,1,3,52,45,831,79,209,0.378,0,1,0,79,208,0.38,0.378,35,50,0.7,62,99,161,38,19,9,33,121
295,3,1992,26,1,3,54,45,833,80,211,0.379,0,1,0,80,210,0.381,0.379,35,50,0.7,63,99,162,38,19,9,33,122
298,1,1987,22,1,3,56,45,1567,401,758,0.529,0,3,0,401,755,0.531,0.529,186,287,0.648,132,170,302,104,36,40,153,188
298,1,1987,22,1,3,63,45,1586,407,766,0.531,0,3,0,407,763,0.533,0.531,187,288,0.649,136,173,309,105,38,40,153,196
298,2,1988,23,1,3,73,56,1922,540,960,0.563,0,0,-1,540,960,0.563,0.563,192,320,0.6,176,219,395,110,55,63,162,207
320,6,1985,28,1,3,80,77,3161,918,1760,0.522,56,131,0.427,862,1629,0.529,0.538,403,457,0.882,164,678,842,531,129,98,248,208
320,7,1986,29,1,3,82,81,3113,796,1606,0.496,82,194,0.423,714,1412,0.506,0.521,441,492,0.896,190,615,805,557,166,51,266,182
320,8,1987,30,1,3,74,73,3005,786,1497,0.525,90,225,0.4,696,1272,0.547,0.555,414,455,0.91,124,558,682,566,135,70,240,185
320,9,1988,31,1,3,76,75,2965,881,1672,0.527,98,237,0.414,783,1435,0.546,0.556,415,453,0.916,108,595,703,467,125,57,213,157
320,10,1989,32,1,3,6,6,189,49,104,0.471,0,0,-1,49,104,0.471,0.471,18,19,0.947,1,36,37,29,6,5,11,18
320,11,1990,33,1,3,75,75,2944,718,1517,0.473,65,195,0.333,653,1322,0.494,0.495,319,343,0.93,90,622,712,562,106,61,243,173
320,12,1991,34,1,3,60,60,2277,462,1017,0.454,77,198,0.389,385,819,0.47,0.492,163,183,0.891,53,456,509,431,108,58,187,118
320,13,1992,35,1,3,45,45,1662,353,758,0.466,52,128,0.406,301,630,0.478,0.5,150,162,0.926,46,388,434,306,42,33,125,82
326,1,1985,21,1,3,60,0,551,87,237,0.367,0,2,0,87,235,0.37,0.367,28,55,0.509,42,54,96,26,25,3,44,55
329,1,1993,22,1,3,27,0,109,14,42,0.333,0,3,0,14,39,0.359,0.333,6,8,0.75,10,13,23,7,4,2,5,14
352,1,2004,23,1,3,73,36,1787,183,454,0.403,67,187,0.358,116,267,0.434,0.477,65,103,0.631,106,211,317,98,46,10,75,128
352,3,2006,25,1,3,33,22,1064,101,256,0.395,32,102,0.314,69,154,0.448,0.457,47,81,0.58,26,123,149,83,32,6,49,89
352,7,2010,29,1,3,79,50,1559,120,298,0.403,70,196,0.357,50,102,0.49,0.52,37,50,0.74,25,151,176,95,45,12,53,156
363,4,1994,25,1,3,73,38,1402,162,288,0.563,0,0,-1,162,288,0.563,0.563,50,105,0.476,150,194,344,88,76,13,89,175
371,1,1999,24,1,3,39,4,432,49,151,0.325,1,10,0.1,48,141,0.34,0.328,21,42,0.5,25,68,93,38,22,11,39,60
376,1,2000,27,1,3,17,6,167,28,63,0.444,0,3,0,28,60,0.467,0.444,6,11,0.545,14,26,40,10,6,3,6,9
383,1,1998,26,1,3,61,9,1305,122,298,0.409,20,59,0.339,102,239,0.427,0.443,76,122,0.623,79,95,174,81,87,29,52,174
383,2,1999,27,1,3,30,1,494,26,93,0.28,7,26,0.269,19,67,0.284,0.317,11,24,0.458,15,37,52,28,21,9,13,51
383,3,2000,28,1,3,42,0,311,26,73,0.356,1,2,0.5,25,71,0.352,0.363,6,12,0.5,14,22,36,16,9,5,5,37
383,3,2000,28,1,3,27,2,567,46,121,0.38,26,56,0.464,20,65,0.308,0.488,19,31,0.613,13,47,60,18,14,10,14,81
383,3,2000,28,1,3,69,2,878,72,194,0.371,27,58,0.466,45,136,0.331,0.441,25,43,0.581,27,69,96,34,23,15,19,118
383,4,2001,29,1,3,82,72,2685,211,581,0.363,103,307,0.336,108,274,0.394,0.452,98,161,0.609,45,200,245,132,83,53,74,269
383,5,2002,30,1,3,59,59,1699,155,398,0.389,56,148,0.378,99,250,0.396,0.46,46,96,0.479,42,120,162,88,62,25,66,116
383,6,2003,31,1,3,82,82,2566,223,479,0.466,101,229,0.441,122,250,0.488,0.571,36,89,0.404,59,180,239,113,66,42,72,195
383,7,2004,32,1,3,82,82,2624,211,502,0.42,77,212,0.363,134,290,0.462,0.497,66,114,0.579,45,208,253,113,84,33,90,166
383,8,2005,33,1,3,82,82,2627,251,598,0.42,102,253,0.403,149,345,0.432,0.505,71,112,0.634,50,235,285,126,55,39,57,175
383,9,2006,34,1,3,82,82,2755,232,536,0.433,104,245,0.424,128,291,0.44,0.53,51,84,0.607,35,285,320,126,79,30,67,191
383,10,2007,35,1,3,82,82,2464,189,467,0.405,89,232,0.384,100,235,0.426,0.5,43,73,0.589,23,200,223,117,62,25,65,175
383,11,2008,36,1,3,81,81,2448,174,428,0.407,90,215,0.419,84,213,0.394,0.512,45,69,0.652,33,201,234,91,54,22,46,177
383,12,2009,37,1,3,80,10,1506,79,187,0.422,42,98,0.429,37,89,0.416,0.535,14,26,0.538,16,129,145,40,36,13,25,123
385,1,2000,22,1,3,46,0,423,49,115,0.426,0,1,0,49,114,0.43,0.426,24,38,0.632,22,63,85,14,14,9,21,46
385,2,2001,23,1,3,44,0,375,53,114,0.465,1,5,0.2,52,109,0.477,0.469,33,40,0.825,30,47,77,4,10,21,11,45
398,1,1982,22,1,3,39,0,331,54,103,0.524,0,1,0,54,102,0.529,0.524,29,48,0.604,31,34,65,11,12,5,28,37
411,1,1987,23,1,3,32,0,219,48,96,0.5,0,2,0,48,94,0.511,0.5,42,54,0.778,23,30,53,16,16,3,24,39
411,2,1988,24,1,3,20,3,308,56,134,0.418,1,5,0.2,55,129,0.426,0.422,20,23,0.87,20,28,48,16,16,11,29,41
411,3,1989,25,1,3,67,4,811,202,436,0.463,7,31,0.226,195,405,0.481,0.471,87,120,0.725,63,69,132,60,45,3,64,99
422,1,2008,21,1,3,79,35,1803,182,486,0.374,7,36,0.194,175,450,0.389,0.382,88,110,0.8,82,210,292,111,76,25,89,188
422,2,2009,22,1,3,15,8,307,37,90,0.411,5,12,0.417,32,78,0.41,0.439,14,19,0.737,18,31,49,25,15,3,13,37
422,4,2011,24,1,3,56,22,1362,168,437,0.384,26,99,0.263,142,338,0.42,0.414,121,171,0.708,45,107,152,77,89,14,77,134
422,4,2011,24,1,3,69,24,1510,193,488,0.395,30,112,0.268,163,376,0.434,0.426,136,192,0.708,57,118,175,89,100,16,87,159
422,5,2012,25,1,3,59,17,1287,201,463,0.434,33,127,0.26,168,336,0.5,0.47,90,130,0.692,43,107,150,88,72,17,56,113
422,6,2013,26,1,3,82,2,2003,375,883,0.425,91,307,0.296,284,576,0.493,0.476,149,216,0.69,55,180,235,124,118,23,102,154
422,7,2014,27,1,3,81,81,2609,388,807,0.481,59,211,0.28,329,596,0.552,0.517,163,227,0.718,63,144,207,135,151,30,105,210
422,8,2015,28,1,3,9,2,206,33,70,0.471,2,10,0.2,31,60,0.517,0.486,20,31,0.645,12,16,28,13,15,0,12,14
426,3,2009,23,1,3,81,80,2605,421,828,0.508,22,85,0.259,399,743,0.537,0.522,247,352,0.702,101,199,300,179,138,30,110,128
426,7,2013,27,1,3,14,0,142,6,23,0.261,1,5,0.2,5,18,0.278,0.283,0,0,-1,13,27,40,10,9,0,4,6
426,7,2013,27,1,3,46,34,711,64,175,0.366,22,71,0.31,42,104,0.404,0.429,16,39,0.41,29,71,100,40,34,6,14,27
426,7,2013,27,1,3,60,34,853,70,198,0.354,23,76,0.303,47,122,0.385,0.412,16,39,0.41,42,98,140,50,43,6,18,33
426,8,2014,28,1,3,23,3,158,3,15,0.2,1,8,0.125,2,7,0.286,0.233,0,2,0,2,12,14,10,6,1,2,4
426,8,2014,28,1,3,24,3,160,3,15,0.2,1,8,0.125,2,7,0.286,0.233,0,2,0,2,12,14,10,6,1,2,4
428,1,1980,26,1,3,81,-1,2316,594,1243,0.478,5,27,0.185,589,1216,0.484,0.48,230,266,0.865,104,197,301,237,94,20,172,216
428,2,1981,27,1,3,77,-1,2215,537,1102,0.487,3,21,0.143,534,1081,0.494,0.489,213,241,0.884,78,211,289,234,88,28,150,182
428,3,1982,28,1,3,41,4,924,209,433,0.483,4,9,0.444,205,424,0.483,0.487,89,103,0.864,37,88,125,109,28,3,64,91
428,4,1983,29,1,3,70,5,1855,421,856,0.492,1,13,0.077,420,843,0.498,0.492,164,196,0.837,44,202,246,207,40,9,122,155
428,5,1984,30,1,3,81,10,2431,509,1094,0.465,6,31,0.194,503,1063,0.473,0.468,196,243,0.807,80,252,332,265,53,14,148,224
428,6,1985,31,1,3,80,15,2042,460,990,0.465,14,39,0.359,446,951,0.469,0.472,181,206,0.879,55,175,230,171,47,18,116,128
428,7,1986,32,1,3,58,14,1161,199,451,0.441,6,18,0.333,193,433,0.446,0.448,106,119,0.891,29,94,123,108,31,8,68,81
428,8,1987,33,1,3,34,4,418,79,171,0.462,1,6,0.167,78,165,0.473,0.465,16,20,0.8,14,38,52,35,10,2,15,50
433,1,1980,28,1,3,82,-1,2304,377,785,0.48,2,7,0.286,375,778,0.482,0.482,197,243,0.811,170,342,512,341,88,6,179,211
433,2,1981,29,1,3,82,-1,2001,271,611,0.444,5,18,0.278,266,593,0.449,0.448,166,198,0.838,103,327,430,383,63,3,171,190
433,3,1982,30,1,3,82,54,2035,218,499,0.437,3,18,0.167,215,481,0.447,0.44,134,164,0.817,119,220,339,448,65,6,165,222
433,4,1983,31,1,3,37,0,371,44,99,0.444,6,13,0.462,38,86,0.442,0.475,10,14,0.714,24,35,59,70,6,1,31,46
443,1,1992,22,1,3,37,0,270,43,97,0.443,2,11,0.182,41,86,0.477,0.454,17,21,0.81,13,26,39,11,8,2,18,19
443,2,1993,23,1,3,55,2,571,93,233,0.399,6,26,0.231,87,207,0.42,0.412,35,40,0.875,22,59,81,34,10,2,39,46
443,3,1994,24,1,3,34,0,190,36,99,0.364,4,23,0.174,32,76,0.421,0.384,9,10,0.9,5,16,21,3,0,2,12,19
449,1,1990,21,1,3,75,35,1339,210,447,0.47,0,7,0,210,440,0.477,0.47,125,164,0.762,83,148,231,50,33,26,69,148
449,2,1991,22,1,3,74,51,1485,263,502,0.524,0,4,0,263,498,0.528,0.524,101,144,0.701,78,135,213,80,26,24,94,130
449,3,1992,23,1,3,36,2,381,55,118,0.466,0,3,0,55,115,0.478,0.466,25,41,0.61,29,47,76,23,9,7,27,41
449,3,1992,23,1,3,42,2,431,60,128,0.469,0,3,0,60,125,0.48,0.469,30,49,0.612,31,51,82,26,12,7,29,48
449,4,1993,24,1,3,77,20,1186,160,331,0.483,0,5,0,160,326,0.491,0.483,71,98,0.724,88,144,232,51,20,24,56,112
449,5,1995,26,1,3,41,14,814,105,174,0.603,1,3,0.333,104,171,0.608,0.606,38,62,0.613,64,125,189,30,11,14,29,105
449,7,1997,28,1,3,60,1,674,65,128,0.508,1,6,0.167,64,122,0.525,0.512,39,59,0.661,38,94,132,24,9,20,15,86
449,7,1997,28,1,3,70,1,757,78,154,0.506,1,6,0.167,77,148,0.52,0.51,47,70,0.671,41,107,148,28,9,22,19,100
449,8,1998,29,1,3,77,8,1202,161,372,0.433,2,8,0.25,159,364,0.437,0.435,63,87,0.724,57,126,183,55,23,13,51,100
449,11,2001,32,1,3,20,2,265,31,75,0.413,0,1,0,31,74,0.419,0.413,16,24,0.667,5,31,36,6,6,6,6,27
449,11,2001,32,1,3,26,2,339,40,95,0.421,0,3,0,40,92,0.435,0.421,22,34,0.647,8,46,54,11,9,7,8,37
450,2,2005,25,1,3,14,0,152,23,62,0.371,4,11,0.364,19,51,0.373,0.403,4,9,0.444,10,18,28,14,1,6,15,17
453,1,2010,22,1,3,57,0,535,68,147,0.463,2,7,0.286,66,140,0.471,0.469,48,72,0.667,31,47,78,19,21,10,19,53
453,2,2011,23,1,3,41,1,488,62,113,0.549,2,6,0.333,60,107,0.561,0.558,25,47,0.532,32,52,84,29,16,8,28,48
453,2,2011,23,1,3,49,1,576,74,131,0.565,5,10,0.5,69,121,0.57,0.584,32,60,0.533,41,58,99,33,20,10,35,59
453,3,2012,24,1,3,65,17,1443,212,409,0.518,6,24,0.25,206,385,0.535,0.526,94,141,0.667,95,141,236,67,48,12,55,96
461,1,1980,28,1,3,28,-1,361,37,98,0.378,0,0,-1,37,98,0.378,0.378,34,44,0.773,21,41,62,14,3,4,24,66
461,1,1980,28,1,3,32,-1,385,37,105,0.352,0,0,-1,37,105,0.352,0.352,38,48,0.792,26,45,71,18,3,4,29,70
463,1,2002,20,1,3,29,5,245,23,70,0.329,5,27,0.185,18,43,0.419,0.364,12,20,0.6,11,39,50,15,18,7,7,18
463,2,2003,21,1,3,51,5,666,61,171,0.357,3,39,0.077,58,132,0.439,0.365,20,32,0.625,45,95,140,20,34,13,23,68
463,3,2004,22,1,3,21,10,408,45,99,0.455,12,32,0.375,33,67,0.493,0.515,8,13,0.615,18,50,68,25,17,2,12,38
463,3,2004,22,1,3,34,16,561,72,155,0.465,26,67,0.388,46,88,0.523,0.548,9,14,0.643,23,55,78,39,13,5,17,42
463,3,2004,22,1,3,55,26,969,117,254,0.461,38,99,0.384,79,155,0.51,0.535,17,27,0.63,41,105,146,64,30,7,29,80
477,1,1990,22,1,3,16,0,128,15,30,0.5,0,0,-1,15,30,0.5,0.5,7,18,0.389,15,11,26,3,6,5,6,24
482,3,1982,27,1,3,75,49,1988,341,701,0.486,8,30,0.267,333,671,0.496,0.492,194,247,0.785,79,195,274,189,78,29,183,250
482,4,1983,28,1,3,81,56,2055,344,768,0.448,8,36,0.222,336,732,0.459,0.453,116,165,0.703,88,189,277,186,82,30,177,258
491,10,2009,32,1,3,63,0,878,61,159,0.384,13,51,0.255,48,108,0.444,0.425,20,25,0.8,32,98,130,57,29,8,38,108
494,1,2014,22,1,3,43,0,395,43,121,0.355,22,73,0.301,21,48,0.438,0.446,7,9,0.778,11,43,54,12,9,1,13,26
495,1,2010,21,1,3,74,4,1488,249,565,0.441,92,249,0.369,157,316,0.497,0.522,67,87,0.77,38,182,220,88,34,11,48,85
495,2,2011,22,1,3,78,22,1738,279,656,0.425,89,274,0.325,190,382,0.497,0.493,118,138,0.855,52,229,281,127,41,18,67,114
495,3,2012,23,1,3,58,9,1298,208,471,0.442,88,219,0.402,120,252,0.476,0.535,54,70,0.771,38,179,217,74,29,7,55,65
495,4,2013,24,1,3,23,1,508,79,191,0.414,26,81,0.321,53,110,0.482,0.482,32,42,0.762,15,56,71,25,14,7,23,29
495,5,2014,25,1,3,41,8,751,100,254,0.394,42,120,0.35,58,134,0.433,0.476,32,39,0.821,19,84,103,31,19,2,24,58
497,1,1991,22,1,3,74,10,859,94,226,0.416,1,4,0.25,93,222,0.419,0.418,43,66,0.652,61,80,141,51,33,15,26,79
497,2,1992,23,1,3,15,0,121,10,33,0.303,0,1,0,10,32,0.313,0.303,9,12,0.75,10,18,28,10,9,3,7,11
497,2,1992,23,1,3,11,0,140,15,30,0.5,0,0,-1,15,30,0.5,0.5,3,9,0.333,6,16,22,11,8,3,5,18
497,2,1992,23,1,3,28,0,290,29,71,0.408,0,1,0,29,70,0.414,0.408,12,21,0.571,18,34,52,23,19,7,13,31
497,3,1993,24,1,3,70,9,1287,176,403,0.437,20,59,0.339,156,344,0.453,0.462,65,87,0.747,81,114,195,94,47,19,55,98
497,4,1994,25,1,3,36,0,218,42,84,0.5,12,29,0.414,30,55,0.545,0.571,10,20,0.5,13,19,32,16,8,1,12,24
497,5,1995,26,1,3,57,0,605,90,183,0.492,15,48,0.313,75,135,0.556,0.533,22,39,0.564,36,62,98,50,24,12,30,64
497,6,1996,27,1,3,74,0,740,112,242,0.463,40,90,0.444,72,152,0.474,0.545,14,22,0.636,45,66,111,56,34,7,39,70
497,7,1997,28,1,3,76,0,703,58,158,0.367,18,54,0.333,40,104,0.385,0.424,5,14,0.357,45,81,126,60,23,21,27,50
497,8,1998,29,1,3,74,0,608,85,176,0.483,25,65,0.385,60,111,0.541,0.554,3,6,0.5,24,53,77,49,22,15,21,47
497,9,1999,30,1,3,50,0,1056,100,240,0.417,61,148,0.412,39,92,0.424,0.544,13,18,0.722,29,104,133,57,37,13,21,83
497,10,2000,31,1,3,58,5,657,55,156,0.353,18,83,0.217,37,73,0.507,0.41,2,7,0.286,30,61,91,33,25,16,13,50
497,11,2001,32,1,3,57,3,737,76,164,0.463,32,77,0.416,44,87,0.506,0.561,9,12,0.75,20,74,94,39,21,10,25,83
497,12,2002,33,1,3,60,2,630,42,112,0.375,19,54,0.352,23,58,0.397,0.46,2,4,0.5,27,81,108,29,20,8,14,46
497,12,2002,33,1,3,66,2,684,44,118,0.373,21,60,0.35,23,58,0.397,0.462,2,4,0.5,29,87,116,32,21,8,15,53
517,1,1994,23,1,3,51,16,767,98,234,0.419,2,6,0.333,96,228,0.421,0.423,46,70,0.657,46,86,132,62,37,16,45,88
517,2,1995,24,1,3,65,62,2014,277,593,0.467,96,235,0.409,181,358,0.506,0.548,100,144,0.694,96,272,368,161,75,40,85,187
517,3,1996,25,1,3,20,20,693,92,206,0.447,37,98,0.378,55,108,0.509,0.536,42,56,0.75,26,72,98,47,27,13,43,76
517,4,1997,26,1,3,29,0,457,53,140,0.379,22,61,0.361,31,79,0.392,0.457,15,23,0.652,25,54,79,35,14,8,28,60
517,4,1997,26,1,3,28,2,482,45,131,0.344,19,55,0.345,26,76,0.342,0.416,42,53,0.792,24,55,79,39,14,11,25,60
517,4,1997,26,1,3,57,2,939,98,271,0.362,41,116,0.353,57,155,0.368,0.437,57,76,0.75,49,109,158,74,28,19,53,120
517,5,1998,27,1,3,80,3,1096,159,375,0.424,51,144,0.354,108,231,0.468,0.492,47,64,0.734,80,118,198,65,64,37,50,131
517,6,1999,28,1,3,32,10,706,75,208,0.361,28,72,0.389,47,136,0.346,0.428,34,42,0.81,32,87,119,45,40,11,23,82
517,7,2000,29,1,3,74,9,1336,165,419,0.394,82,232,0.353,83,187,0.444,0.492,39,50,0.78,65,191,256,72,67,44,38,173
522,2,2013,23,1,3,82,20,2134,239,512,0.467,40,105,0.381,199,407,0.489,0.506,187,233,0.803,136,192,328,115,78,31,62,97
523,1,2003,22,1,3,78,78,2858,429,1032,0.416,34,107,0.318,395,925,0.427,0.432,309,375,0.824,135,262,397,213,137,31,192,230
523,2,2004,23,1,3,68,56,2030,240,631,0.38,10,42,0.238,230,589,0.39,0.388,133,176,0.756,92,234,326,126,75,13,91,162
523,3,2005,24,1,3,77,77,2746,441,991,0.445,38,125,0.304,403,866,0.465,0.464,275,319,0.862,146,304,450,146,110,23,125,213
523,4,2006,25,1,3,75,54,2708,494,1086,0.455,41,120,0.342,453,966,0.469,0.474,289,332,0.87,114,352,466,186,127,18,175,238
523,5,2007,26,1,3,63,63,2474,451,975,0.463,18,72,0.25,433,903,0.48,0.472,283,328,0.863,147,320,467,233,134,17,181,188
523,6,2008,27,1,3,58,58,2314,439,943,0.466,66,185,0.357,373,758,0.492,0.501,236,262,0.901,93,295,388,284,128,20,150,160
523,8,2010,29,1,3,47,47,1853,293,694,0.422,25,95,0.263,268,599,0.447,0.44,185,211,0.877,68,248,316,107,68,15,113,126
523,8,2010,29,1,3,74,74,2783,450,1051,0.428,42,145,0.29,408,906,0.45,0.448,264,315,0.838,104,357,461,156,116,24,160,193
523,9,2011,30,1,3,29,29,867,170,378,0.45,28,65,0.431,142,313,0.454,0.487,68,88,0.773,22,96,118,46,28,8,49,59
523,10,2012,31,1,3,63,63,1871,287,705,0.407,92,257,0.358,195,448,0.435,0.472,87,107,0.813,44,186,230,78,52,9,77,123
523,11,2013,32,1,3,78,78,1879,305,720,0.424,128,330,0.388,177,390,0.454,0.513,75,90,0.833,41,182,223,78,51,11,72,139
523,12,2014,33,1,3,22,0,598,76,186,0.409,45,102,0.441,31,84,0.369,0.53,16,19,0.842,5,66,71,26,24,6,8,56
523,12,2014,33,1,3,34,13,821,137,354,0.387,53,147,0.361,84,207,0.406,0.462,47,56,0.839,16,142,158,56,23,11,52,64
523,12,2014,33,1,3,56,13,1419,213,540,0.394,98,249,0.394,115,291,0.395,0.485,63,75,0.84,21,208,229,82,47,17,60,120
523,13,2015,34,1,3,10,0,269,25,59,0.424,12,32,0.375,13,27,0.481,0.525,6,8,0.75,6,41,47,7,5,0,9,21
544,1,1993,23,1,3,53,13,885,151,312,0.484,0,4,0,151,308,0.49,0.484,68,99,0.687,88,79,167,58,24,6,63,128
549,1,1985,22,1,3,56,0,625,130,262,0.496,0,1,0,130,261,0.498,0.496,56,70,0.8,41,48,89,24,28,3,69,107
549,2,1986,23,1,3,82,1,1292,294,608,0.484,2,9,0.222,292,599,0.487,0.485,58,73,0.795,83,153,236,45,62,7,86,164
549,3,1987,24,1,3,40,0,332,57,145,0.393,0,3,0,57,142,0.401,0.393,24,39,0.615,21,37,58,19,12,1,34,40
549,4,1988,25,1,3,13,1,242,57,101,0.564,1,3,0.333,56,98,0.571,0.569,28,39,0.718,8,19,27,15,11,2,26,41
549,5,1989,26,1,3,63,2,787,158,345,0.458,2,21,0.095,156,324,0.481,0.461,70,83,0.843,53,77,130,47,37,6,62,108
549,8,1992,29,1,3,78,41,2441,527,1137,0.464,13,37,0.351,514,1100,0.467,0.469,240,299,0.803,141,145,286,229,84,31,165,206
549,9,1993,30,1,3,58,13,1062,194,396,0.49,2,5,0.4,192,391,0.491,0.492,59,87,0.678,59,96,155,62,34,5,51,150
549,10,1994,31,1,3,22,11,379,63,128,0.492,1,3,0.333,62,125,0.496,0.496,30,37,0.811,28,32,60,31,20,1,29,59
549,10,1994,31,1,3,41,3,835,164,384,0.427,6,25,0.24,158,359,0.44,0.435,64,83,0.771,48,78,126,51,30,14,55,75
549,10,1994,31,1,3,63,14,1214,227,512,0.443,7,28,0.25,220,484,0.455,0.45,94,120,0.783,76,110,186,82,50,15,84,134
549,11,1995,32,1,3,78,0,1128,161,392,0.411,15,42,0.357,146,350,0.417,0.43,132,159,0.83,60,93,153,69,32,8,65,122
554,9,2011,33,1,3,56,4,618,43,100,0.43,42,87,0.483,1,13,0.077,0.64,17,18,0.944,10,49,59,40,24,7,17,82
554,10,2012,34,1,3,44,0,277,14,55,0.255,10,49,0.204,4,6,0.667,0.345,5,6,0.833,4,30,34,16,8,2,8,38
562,1,2007,22,1,3,67,35,1169,182,392,0.464,25,72,0.347,157,320,0.491,0.496,53,87,0.609,39,89,128,26,38,23,43,118
562,2,2008,23,1,3,70,6,1039,158,392,0.403,38,120,0.317,120,272,0.441,0.452,55,81,0.679,50,99,149,32,39,23,34,96
562,5,2011,26,1,3,25,1,331,45,107,0.421,17,37,0.459,28,70,0.4,0.5,18,27,0.667,12,35,47,11,11,5,16,33
562,5,2011,26,1,3,27,1,336,46,110,0.418,17,38,0.447,29,72,0.403,0.495,18,27,0.667,13,35,48,11,12,5,16,33
566,12,1996,34,1,3,80,0,1532,233,510,0.457,0,3,0,233,507,0.46,0.457,114,144,0.792,71,129,200,74,28,65,78,254
566,16,2000,38,1,3,21,0,221,28,64,0.438,0,0,-1,28,64,0.438,0.438,11,14,0.786,8,24,32,7,3,6,9,42
567,5,2000,25,1,3,50,2,1092,185,463,0.4,31,93,0.333,154,370,0.416,0.433,91,106,0.858,36,124,160,81,30,14,112,101
567,5,2000,25,1,3,57,2,1166,196,496,0.395,32,101,0.317,164,395,0.415,0.427,107,125,0.856,41,132,173,84,30,15,117,113
568,1,1980,29,1,3,82,7,1994,362,763,0.474,12,41,0.293,350,722,0.485,0.482,178,241,0.739,106,224,330,156,120,36,143,214
568,2,1981,30,1,3,41,7,655,97,216,0.449,1,14,0.071,96,202,0.475,0.451,53,67,0.791,26,57,83,56,30,18,47,74
568,3,1982,31,1,3,56,27,1296,184,409,0.45,5,17,0.294,179,392,0.457,0.456,82,116,0.707,56,94,150,128,67,21,63,136
568,4,1983,32,1,3,77,0,883,135,315,0.429,3,19,0.158,132,296,0.446,0.433,60,81,0.741,51,86,137,71,48,10,79,140
568,5,1984,33,1,3,60,1,585,70,171,0.409,3,15,0.2,67,156,0.429,0.418,42,48,0.875,26,49,75,49,17,4,46,67
568,6,1985,34,1,3,47,0,397,62,149,0.416,9,23,0.391,53,126,0.421,0.446,17,17,1,21,22,43,24,21,6,24,44
570,1,2010,23,1,3,71,1,795,88,222,0.396,0,6,0,88,216,0.407,0.396,33,53,0.623,53,97,150,33,28,9,24,107
570,2,2012,25,1,3,20,9,327,37,99,0.374,7,19,0.368,30,80,0.375,0.409,14,16,0.875,28,22,50,15,12,1,9,36
570,2,2012,25,1,3,24,9,348,43,105,0.41,7,19,0.368,36,86,0.419,0.443,14,16,0.875,28,25,53,18,12,1,11,37
570,3,2013,26,1,3,66,12,1111,149,324,0.46,20,70,0.286,129,254,0.508,0.491,75,98,0.765,87,101,188,61,58,24,34,119
570,4,2014,27,1,3,73,73,2341,302,642,0.47,97,268,0.362,205,374,0.548,0.546,109,141,0.773,107,296,403,134,108,21,79,188
570,5,2015,28,1,3,6,6,203,25,51,0.49,11,24,0.458,14,27,0.519,0.598,11,14,0.786,11,27,38,9,7,0,7,18
574,1,1981,22,1,3,54,-1,672,114,247,0.462,3,10,0.3,111,237,0.468,0.468,70,95,0.737,34,31,65,52,23,1,50,99
585,1,1999,22,1,3,50,49,1760,345,766,0.45,19,66,0.288,326,700,0.466,0.463,204,268,0.761,94,189,283,149,55,77,110,140
585,2,2000,23,1,3,82,82,3126,788,1696,0.465,95,236,0.403,693,1460,0.475,0.493,436,551,0.791,150,326,476,322,110,92,178,263
585,3,2001,24,1,3,75,75,2979,762,1656,0.46,162,397,0.408,600,1259,0.477,0.509,384,502,0.765,176,240,416,291,114,82,167,205
585,7,2005,28,1,3,57,56,2220,572,1239,0.462,108,254,0.425,464,985,0.471,0.505,317,388,0.817,78,257,335,266,84,33,146,187
585,7,2005,28,1,3,77,76,2828,696,1541,0.452,127,313,0.406,569,1228,0.463,0.493,367,460,0.798,106,295,401,327,109,48,168,243
585,15,2013,36,1,3,81,3,2093,372,855,0.435,162,399,0.406,210,456,0.461,0.53,182,223,0.816,58,276,334,194,74,44,106,226
586,1,2010,21,1,3,77,31,1931,300,672,0.446,75,203,0.369,225,469,0.48,0.502,117,174,0.672,75,274,349,95,54,17,98,125
586,2,2011,22,1,3,71,27,1702,225,546,0.412,92,247,0.372,133,299,0.445,0.496,68,101,0.673,74,233,307,74,54,13,68,115
586,3,2012,23,1,3,65,35,1341,166,412,0.403,53,168,0.315,113,244,0.463,0.467,74,108,0.685,63,165,228,66,37,21,64,115
586,4,2013,24,1,3,43,1,503,63,160,0.394,25,76,0.329,38,84,0.452,0.472,22,41,0.537,20,94,114,28,25,12,22,45
586,6,2015,26,1,3,10,0,158,20,38,0.526,1,8,0.125,19,30,0.633,0.539,24,27,0.889,8,27,35,14,2,2,10,21
593,1,1991,21,1,3,63,0,730,204,419,0.487,1,6,0.167,203,413,0.492,0.488,110,166,0.663,77,73,150,35,22,5,69,70
593,2,1992,22,1,3,64,4,725,176,365,0.482,1,6,0.167,175,359,0.487,0.484,109,148,0.736,60,92,152,50,16,11,71,52
593,3,1993,23,1,3,74,46,1607,381,662,0.576,0,2,0,381,660,0.577,0.576,187,258,0.725,172,236,408,77,54,28,106,103
593,4,1994,24,1,3,53,43,1602,425,795,0.535,0,9,0,425,786,0.541,0.535,160,221,0.724,153,191,344,91,59,23,93,124
593,5,1995,25,1,3,58,54,2029,497,977,0.509,58,146,0.397,439,831,0.528,0.538,209,292,0.716,169,295,464,105,60,19,143,131
593,6,1996,26,1,3,78,71,2628,638,1203,0.53,51,184,0.277,587,1019,0.576,0.552,329,409,0.804,215,321,536,119,94,22,167,144
593,7,1997,27,1,3,8,8,279,34,83,0.41,5,21,0.238,29,62,0.468,0.44,13,15,0.867,11,42,53,15,5,6,17,19
593,7,1997,27,1,3,42,32,1147,248,534,0.464,21,81,0.259,227,453,0.501,0.484,126,171,0.737,91,186,277,49,28,17,68,94
593,7,1997,27,1,3,50,40,1426,282,617,0.457,26,102,0.255,256,515,0.497,0.478,139,186,0.747,102,228,330,64,33,23,85,113
593,8,1998,28,1,3,12,9,364,75,157,0.478,6,20,0.3,69,137,0.504,0.497,47,61,0.77,24,48,72,25,11,8,33,29
593,8,1998,28,1,3,35,16,626,129,258,0.5,15,50,0.3,114,208,0.548,0.529,60,84,0.714,51,98,149,35,22,8,39,59
593,8,1998,28,1,3,47,25,990,204,415,0.492,21,70,0.3,183,345,0.53,0.517,107,145,0.738,75,146,221,60,33,16,72,88
593,9,1999,29,1,3,13,5,352,59,140,0.421,11,28,0.393,48,112,0.429,0.461,34,49,0.694,23,62,85,12,7,5,28,23
593,10,2000,30,1,3,69,25,2064,447,1002,0.446,44,134,0.328,403,868,0.464,0.468,209,248,0.843,172,290,462,90,56,24,125,165
593,11,2001,31,1,3,13,0,166,28,71,0.394,11,40,0.275,17,31,0.548,0.472,8,10,0.8,7,19,26,7,6,3,9,19
593,11,2001,31,1,3,27,0,393,73,158,0.462,11,33,0.333,62,125,0.496,0.497,29,33,0.879,27,53,80,13,10,4,23,42
593,11,2001,31,1,3,40,0,559,101,229,0.441,22,73,0.301,79,156,0.506,0.489,37,43,0.86,34,72,106,20,16,7,32,61
607,1,2008,20,1,3,35,16,685,106,242,0.438,9,30,0.3,97,212,0.458,0.457,34,54,0.63,38,89,127,33,15,16,27,83
607,2,2009,21,1,3,82,70,2735,455,1054,0.432,103,314,0.328,352,740,0.476,0.481,171,215,0.795,91,354,445,170,71,75,139,250
607,4,2011,23,1,3,21,19,642,101,241,0.419,26,75,0.347,75,166,0.452,0.473,34,42,0.81,13,92,105,34,14,24,37,47
607,4,2011,23,1,3,51,30,1759,328,712,0.461,86,245,0.351,242,467,0.518,0.521,96,119,0.807,62,241,303,86,34,70,67,152
607,4,2011,23,1,3,72,49,2401,429,953,0.45,112,320,0.35,317,633,0.501,0.509,130,161,0.807,75,333,408,120,48,94,104,199
607,5,2012,24,1,3,8,6,215,31,79,0.392,3,12,0.25,28,67,0.418,0.411,10,12,0.833,6,35,41,17,6,6,18,18
607,7,2014,26,1,3,62,55,1927,307,738,0.416,122,351,0.348,185,387,0.478,0.499,110,152,0.724,58,236,294,114,46,31,79,193
607,8,2015,27,1,3,8,6,212,29,75,0.387,10,37,0.27,19,38,0.5,0.453,14,16,0.875,5,33,38,12,3,4,10,28
609,1,1986,22,1,3,36,0,273,49,88,0.557,0,0,-1,49,88,0.557,0.557,24,36,0.667,13,26,39,8,2,6,18,37
610,3,1996,24,1,3,70,70,2324,426,905,0.471,52,154,0.338,374,751,0.498,0.499,151,214,0.706,67,172,239,154,67,18,129,205
610,11,2004,32,1,3,79,7,2067,278,578,0.481,0,10,0,278,568,0.489,0.481,47,77,0.61,77,183,260,136,60,12,85,184
610,13,2006,34,1,3,42,0,448,42,108,0.389,0,8,0,42,100,0.42,0.389,8,8,1,20,41,61,19,13,2,17,38
612,1,1989,21,1,3,81,1,1539,277,634,0.437,5,24,0.208,272,610,0.446,0.441,191,244,0.783,114,142,256,77,48,11,136,161
612,2,1990,22,1,3,41,0,492,90,178,0.506,3,8,0.375,87,170,0.512,0.514,61,87,0.701,28,47,75,27,23,4,40,59
612,2,1990,22,1,3,55,0,591,105,220,0.477,3,9,0.333,102,211,0.483,0.484,80,111,0.721,35,55,90,31,26,5,45,70
612,3,1991,23,1,3,18,0,110,17,46,0.37,0,0,-1,17,46,0.37,0.37,9,16,0.563,11,7,18,2,3,1,6,16
619,1,2014,27,1,3,31,0,198,22,62,0.355,9,31,0.29,13,31,0.419,0.427,18,24,0.75,13,25,38,8,2,3,6,19
626,3,1996,25,1,3,23,0,218,35,73,0.479,10,19,0.526,25,54,0.463,0.548,13,22,0.591,8,26,34,25,12,3,19,41
626,3,1996,25,1,3,32,17,818,115,264,0.436,36,87,0.414,79,177,0.446,0.504,56,71,0.789,26,94,120,92,58,16,76,100
626,3,1996,25,1,3,55,17,1036,150,337,0.445,46,106,0.434,104,231,0.45,0.513,69,93,0.742,34,120,154,117,70,19,95,141
628,2,2011,23,1,3,33,0,392,56,127,0.441,0,5,0,56,122,0.459,0.441,22,37,0.595,33,51,84,5,7,15,26,39
628,2,2011,23,1,3,42,0,464,68,158,0.43,0,5,0,68,153,0.444,0.43,27,47,0.574,37,64,101,9,8,18,28,45
632,1,2013,24,1,3,49,16,812,74,189,0.392,25,87,0.287,49,102,0.48,0.458,14,30,0.467,31,88,119,43,26,12,43,75
632,2,2014,25,1,3,21,0,184,17,42,0.405,3,18,0.167,14,24,0.583,0.44,10,11,0.909,9,30,39,12,3,3,11,16
647,1,1991,25,1,3,52,1,320,28,75,0.373,0,1,0,28,74,0.378,0.373,12,22,0.545,42,37,79,3,6,4,5,45
650,1,1988,26,1,3,29,11,431,66,191,0.346,1,2,0.5,65,189,0.344,0.348,20,36,0.556,36,45,81,13,11,6,16,51
660,1,2007,22,1,3,52,9,777,87,228,0.382,13,47,0.277,74,181,0.409,0.41,48,82,0.585,28,76,104,83,32,3,57,75
668,1,1984,23,1,3,48,0,446,81,163,0.497,0,3,0,81,160,0.506,0.497,56,91,0.615,19,37,56,38,23,18,46,49
679,2,2009,21,1,3,75,4,1833,242,645,0.375,153,395,0.387,89,250,0.356,0.494,49,56,0.875,19,170,189,71,39,10,42,125
690,2,2014,29,1,3,41,0,265,55,117,0.47,33,79,0.418,22,38,0.579,0.611,10,14,0.714,7,25,32,18,3,7,14,38
690,3,2015,30,1,3,11,6,353,57,153,0.373,27,79,0.342,30,74,0.405,0.461,15,24,0.625,15,39,54,20,4,3,33,28
694,1,1986,23,1,3,16,0,174,27,64,0.422,0,1,0,27,63,0.429,0.422,10,14,0.714,11,14,25,11,11,2,12,21
694,2,1987,24,1,3,32,0,438,43,117,0.368,1,4,0.25,42,113,0.372,0.372,42,57,0.737,36,60,96,17,17,2,20,48
694,2,1987,24,1,3,31,15,732,113,264,0.428,0,0,-1,113,264,0.428,0.428,49,67,0.731,52,67,119,80,38,3,46,81
694,2,1987,24,1,3,63,15,1170,156,381,0.409,1,4,0.25,155,377,0.411,0.411,91,124,0.734,88,127,215,97,55,5,66,129
694,3,1988,25,1,3,30,1,591,99,203,0.488,1,3,0.333,98,200,0.49,0.49,33,40,0.825,48,82,130,59,30,3,38,53
694,3,1988,25,1,3,54,4,1148,158,322,0.491,0,3,0,158,319,0.495,0.491,77,98,0.786,79,141,220,56,42,15,66,128
694,3,1988,25,1,3,84,5,1739,257,525,0.49,1,6,0.167,256,519,0.493,0.49,110,138,0.797,127,223,350,115,72,18,104,181
694,4,1989,26,1,3,77,30,1655,245,454,0.54,0,2,0,245,452,0.542,0.54,141,179,0.788,176,222,398,118,82,13,92,222
694,5,1990,27,1,3,82,80,3011,521,1083,0.481,0,11,0,521,1072,0.486,0.481,161,209,0.77,219,385,604,216,175,41,143,288
694,6,1991,28,1,3,82,82,3196,587,1311,0.448,2,10,0.2,585,1301,0.45,0.449,296,371,0.798,185,404,589,347,162,53,209,257
694,7,1992,29,1,3,11,8,344,57,142,0.401,0,1,0,57,141,0.404,0.401,44,53,0.83,24,45,69,33,12,6,26,31
694,7,1992,29,1,3,69,1,1863,246,488,0.504,0,3,0,246,485,0.507,0.504,130,148,0.878,139,264,403,107,70,14,71,162
694,7,1992,29,1,3,80,9,2207,303,630,0.481,0,4,0,303,626,0.484,0.481,174,201,0.866,163,309,472,140,82,20,97,193
694,8,1993,30,1,3,82,58,2555,385,766,0.503,0,5,0,385,761,0.506,0.503,180,218,0.826,194,325,519,173,108,32,108,252
694,9,1994,31,1,3,82,17,2149,268,588,0.456,6,29,0.207,262,559,0.469,0.461,117,144,0.813,150,239,389,122,99,24,92,212
694,10,1995,32,1,3,81,4,1389,205,464,0.442,14,56,0.25,191,408,0.468,0.457,78,114,0.684,98,164,262,67,55,16,74,161
694,11,1996,33,1,3,22,0,354,38,92,0.413,2,6,0.333,36,86,0.419,0.424,23,28,0.821,26,39,65,23,16,3,17,51
694,11,1996,33,1,3,49,2,930,117,259,0.452,1,12,0.083,116,247,0.47,0.454,77,92,0.837,55,124,179,61,47,17,50,96
694,11,1996,33,1,3,71,2,1284,155,351,0.442,3,18,0.167,152,333,0.456,0.446,100,120,0.833,81,163,244,84,63,20,67,147
694,12,1997,34,1,3,70,65,2305,253,600,0.422,74,208,0.356,179,392,0.457,0.483,86,108,0.796,76,218,294,124,90,7,85,176
694,13,1998,35,1,3,79,79,2699,328,747,0.439,49,141,0.348,279,606,0.46,0.472,101,128,0.789,78,284,362,173,105,7,86,197
694,14,1999,36,1,3,47,6,1066,131,335,0.391,38,119,0.319,93,216,0.431,0.448,52,80,0.65,37,108,145,43,31,7,43,74
694,15,2000,37,1,3,54,5,941,88,247,0.356,10,44,0.227,78,203,0.384,0.377,33,39,0.846,40,125,165,60,36,5,29,99
694,16,2001,38,1,3,15,1,117,9,38,0.237,0,5,0,9,33,0.273,0.237,2,4,0.5,3,10,13,4,2,0,3,18
698,1,1980,28,1,3,24,-1,160,29,81,0.358,2,9,0.222,27,72,0.375,0.37,8,14,0.571,2,17,19,12,7,1,13,24
718,1,1988,22,1,3,29,0,258,34,68,0.5,0,0,-1,34,68,0.5,0.5,19,25,0.76,27,37,64,15,5,8,25,42
730,1,2013,22,1,3,78,16,1353,141,367,0.384,63,192,0.328,78,175,0.446,0.47,47,73,0.644,35,152,187,94,63,17,49,128
730,2,2014,23,1,3,78,8,1254,130,296,0.439,50,151,0.331,80,145,0.552,0.524,46,61,0.754,46,148,194,60,59,21,41,100
735,2,2011,23,1,3,22,9,529,92,181,0.508,1,9,0.111,91,172,0.529,0.511,13,17,0.765,23,65,88,13,15,11,18,38
735,4,2013,25,1,3,80,9,2010,314,671,0.468,0,6,0,314,665,0.472,0.468,67,103,0.65,142,266,408,67,84,38,56,153
735,5,2014,26,1,3,81,7,1635,236,509,0.464,0,5,0,236,504,0.468,0.464,38,67,0.567,112,218,330,83,62,58,42,146
738,7,1989,27,1,3,80,78,2824,730,1563,0.467,7,15,0.467,723,1548,0.467,0.469,362,460,0.787,281,369,650,198,106,72,201,265
768,1,2012,21,1,3,26,2,258,48,111,0.432,17,47,0.362,31,64,0.484,0.509,2,5,0.4,11,51,62,20,4,3,16,15
768,2,2013,22,1,3,40,1,397,84,201,0.418,27,73,0.37,57,128,0.445,0.485,13,26,0.5,32,63,95,23,15,8,19,24
768,3,2014,23,1,3,21,1,349,48,122,0.393,25,69,0.362,23,53,0.434,0.496,17,20,0.85,9,52,61,18,13,7,19,36
768,3,2014,23,1,3,39,11,670,99,254,0.39,45,129,0.349,54,125,0.432,0.478,23,31,0.742,23,110,133,34,31,13,27,31
768,3,2014,23,1,3,60,12,1019,147,376,0.391,70,198,0.354,77,178,0.433,0.484,40,51,0.784,32,162,194,52,44,20,46,67
773,2,2001,22,1,3,78,42,2519,547,1249,0.438,40,146,0.274,507,1103,0.46,0.454,277,319,0.868,75,163,238,224,75,10,201,203
782,1,1995,23,1,3,46,7,424,68,121,0.562,1,3,0.333,67,118,0.568,0.566,16,39,0.41,14,39,53,30,19,4,30,48
782,2,1996,24,1,3,63,7,838,112,214,0.523,1,3,0.333,111,211,0.526,0.526,47,73,0.644,40,58,98,47,28,5,56,94
782,3,1997,25,1,3,24,0,133,16,35,0.457,0,0,-1,16,35,0.457,0.457,10,14,0.714,4,14,18,12,9,1,11,15
792,1,2004,25,1,3,41,4,507,46,130,0.354,9,30,0.3,37,100,0.37,0.388,22,27,0.815,30,40,70,19,10,9,15,67
800,1,1981,23,1,3,74,-1,1259,138,289,0.478,1,5,0.2,137,284,0.482,0.479,119,150,0.793,67,86,153,111,58,20,84,168
800,2,1982,24,1,3,81,76,1974,167,357,0.468,0,4,0,167,353,0.473,0.468,138,176,0.784,99,167,266,183,81,30,106,250
800,3,1983,25,1,3,82,8,1547,187,437,0.428,1,7,0.143,186,430,0.433,0.429,125,160,0.781,80,156,236,268,75,15,144,220
800,4,1984,26,1,3,80,14,1469,132,306,0.431,3,12,0.25,129,294,0.439,0.436,167,207,0.807,66,139,205,252,68,19,109,255
800,5,1985,27,1,3,80,1,1673,220,522,0.421,1,15,0.067,219,507,0.432,0.422,180,238,0.756,88,119,207,210,84,26,115,291
800,6,1986,28,1,3,79,0,1982,331,741,0.447,8,41,0.195,323,700,0.461,0.452,318,405,0.785,88,176,264,316,107,16,165,277
800,8,1988,30,1,3,77,0,1334,109,287,0.38,3,16,0.188,106,271,0.391,0.385,129,163,0.791,39,132,171,166,64,17,95,185
806,1,2013,19,1,3,76,59,1974,260,564,0.461,32,117,0.274,228,447,0.51,0.489,73,128,0.57,122,213,335,50,88,62,69,144
806,2,2014,20,1,3,80,41,1950,224,483,0.464,59,154,0.383,165,329,0.502,0.525,85,143,0.594,69,195,264,80,97,50,86,140
808,3,1982,25,1,3,82,17,1814,179,369,0.485,0,1,0,179,368,0.486,0.485,64,93,0.688,153,317,470,110,58,67,78,192
812,1,1999,22,1,3,50,22,1114,148,320,0.463,10,25,0.4,138,295,0.468,0.478,102,143,0.713,88,126,214,45,30,6,73,112
812,3,2002,25,1,3,81,81,2541,386,838,0.461,21,69,0.304,365,769,0.475,0.473,165,222,0.743,203,370,573,107,70,5,127,201
812,4,2003,26,1,3,78,69,2557,521,1020,0.511,66,160,0.413,455,860,0.529,0.543,262,331,0.792,190,324,514,133,73,17,160,217
812,5,2004,27,1,3,31,31,1134,193,410,0.471,8,33,0.242,185,377,0.491,0.48,108,157,0.688,91,156,247,63,22,2,65,102
812,6,2005,28,1,3,78,55,2584,418,855,0.489,9,43,0.209,409,812,0.504,0.494,245,315,0.778,196,284,480,142,70,16,133,250
812,7,2006,29,1,3,71,32,1944,322,678,0.475,14,39,0.359,308,639,0.482,0.485,227,313,0.725,158,210,368,98,59,14,109,202
812,8,2007,30,1,3,77,2,1965,322,656,0.491,13,39,0.333,309,617,0.501,0.501,237,309,0.767,117,236,353,99,52,11,118,232
812,9,2008,31,1,3,76,0,1374,237,474,0.5,2,10,0.2,235,464,0.506,0.502,146,205,0.712,96,144,240,82,45,14,95,162
822,5,2003,22,1,3,82,37,2467,389,896,0.434,13,46,0.283,376,850,0.442,0.441,211,274,0.77,159,352,511,125,71,33,163,280
822,7,2005,24,1,3,66,66,2550,453,986,0.459,16,74,0.216,437,912,0.479,0.468,236,351,0.672,145,316,461,208,85,16,204,249
828,1,2012,19,1,3,42,9,479,79,169,0.467,6,23,0.261,73,146,0.5,0.485,44,54,0.815,30,71,101,22,13,7,31,45
828,2,2013,20,1,3,28,14,325,53,115,0.461,7,21,0.333,46,94,0.489,0.491,23,26,0.885,17,40,57,13,8,7,18,31
828,2,2013,20,1,3,55,34,1299,233,512,0.455,34,108,0.315,199,404,0.493,0.488,103,137,0.752,73,214,287,69,32,44,66,120
828,4,2015,22,1,3,11,11,403,75,162,0.463,9,24,0.375,66,138,0.478,0.491,38,48,0.792,19,74,93,19,10,7,30,39
831,2,2003,22,1,3,77,27,1613,246,551,0.446,1,7,0.143,245,544,0.45,0.447,118,176,0.67,125,284,409,100,48,27,123,203
835,8,2009,29,1,3,53,31,1094,86,191,0.45,2,8,0.25,84,183,0.459,0.455,20,25,0.8,50,96,146,51,21,16,30,92
835,9,2010,30,1,3,52,31,1106,90,219,0.411,0,5,0,90,214,0.421,0.411,52,69,0.754,56,96,152,50,17,9,47,91
853,1,2004,22,1,3,70,42,2044,278,695,0.4,40,131,0.305,238,564,0.422,0.429,77,98,0.786,71,193,264,106,71,11,110,157
853,2,2005,23,1,3,54,22,1560,206,530,0.389,42,123,0.341,164,407,0.403,0.428,99,118,0.839,41,186,227,90,49,9,62,107
853,4,2007,25,1,3,81,17,1626,224,546,0.41,66,183,0.361,158,363,0.435,0.471,71,84,0.845,42,168,210,80,48,13,56,160
853,5,2008,26,1,3,82,1,1287,217,504,0.431,73,194,0.376,144,310,0.465,0.503,45,60,0.75,35,143,178,62,47,6,47,137
853,6,2009,27,1,3,74,1,1832,257,577,0.445,94,244,0.385,163,333,0.489,0.527,36,52,0.692,27,240,267,54,52,7,49,162
853,7,2010,28,1,3,45,19,1033,138,328,0.421,60,179,0.335,78,149,0.523,0.512,14,18,0.778,9,99,108,40,29,9,28,91
856,1,2011,20,1,3,72,17,1218,142,293,0.485,35,74,0.473,107,219,0.489,0.544,69,97,0.711,41,98,139,81,30,19,70,106
856,2,2012,21,1,3,66,58,2015,267,586,0.456,55,159,0.346,212,427,0.496,0.503,193,232,0.832,59,171,230,207,53,41,109,106
856,3,2013,22,1,3,72,27,2104,336,773,0.435,102,246,0.415,234,527,0.444,0.501,243,294,0.827,51,174,225,213,58,38,120,125
856,4,2014,23,1,3,77,77,2800,426,1032,0.413,85,280,0.304,341,752,0.453,0.454,311,381,0.816,62,329,391,400,110,40,212,155
856,5,2015,24,1,3,11,11,385,71,147,0.483,19,54,0.352,52,93,0.559,0.548,50,56,0.893,7,54,61,53,14,4,21,21
857,1,2011,24,1,3,42,0,419,55,154,0.357,17,60,0.283,38,94,0.404,0.412,33,42,0.786,23,47,70,28,12,7,19,44
857,2,2012,25,1,3,26,0,141,13,38,0.342,4,14,0.286,9,24,0.375,0.395,7,12,0.583,2,14,16,4,3,1,9,18
868,4,1999,26,1,3,38,37,1142,187,423,0.442,0,1,0,187,422,0.443,0.442,100,149,0.671,100,150,250,28,33,19,58,96
871,1,1998,22,1,3,82,71,2527,348,725,0.48,0,4,0,348,721,0.483,0.48,136,190,0.716,71,254,325,168,96,45,165,238
871,2,1999,23,1,3,50,48,1517,189,453,0.417,2,12,0.167,187,441,0.424,0.419,74,91,0.813,45,152,197,113,58,24,97,136
871,3,2000,24,1,3,61,7,1107,129,326,0.396,1,15,0.067,128,311,0.412,0.397,69,104,0.663,34,106,140,55,39,17,68,99
871,4,2001,25,1,3,55,10,961,102,262,0.389,1,8,0.125,101,254,0.398,0.391,30,46,0.652,19,71,90,79,29,23,63,101
872,1,1999,22,1,3,30,0,331,35,96,0.365,2,5,0.4,33,91,0.363,0.375,25,45,0.556,20,27,47,22,9,4,18,29
880,3,2013,21,1,3,50,2,625,66,161,0.41,4,11,0.364,62,150,0.413,0.422,58,92,0.63,21,69,90,13,16,5,31,72
880,4,2014,22,1,3,43,5,908,144,345,0.417,28,81,0.346,116,264,0.439,0.458,116,177,0.655,25,89,114,51,44,7,57,79
883,3,2009,29,1,3,59,0,630,82,207,0.396,41,120,0.342,41,87,0.471,0.495,19,25,0.76,28,79,107,22,7,4,17,43
901,1,1983,23,1,3,82,42,2196,313,698,0.448,13,41,0.317,300,657,0.457,0.458,209,264,0.792,159,207,366,175,66,65,127,248
901,2,1984,24,1,3,78,6,1577,193,432,0.447,1,22,0.045,192,410,0.468,0.448,113,156,0.724,87,119,206,116,49,29,76,161
901,3,1985,25,1,3,68,5,942,119,270,0.441,10,37,0.27,109,233,0.468,0.459,60,90,0.667,55,92,147,73,21,13,49,91
901,4,1986,26,1,3,11,0,128,18,40,0.45,0,2,0,18,38,0.474,0.45,11,16,0.688,5,19,24,12,2,3,5,21
901,4,1986,26,1,3,30,0,332,39,106,0.368,1,9,0.111,38,97,0.392,0.373,19,27,0.704,14,37,51,24,9,11,13,49
901,5,1987,27,1,3,73,28,1497,214,412,0.519,3,17,0.176,211,395,0.534,0.523,200,240,0.833,72,165,237,96,40,21,76,145
901,6,1988,28,1,3,68,67,2188,381,725,0.526,19,39,0.487,362,686,0.528,0.539,273,322,0.848,94,199,293,188,70,31,111,188
901,9,1991,31,1,3,82,9,2024,259,559,0.463,73,220,0.332,186,339,0.549,0.529,185,226,0.819,109,245,354,113,52,37,65,198
901,10,1992,32,1,3,25,6,535,87,211,0.412,33,95,0.347,54,116,0.466,0.491,48,59,0.814,30,55,85,22,15,13,15,75
901,11,1993,33,1,3,69,4,1425,199,483,0.412,43,133,0.323,156,350,0.446,0.457,130,151,0.861,66,127,193,119,51,29,63,141
901,12,1994,34,1,3,36,11,547,71,163,0.436,22,50,0.44,49,113,0.434,0.503,31,42,0.738,25,57,82,36,25,14,21,53
909,1,2014,22,1,3,28,0,226,17,40,0.425,7,23,0.304,10,17,0.588,0.513,6,7,0.857,9,32,41,12,5,2,13,19
909,2,2015,23,1,3,11,11,371,47,117,0.402,12,35,0.343,35,82,0.427,0.453,33,44,0.75,20,46,66,16,11,3,21,25
914,1,1984,22,1,3,80,61,1858,184,371,0.496,0,0,-1,184,371,0.496,0.496,69,117,0.59,175,324,499,69,31,145,109,306
914,3,1986,24,1,3,82,82,2834,621,1167,0.532,0,4,0,621,1163,0.534,0.532,364,506,0.719,167,472,639,102,62,112,188,316
914,4,1987,25,1,3,76,58,2489,393,823,0.478,0,1,0,393,822,0.478,0.478,273,360,0.758,150,338,488,60,45,161,149,281
914,5,1988,26,1,3,29,10,845,123,272,0.452,0,1,0,123,271,0.454,0.452,89,124,0.718,53,116,169,27,24,68,63,90
914,5,1988,26,1,3,48,47,1747,330,658,0.502,0,1,0,330,657,0.502,0.502,183,227,0.806,106,242,348,72,45,72,106,185
914,5,1988,26,1,3,77,57,2592,453,930,0.487,0,2,0,453,928,0.488,0.487,272,351,0.775,159,358,517,99,69,140,169,275
914,6,1989,27,1,3,82,39,2542,495,1027,0.482,0,2,0,495,1025,0.483,0.482,318,420,0.757,152,370,522,71,34,121,165,298
954,4,1991,25,1,3,61,0,728,104,244,0.426,1,5,0.2,103,239,0.431,0.428,55,83,0.663,49,60,109,65,25,14,59,79
960,1,1993,22,1,3,79,79,2330,323,682,0.474,12,47,0.255,311,635,0.49,0.482,143,200,0.715,113,279,392,191,80,83,156,210
960,2,1994,23,1,3,81,81,2370,322,702,0.459,44,136,0.324,278,566,0.491,0.49,115,157,0.732,128,312,440,231,119,75,137,186
960,4,1996,25,1,3,71,71,2634,300,732,0.41,142,388,0.366,158,344,0.459,0.507,111,143,0.776,97,315,412,281,116,109,160,197
960,5,1997,26,1,3,22,14,676,75,165,0.455,25,76,0.329,50,89,0.562,0.53,28,40,0.7,28,90,118,56,38,29,26,72
960,5,1997,26,1,3,32,15,719,82,195,0.421,24,78,0.308,58,117,0.496,0.482,32,50,0.64,40,79,119,54,28,26,46,81
960,5,1997,26,1,3,54,29,1395,157,360,0.436,49,154,0.318,108,206,0.524,0.504,60,90,0.667,68,169,237,110,66,55,72,153
963,1,1992,24,1,3,27,0,318,54,104,0.519,1,2,0.5,53,102,0.52,0.524,22,31,0.71,17,34,51,14,11,8,15,55
963,2,1993,25,1,3,68,22,1295,183,414,0.442,1,7,0.143,182,407,0.447,0.443,72,94,0.766,66,146,212,67,55,34,68,217
972,3,1982,25,1,3,31,2,735,119,255,0.467,0,1,0,119,254,0.469,0.467,85,117,0.726,86,115,201,24,27,3,62,116
972,3,1982,25,1,3,52,38,1104,207,410,0.505,0,3,0,207,407,0.509,0.505,106,163,0.65,101,171,272,67,38,16,99,176
972,3,1982,25,1,3,83,40,1839,326,665,0.49,0,4,0,326,661,0.493,0.49,191,280,0.682,187,286,473,91,65,19,161,292
972,4,1983,26,1,3,82,38,1953,288,597,0.482,0,2,0,288,595,0.484,0.482,204,296,0.689,222,249,471,89,87,8,158,271
972,5,1984,27,1,3,80,6,1799,321,628,0.511,0,1,0,321,627,0.512,0.511,221,299,0.739,172,208,380,86,71,6,115,244
972,6,1985,28,1,3,76,55,2249,415,822,0.505,0,4,0,415,818,0.507,0.505,371,494,0.751,214,265,479,114,81,9,178,258
972,7,1986,29,1,3,23,21,640,93,198,0.47,0,1,0,93,197,0.472,0.47,76,112,0.679,48,72,120,29,20,3,66,78
972,8,1987,30,1,3,68,68,2083,321,605,0.531,0,4,0,321,601,0.534,0.531,162,272,0.596,178,210,388,136,66,7,156,224
972,9,1988,31,1,3,78,59,1631,237,485,0.489,0,5,0,237,480,0.494,0.489,182,243,0.749,117,164,281,81,50,7,118,167
972,10,1989,32,1,3,31,0,191,28,63,0.444,0,0,-1,28,63,0.444,0.444,17,25,0.68,14,26,40,11,6,0,9,20
978,2,1994,24,1,3,71,2,866,81,177,0.458,1,7,0.143,80,170,0.471,0.46,33,54,0.611,67,127,194,32,33,31,49,181
978,3,1995,25,1,3,39,0,258,49,107,0.458,6,22,0.273,43,85,0.506,0.486,28,38,0.737,20,35,55,6,13,5,20,50
978,4,1996,26,1,3,25,0,276,32,64,0.5,1,3,0.333,31,61,0.508,0.508,21,26,0.808,31,53,84,7,13,7,17,59
980,1,2004,23,1,3,67,29,1589,229,532,0.43,20,66,0.303,209,466,0.448,0.449,97,138,0.703,149,219,368,97,69,54,67,168
980,2,2005,24,1,3,76,76,2446,377,793,0.475,34,115,0.296,343,678,0.506,0.497,170,232,0.733,169,315,484,109,116,49,122,211
980,3,2006,25,1,3,59,58,1915,350,743,0.471,27,63,0.429,323,680,0.475,0.489,196,267,0.734,123,248,371,111,68,26,79,167
980,4,2007,26,1,3,70,69,2455,493,1075,0.459,92,239,0.385,401,836,0.48,0.501,243,294,0.827,130,345,475,127,82,56,123,180
980,5,2008,27,1,3,76,76,2757,567,1247,0.455,67,210,0.319,500,1037,0.482,0.482,312,384,0.813,120,412,532,164,59,32,114,202
980,6,2009,28,1,3,52,51,1663,353,783,0.451,58,168,0.345,295,615,0.48,0.488,172,220,0.782,59,204,263,83,55,30,89,135
980,7,2010,29,1,3,31,9,827,137,342,0.401,20,75,0.267,117,267,0.438,0.43,94,119,0.79,26,86,112,44,23,9,43,78
980,7,2010,29,1,3,35,12,918,157,388,0.405,23,86,0.267,134,302,0.444,0.434,109,139,0.784,30,95,125,48,26,11,46,91
980,8,2011,30,1,3,18,10,409,58,162,0.358,7,29,0.241,51,133,0.383,0.38,29,47,0.617,18,56,74,24,13,5,20,34
980,9,2012,31,1,3,43,18,991,144,361,0.399,9,37,0.243,135,324,0.417,0.411,75,97,0.773,39,119,158,50,32,10,53,91
980,10,2013,32,1,3,11,4,207,31,77,0.403,5,16,0.313,26,61,0.426,0.435,7,12,0.583,9,27,36,4,10,3,10,18
982,3,1997,23,1,3,82,82,3324,638,1313,0.486,0,2,0,638,1311,0.487,0.486,294,389,0.756,202,450,652,311,93,23,246,259
982,5,1999,25,1,3,36,36,1430,286,604,0.474,0,3,0,286,601,0.476,0.474,110,146,0.753,90,203,293,107,42,14,95,130
982,15,2009,35,1,3,39,2,450,74,145,0.51,0,0,-1,74,145,0.51,0.51,23,34,0.676,29,43,72,24,6,5,26,67
982,15,2009,35,1,3,42,2,472,75,147,0.51,0,0,-1,75,147,0.51,0.51,23,34,0.676,30,46,76,26,7,6,26,71
984,1,2014,24,1,3,53,5,655,67,177,0.379,32,89,0.36,35,88,0.398,0.469,15,16,0.938,35,97,132,23,16,2,10,57
987,2,2005,25,1,3,35,0,317,42,103,0.408,0,2,0,42,101,0.416,0.408,18,37,0.486,50,37,87,6,10,1,23,35
992,5,2009,23,1,3,29,0,265,38,90,0.422,0,0,-1,38,90,0.422,0.422,38,48,0.792,24,46,70,10,8,6,8,31
1023,1,1989,23,1,3,41,0,231,35,83,0.422,0,0,-1,35,83,0.422,0.422,30,44,0.682,19,22,41,10,7,6,12,33
1023,2,1991,25,1,3,78,2,1165,174,356,0.489,2,3,0.667,172,353,0.487,0.492,125,156,0.801,97,82,179,55,33,27,78,151
1023,3,1992,26,1,3,66,12,1598,331,632,0.524,11,33,0.333,320,599,0.534,0.532,166,218,0.761,105,105,210,92,49,17,99,134
1023,4,1993,27,1,3,82,15,1736,327,696,0.47,9,36,0.25,318,660,0.482,0.476,176,226,0.779,97,94,191,132,59,17,103,160
1023,5,1994,28,1,3,72,13,1155,184,379,0.485,1,9,0.111,183,370,0.495,0.487,144,184,0.783,62,67,129,65,44,16,64,85
1023,6,1995,29,1,3,56,1,607,83,173,0.48,1,6,0.167,82,167,0.491,0.483,64,85,0.753,50,38,88,31,26,6,43,79
1023,7,1996,30,1,3,54,6,591,80,166,0.482,0,8,0,80,158,0.506,0.482,42,57,0.737,32,61,93,30,23,3,34,83
1023,8,1997,31,1,3,62,18,1115,159,337,0.472,18,44,0.409,141,293,0.481,0.499,58,94,0.617,57,84,141,66,38,6,55,120
1023,9,1998,32,1,3,50,5,461,41,111,0.369,0,6,0,41,105,0.39,0.369,12,22,0.545,25,22,47,26,21,6,18,50
1026,11,2001,34,1,3,80,29,1688,178,375,0.475,70,156,0.449,108,219,0.493,0.568,22,30,0.733,55,168,223,71,28,21,50,169
1026,12,2002,35,1,3,50,2,799,76,177,0.429,43,99,0.434,33,78,0.423,0.551,34,36,0.944,15,75,90,48,16,9,22,70
1026,13,2003,36,1,3,64,1,601,44,124,0.355,21,60,0.35,23,64,0.359,0.44,10,13,0.769,20,55,75,21,7,9,27,55
1029,1,1985,22,1,3,51,1,535,84,191,0.44,0,0,-1,84,191,0.44,0.44,27,36,0.75,41,43,84,38,9,10,32,84
1029,2,1986,23,1,3,78,3,1120,204,398,0.513,0,4,0,204,394,0.518,0.513,91,132,0.689,59,144,203,79,51,15,77,170
1029,3,1987,24,1,3,44,17,861,153,344,0.445,3,12,0.25,150,332,0.452,0.449,72,89,0.809,63,83,146,60,31,11,52,120
1029,3,1987,24,1,3,48,17,883,159,352,0.452,3,12,0.25,156,340,0.459,0.456,73,94,0.777,63,85,148,61,32,11,53,123
1029,4,1988,25,1,3,7,0,154,16,36,0.444,0,0,-1,16,36,0.444,0.444,20,26,0.769,13,16,29,10,5,2,19,17
1030,3,2013,24,1,3,51,22,1037,102,223,0.457,2,14,0.143,100,209,0.478,0.462,34,53,0.642,59,149,208,60,32,8,42,63
1030,4,2014,25,1,3,30,2,322,27,67,0.403,0,5,0,27,62,0.435,0.403,14,22,0.636,15,44,59,20,10,3,11,25
1039,1,1996,22,1,3,82,72,3212,465,976,0.476,61,186,0.328,404,790,0.511,0.508,242,323,0.749,139,235,374,289,85,31,133,199
1039,2,1997,23,1,3,27,18,796,141,297,0.475,14,55,0.255,127,242,0.525,0.498,56,69,0.812,34,86,120,68,18,4,44,42
1039,2,1997,23,1,3,56,36,1994,334,774,0.432,87,225,0.387,247,549,0.45,0.488,142,176,0.807,54,198,252,156,50,20,120,96
1039,2,1997,23,1,3,83,54,2790,475,1071,0.444,101,280,0.361,374,791,0.473,0.491,198,245,0.808,88,284,372,224,68,24,164,138
1039,3,1998,24,1,3,82,82,3394,675,1505,0.449,87,244,0.357,588,1261,0.466,0.477,326,416,0.784,150,288,438,405,132,30,219,163
1039,4,1999,25,1,3,50,50,2051,389,876,0.444,45,136,0.331,344,740,0.465,0.47,186,226,0.823,69,194,263,218,66,15,107,96
1039,5,2000,26,1,3,82,82,3464,748,1636,0.457,99,247,0.401,649,1389,0.467,0.487,260,317,0.82,122,396,518,438,109,32,196,171
1039,6,2001,27,1,3,82,82,3443,711,1552,0.458,91,263,0.346,620,1289,0.481,0.487,252,325,0.775,109,316,425,360,118,32,190,174
1039,7,2002,28,1,3,69,69,2754,569,1228,0.463,76,224,0.339,493,1004,0.491,0.494,210,251,0.837,90,270,360,230,65,25,117,144
1039,8,2003,29,1,3,69,69,2642,507,1193,0.425,119,322,0.37,388,871,0.445,0.475,198,230,0.861,107,295,402,205,76,21,114,105
1039,12,2007,33,1,3,82,16,1823,273,663,0.412,104,286,0.364,169,377,0.448,0.49,90,98,0.918,34,189,223,108,32,16,46,76
1039,14,2009,35,1,3,81,77,2336,301,689,0.437,131,319,0.411,170,370,0.459,0.532,51,62,0.823,26,244,270,114,37,17,61,82
1039,15,2010,36,1,3,21,1,314,44,87,0.506,19,41,0.463,25,46,0.543,0.615,2,6,0.333,1,32,33,24,4,2,8,21
1039,15,2010,36,1,3,25,6,395,37,97,0.381,13,41,0.317,24,56,0.429,0.448,6,9,0.667,5,33,38,19,6,4,13,12
1039,15,2010,36,1,3,46,7,709,81,184,0.44,32,82,0.39,49,102,0.48,0.527,8,15,0.533,6,65,71,43,10,6,21,33
1042,4,2004,25,1,3,46,2,738,134,350,0.383,2,17,0.118,132,333,0.396,0.386,90,120,0.75,61,141,202,43,16,8,51,97
1056,1,2011,25,1,3,63,11,791,124,273,0.454,19,58,0.328,105,215,0.488,0.489,59,87,0.678,28,88,116,49,23,6,46,77
1061,1,1980,27,1,3,21,-1,419,65,144,0.451,1,2,0.5,64,142,0.451,0.455,22,25,0.88,21,66,87,29,11,6,21,45
1061,1,1980,27,1,3,52,-1,580,66,130,0.508,0,1,0,66,129,0.512,0.508,23,28,0.821,23,75,98,36,11,15,30,86
1061,1,1980,27,1,3,73,-1,999,131,274,0.478,1,3,0.333,130,271,0.48,0.48,45,53,0.849,44,141,185,65,22,21,51,131
1061,2,1981,28,1,3,64,-1,996,100,224,0.446,0,3,0,100,221,0.452,0.446,22,24,0.917,74,90,164,84,15,12,49,100
1061,3,1982,29,1,3,21,1,201,9,24,0.375,0,1,0,9,23,0.391,0.375,5,6,0.833,14,21,35,11,8,0,15,30
1065,1,1996,23,1,3,28,1,139,30,80,0.375,4,25,0.16,26,55,0.473,0.4,26,34,0.765,12,12,24,5,8,1,6,27
1076,1,2002,25,1,3,22,17,343,25,64,0.391,0,0,-1,25,64,0.391,0.391,24,31,0.774,32,32,64,17,11,1,13,39
1076,2,2003,26,1,3,37,10,573,56,128,0.438,2,9,0.222,54,119,0.454,0.445,50,59,0.847,41,62,103,23,25,2,20,63
1076,3,2004,27,1,3,36,0,261,15,48,0.313,1,8,0.125,14,40,0.35,0.323,13,18,0.722,18,35,53,14,9,3,12,37
1086,1,1992,22,1,3,81,5,1535,241,525,0.459,23,70,0.329,218,455,0.479,0.481,139,184,0.755,73,147,220,126,78,30,123,230
1086,2,1993,23,1,3,71,14,1082,184,380,0.484,4,23,0.174,180,357,0.504,0.489,81,101,0.802,55,104,159,113,61,21,77,133
1086,3,1994,24,1,3,82,53,2096,340,728,0.467,33,100,0.33,307,628,0.489,0.49,174,230,0.757,105,250,355,217,81,52,158,244
1086,4,1995,25,1,3,53,7,1039,169,351,0.481,31,75,0.413,138,276,0.5,0.526,95,123,0.772,61,94,155,139,52,19,78,154
1086,5,1996,26,1,3,81,81,2588,421,928,0.454,99,272,0.364,322,656,0.491,0.507,196,254,0.772,158,292,450,369,113,41,216,290
1086,6,1997,27,1,3,76,75,2650,433,950,0.456,101,278,0.363,332,672,0.494,0.509,207,263,0.787,114,280,394,286,167,40,178,279
1086,7,1998,28,1,3,82,82,2709,363,771,0.471,86,265,0.325,277,506,0.547,0.527,171,230,0.743,78,280,358,276,100,48,201,309
1086,8,1999,29,1,3,44,1,944,148,330,0.448,32,95,0.337,116,235,0.494,0.497,66,89,0.742,26,63,89,89,28,10,56,114
1086,9,2000,30,1,3,82,1,1473,206,498,0.414,59,181,0.326,147,317,0.464,0.473,63,78,0.808,63,135,198,138,52,26,87,203
1086,10,2001,31,1,3,82,77,2291,287,646,0.444,118,300,0.393,169,346,0.488,0.536,95,122,0.779,80,245,325,262,70,29,136,225
1086,11,2002,32,1,3,82,82,2289,255,605,0.421,65,208,0.313,190,397,0.479,0.475,70,85,0.824,90,299,389,283,67,21,132,244
1086,12,2003,33,1,3,76,75,2181,262,621,0.422,105,280,0.375,157,341,0.46,0.506,52,69,0.754,64,259,323,253,69,14,121,215
1086,13,2004,34,1,3,38,34,846,73,186,0.392,15,61,0.246,58,125,0.464,0.433,22,30,0.733,29,73,102,98,29,4,48,99
1121,1,1989,23,1,3,44,6,375,75,136,0.551,2,11,0.182,73,125,0.584,0.559,35,55,0.636,11,31,42,34,14,3,19,40
1121,2,1990,24,1,3,71,10,990,137,301,0.455,3,18,0.167,134,283,0.473,0.46,85,107,0.794,42,70,112,119,28,8,44,77
1121,3,1991,25,1,3,82,76,2706,548,933,0.587,0,7,0,548,926,0.592,0.587,185,227,0.815,85,182,267,256,100,34,148,237
1121,4,1992,26,1,3,82,77,2496,480,908,0.529,9,31,0.29,471,877,0.537,0.534,139,157,0.885,80,206,286,219,75,37,97,200
1121,5,1993,27,1,3,82,58,2541,459,906,0.507,52,139,0.374,407,767,0.531,0.535,123,149,0.826,46,200,246,226,86,37,81,185
1121,6,1994,28,1,3,75,28,1880,368,804,0.458,25,103,0.243,343,701,0.489,0.473,103,126,0.817,41,118,159,149,57,22,77,134
1121,7,1995,29,1,3,77,0,1223,220,450,0.489,39,98,0.398,181,352,0.514,0.532,87,111,0.784,29,93,122,119,52,10,49,130
1121,8,1996,30,1,3,21,0,292,35,82,0.427,6,23,0.261,29,59,0.492,0.463,5,10,0.5,7,20,27,18,4,3,11,28
1121,8,1996,30,1,3,44,13,1033,117,297,0.394,38,91,0.418,79,206,0.383,0.458,33,38,0.868,14,72,86,82,31,5,32,119
1121,8,1996,30,1,3,65,13,1325,152,379,0.401,44,114,0.386,108,265,0.408,0.459,38,48,0.792,21,92,113,100,35,8,43,147
1121,9,1997,31,1,3,62,2,953,123,286,0.43,54,112,0.482,69,174,0.397,0.524,7,10,0.7,13,94,107,77,21,17,27,76
1130,1,2006,24,1,3,67,11,1301,130,325,0.4,39,137,0.285,91,188,0.484,0.46,78,101,0.772,39,146,185,94,41,47,75,135
1130,2,2007,25,1,3,79,5,1410,163,380,0.429,53,149,0.356,110,231,0.476,0.499,95,114,0.833,53,152,205,87,45,43,70,190
1130,3,2008,26,1,3,79,20,2096,348,752,0.463,113,289,0.391,235,463,0.508,0.538,162,208,0.779,52,212,264,128,96,50,128,232
1130,4,2009,27,1,3,65,36,1975,295,665,0.444,88,221,0.398,207,444,0.466,0.51,146,178,0.82,56,162,218,150,80,67,112,196
1130,6,2011,29,1,3,58,34,1386,207,475,0.436,81,224,0.362,126,251,0.502,0.521,65,76,0.855,24,109,133,71,51,49,45,126
1130,7,2012,30,1,3,49,3,798,86,229,0.376,38,131,0.29,48,98,0.49,0.459,24,30,0.8,11,88,99,31,36,37,22,73
1130,8,2013,31,1,3,18,5,319,41,95,0.432,27,70,0.386,14,25,0.56,0.574,6,7,0.857,1,22,23,20,14,7,12,22
1130,9,2014,32,1,3,55,4,1083,118,294,0.401,69,193,0.358,49,101,0.485,0.519,10,19,0.526,21,101,122,63,27,33,30,120
1138,1,1981,24,1,3,70,-1,1638,188,415,0.453,1,3,0.333,187,412,0.454,0.454,50,62,0.806,85,179,264,132,50,10,90,167
1138,2,1982,25,1,3,51,22,858,105,242,0.434,3,10,0.3,102,232,0.44,0.44,17,26,0.654,27,67,94,76,32,6,38,94
1138,3,1984,27,1,3,41,0,478,78,152,0.513,2,6,0.333,76,146,0.521,0.52,30,39,0.769,24,47,71,31,12,2,34,62
1144,1,1996,19,1,3,80,43,2293,361,735,0.491,8,28,0.286,353,707,0.499,0.497,105,149,0.705,175,326,501,145,86,131,110,189
1144,2,1997,20,1,3,77,77,2995,549,1100,0.499,6,21,0.286,543,1079,0.503,0.502,205,272,0.754,190,428,618,236,105,163,175,199
1146,2,2000,23,1,3,82,1,1479,258,585,0.441,79,197,0.401,179,388,0.461,0.509,80,111,0.721,44,166,210,58,31,19,85,197
1146,3,2001,24,1,3,76,1,1579,223,576,0.387,97,224,0.433,126,352,0.358,0.471,85,98,0.867,51,159,210,51,40,15,68,241
1152,1,2007,20,1,3,78,43,2103,321,760,0.422,52,143,0.364,269,617,0.436,0.457,152,209,0.727,93,255,348,100,71,74,140,192
1152,2,2008,21,1,3,81,81,3000,625,1355,0.461,134,387,0.346,491,968,0.507,0.511,248,316,0.785,140,359,499,158,111,79,190,230
1152,3,2009,22,1,3,79,78,2945,572,1262,0.453,85,242,0.351,487,1020,0.477,0.487,264,344,0.767,109,328,437,135,98,59,203,221
1152,4,2010,23,1,3,80,80,3175,600,1288,0.466,66,202,0.327,534,1086,0.492,0.491,301,400,0.753,115,357,472,153,118,64,169,201
1152,5,2011,24,1,3,54,54,2152,409,869,0.471,57,144,0.396,352,725,0.486,0.503,194,241,0.805,82,254,336,153,91,58,135,131
1152,6,2012,25,1,3,65,65,2422,485,1067,0.455,54,173,0.312,431,894,0.482,0.48,208,263,0.791,130,287,417,147,95,55,161,138
1152,7,2013,26,1,3,33,32,1146,240,565,0.425,44,131,0.336,196,434,0.452,0.464,119,139,0.856,43,169,212,94,57,22,94,95
1152,7,2013,26,1,3,42,42,1541,281,688,0.408,40,129,0.31,241,559,0.431,0.438,121,156,0.776,56,193,249,108,56,31,104,87
1152,7,2013,26,1,3,75,74,2687,521,1253,0.416,84,260,0.323,437,993,0.44,0.449,240,295,0.814,99,362,461,202,113,53,198,182
1152,8,2014,27,1,3,18,18,639,130,335,0.388,22,59,0.373,108,276,0.391,0.421,68,88,0.773,29,104,133,40,28,23,59,47
1152,8,2014,27,1,3,55,55,1892,407,844,0.482,43,138,0.312,364,706,0.516,0.508,250,299,0.836,84,220,304,169,67,33,165,124
1152,8,2014,27,1,3,73,73,2531,537,1179,0.455,65,197,0.33,472,982,0.481,0.483,318,387,0.822,113,324,437,209,95,56,224,171
1152,9,2015,28,1,3,10,10,369,74,165,0.448,11,32,0.344,63,133,0.474,0.482,66,75,0.88,14,54,68,35,12,6,27,19
1156,3,2013,22,1,3,79,79,2972,493,1176,0.419,170,469,0.362,323,707,0.457,0.491,221,274,0.807,88,515,603,327,143,51,233,227
1156,4,2014,23,1,3,80,80,2898,577,1362,0.424,182,500,0.364,395,862,0.458,0.49,401,464,0.864,64,478,542,283,151,22,224,198
1157,4,2013,25,1,3,82,82,2541,305,744,0.41,69,219,0.315,236,525,0.45,0.456,163,205,0.795,75,245,320,133,107,29,132,199
1157,5,2014,26,1,3,65,24,1020,98,236,0.415,19,58,0.328,79,178,0.444,0.456,43,61,0.705,35,114,149,47,39,15,44,96
1157,6,2015,27,1,3,7,0,104,11,29,0.379,2,5,0.4,9,24,0.375,0.414,5,8,0.625,4,11,15,3,7,2,3,6
1158,1,2000,22,1,3,49,1,345,56,144,0.389,16,47,0.34,40,97,0.412,0.444,27,41,0.659,29,46,75,12,10,4,21,54
1158,2,2001,23,1,3,59,1,593,64,207,0.309,15,68,0.221,49,139,0.353,0.345,39,55,0.709,35,75,110,19,15,15,34,87
1158,3,2002,24,1,3,82,1,1759,215,523,0.411,66,178,0.371,149,345,0.432,0.474,85,126,0.675,78,225,303,111,71,42,66,190
1158,4,2003,25,1,3,71,7,1613,180,461,0.39,49,132,0.371,131,329,0.398,0.444,83,105,0.79,91,195,286,92,56,38,65,180
1158,5,2004,26,1,3,82,48,1951,233,571,0.408,65,186,0.349,168,385,0.436,0.465,73,96,0.76,87,245,332,112,81,38,88,189
1158,6,2005,27,1,3,15,3,306,37,104,0.356,21,58,0.362,16,46,0.348,0.457,15,20,0.75,13,40,53,14,8,2,12,32
1158,7,2006,28,1,3,71,5,1542,170,425,0.4,50,160,0.313,120,265,0.453,0.459,58,86,0.674,82,192,274,68,66,34,54,159
1158,8,2007,29,1,3,60,17,1283,146,370,0.395,53,150,0.353,93,220,0.423,0.466,36,48,0.75,57,156,213,33,46,23,51,143
1158,9,2008,30,1,3,53,4,821,74,207,0.357,22,68,0.324,52,139,0.374,0.411,24,34,0.706,28,109,137,35,19,13,24,90
1158,10,2009,31,1,3,43,17,708,54,142,0.38,22,76,0.289,32,66,0.485,0.458,17,22,0.773,25,53,78,15,23,11,17,57
1158,11,2010,32,1,3,45,4,761,89,206,0.432,48,123,0.39,41,83,0.494,0.549,16,23,0.696,21,93,114,32,41,10,15,89
1160,1,1980,26,1,3,73,-1,869,159,348,0.457,1,3,0.333,158,345,0.458,0.458,66,100,0.66,77,100,177,43,41,26,49,96
1160,2,1981,27,1,3,16,-1,123,19,51,0.373,0,3,0,19,48,0.396,0.373,19,29,0.655,13,16,29,6,3,6,7,24
1160,2,1981,27,1,3,11,-1,129,22,60,0.367,0,1,0,22,59,0.373,0.367,8,11,0.727,17,21,38,9,7,3,8,17
1160,2,1981,27,1,3,27,-1,252,41,111,0.369,0,4,0,41,107,0.383,0.369,27,40,0.675,30,37,67,15,10,9,15,41
1174,7,1997,28,1,3,82,81,3199,644,1453,0.443,74,220,0.336,570,1233,0.462,0.469,427,536,0.797,183,316,499,326,154,46,218,225
1174,8,1998,29,1,3,81,81,2733,418,974,0.429,26,101,0.257,392,873,0.449,0.443,225,327,0.688,112,279,391,200,156,64,124,268
1174,9,1999,30,1,3,50,47,1606,236,593,0.398,2,17,0.118,234,576,0.406,0.4,114,167,0.683,61,183,244,123,134,26,71,162
1174,10,2000,31,1,3,76,75,2355,396,956,0.414,20,78,0.256,376,878,0.428,0.425,181,255,0.71,82,201,283,210,139,41,89,211
1176,1,2010,24,1,3,11,0,140,19,39,0.487,0,8,0,19,31,0.613,0.487,7,11,0.636,12,19,31,7,5,1,10,19
1176,1,2010,24,1,3,32,1,239,28,60,0.467,0,10,0,28,50,0.56,0.467,13,23,0.565,16,35,51,13,9,2,17,29
1177,9,1996,31,1,3,78,76,2856,576,1216,0.474,0,1,0,576,1215,0.474,0.474,277,350,0.791,241,472,713,140,73,53,177,180
1183,1,2003,25,1,3,27,27,961,143,325,0.44,39,119,0.328,104,206,0.505,0.5,62,76,0.816,18,112,130,67,30,2,51,55
1183,2,2004,26,1,3,48,25,1435,188,427,0.44,46,113,0.407,142,314,0.452,0.494,67,81,0.827,37,127,164,80,41,10,63,98
1183,2,2004,26,1,3,73,43,2041,316,724,0.436,60,152,0.395,256,572,0.448,0.478,135,158,0.854,51,175,226,122,56,15,103,144
1184,1,1980,23,1,3,82,-1,1254,182,473,0.385,0,2,0,182,471,0.386,0.385,106,128,0.828,114,128,242,59,51,19,59,132
1197,1,1980,24,1,3,59,-1,1020,148,286,0.517,2,6,0.333,146,280,0.521,0.521,92,121,0.76,107,152,259,81,68,16,58,119
1197,3,1982,26,1,3,80,0,1699,250,495,0.505,0,3,0,250,492,0.508,0.505,160,217,0.737,140,283,423,152,92,36,100,229
1198,1,2003,21,1,3,51,29,1329,255,576,0.443,14,46,0.304,241,530,0.455,0.455,92,132,0.697,105,190,295,63,38,22,105,121
1198,1,2003,21,1,3,70,47,1873,355,777,0.457,14,48,0.292,341,729,0.468,0.466,151,212,0.712,163,292,455,83,53,35,150,172
1212,1,2006,23,1,3,80,24,1581,198,414,0.478,29,87,0.333,169,327,0.517,0.513,108,133,0.812,57,187,244,60,37,13,92,228
1212,2,2007,24,1,3,79,21,1319,192,388,0.495,9,31,0.29,183,357,0.513,0.506,110,131,0.84,55,193,248,44,30,4,49,161
1212,3,2008,25,1,3,38,3,331,49,113,0.434,2,3,0.667,47,110,0.427,0.442,38,45,0.844,18,49,67,15,3,0,23,47
1212,4,2009,26,1,3,78,10,1541,231,480,0.481,3,16,0.188,228,464,0.491,0.484,132,160,0.825,95,197,292,48,35,12,74,191
1212,5,2010,27,1,3,63,18,759,105,202,0.52,2,13,0.154,103,189,0.545,0.525,54,73,0.74,39,84,123,22,23,7,43,104
1212,6,2011,28,1,3,39,8,586,82,179,0.458,9,30,0.3,73,149,0.49,0.483,29,36,0.806,8,76,84,18,6,7,28,73
1220,3,2008,25,1,3,22,0,128,34,58,0.586,7,14,0.5,27,44,0.614,0.647,12,16,0.75,4,18,22,9,4,1,10,14
1221,1,2006,22,1,3,78,17,1765,221,478,0.462,30,93,0.323,191,385,0.496,0.494,115,148,0.777,131,253,384,90,58,62,80,211
1221,2,2007,23,1,3,82,57,2785,398,868,0.459,110,288,0.382,288,580,0.497,0.522,236,294,0.803,114,267,381,114,67,61,135,245
1221,3,2008,24,1,3,80,80,2876,537,1205,0.446,171,423,0.404,366,782,0.468,0.517,322,378,0.852,93,393,486,166,95,84,171,290
1221,4,2009,25,1,3,67,66,2424,571,1277,0.447,182,450,0.404,389,827,0.47,0.518,404,460,0.878,49,292,341,183,69,97,165,207
1221,5,2010,26,1,3,62,62,2278,488,1139,0.428,158,438,0.361,330,701,0.471,0.498,363,428,0.848,67,275,342,171,94,51,157,183
1221,6,2011,27,1,3,79,79,2763,535,1260,0.425,157,407,0.386,378,853,0.443,0.487,395,466,0.848,87,338,425,203,89,62,206,213
1221,7,2012,28,1,3,62,62,2062,391,941,0.416,123,323,0.381,268,618,0.434,0.481,254,291,0.873,79,228,307,109,62,40,110,144
1221,8,2014,30,1,3,12,0,194,36,84,0.429,12,34,0.353,24,50,0.48,0.5,12,14,0.857,7,21,28,8,3,4,10,21
1221,8,2014,30,1,3,29,2,653,80,223,0.359,31,94,0.33,49,129,0.38,0.428,51,53,0.962,24,81,105,33,9,13,36,41
1221,8,2014,30,1,3,41,2,847,116,307,0.378,43,128,0.336,73,179,0.408,0.448,63,67,0.94,31,102,133,41,12,17,46,62
1222,4,1998,25,1,3,61,49,1921,283,557,0.508,0,1,0,283,556,0.509,0.508,171,228,0.75,197,358,555,86,44,45,110,184
1224,4,1992,26,1,3,64,60,2388,489,1022,0.478,1,8,0.125,488,1014,0.481,0.479,176,220,0.8,157,275,432,170,74,27,109,178
1224,5,1993,27,1,3,72,72,2667,560,1149,0.487,1,10,0.1,559,1139,0.491,0.488,218,300,0.727,133,279,412,205,72,44,90,168
1224,6,1994,28,1,3,77,73,2112,356,774,0.46,2,7,0.286,354,767,0.462,0.461,84,131,0.641,109,242,351,107,70,49,56,179
1224,10,1998,32,1,3,65,8,895,75,196,0.383,1,6,0.167,74,190,0.389,0.385,19,30,0.633,60,108,168,39,23,15,26,94
1237,1,1989,21,1,3,55,15,1220,167,398,0.42,1,4,0.25,166,394,0.421,0.421,105,156,0.673,117,169,286,117,36,25,102,144
1240,10,1995,31,1,3,82,52,2687,311,617,0.504,43,127,0.339,268,490,0.547,0.539,251,343,0.732,194,475,669,127,55,31,114,146
1240,11,1996,32,1,3,82,36,2113,215,444,0.484,14,52,0.269,201,392,0.513,0.5,168,237,0.709,166,388,554,72,45,23,79,141
1243,1,2013,22,1,3,79,1,1061,84,257,0.327,14,67,0.209,70,190,0.368,0.354,45,55,0.818,58,202,260,53,42,25,51,159
1243,2,2014,23,1,3,82,12,1797,187,459,0.407,55,165,0.333,132,294,0.449,0.467,82,123,0.667,86,323,409,152,102,72,91,231
1243,3,2015,24,1,3,9,9,293,42,92,0.457,16,41,0.39,26,51,0.51,0.543,19,24,0.792,7,57,64,27,8,11,24,30
1246,1,1986,21,1,3,20,0,221,44,101,0.436,0,1,0,44,100,0.44,0.436,21,26,0.808,17,21,38,3,4,7,17,26
1246,1,1986,21,1,3,21,0,232,39,91,0.429,0,0,-1,39,91,0.429,0.429,14,23,0.609,10,25,35,6,1,2,18,27
1246,1,1986,21,1,3,41,0,453,83,192,0.432,0,1,0,83,191,0.435,0.432,35,49,0.714,27,46,73,9,5,9,35,53
1246,2,1987,22,1,3,19,0,172,25,70,0.357,0,0,-1,25,70,0.357,0.357,14,19,0.737,6,22,28,7,4,2,15,8
1255,1,2009,20,1,3,55,4,725,77,236,0.326,26,100,0.26,51,136,0.375,0.381,29,34,0.853,19,67,86,30,16,14,37,68
1255,2,2010,21,1,3,76,50,1630,244,553,0.441,69,183,0.377,175,370,0.473,0.504,90,140,0.643,53,181,234,71,41,53,93,150
1255,3,2011,22,1,3,69,21,1127,156,386,0.404,45,154,0.292,111,232,0.478,0.462,43,65,0.662,49,98,147,48,36,20,60,88
1265,1,1980,26,1,3,65,-1,1818,331,804,0.412,34,92,0.37,297,712,0.417,0.433,216,249,0.867,80,107,187,177,56,16,102,158
1265,4,1983,29,1,3,41,11,756,114,294,0.388,15,38,0.395,99,256,0.387,0.413,54,69,0.783,18,31,49,49,18,7,27,61
1265,6,1985,31,1,3,78,6,1182,190,424,0.448,8,33,0.242,182,391,0.465,0.458,88,107,0.822,27,76,103,94,30,2,55,85
1266,2,2001,26,1,3,44,0,377,33,97,0.34,9,26,0.346,24,71,0.338,0.387,18,24,0.75,27,60,87,27,18,5,18,45
1266,6,2005,30,1,3,69,1,667,58,161,0.36,2,9,0.222,56,152,0.368,0.366,33,44,0.75,52,94,146,53,43,4,30,78
1266,8,2007,32,1,3,54,1,585,61,129,0.473,0,6,0,61,123,0.496,0.473,15,19,0.789,40,69,109,59,32,4,38,78
1276,1,1980,26,1,3,62,-1,1581,221,472,0.468,1,10,0.1,220,462,0.476,0.469,95,114,0.833,84,165,249,228,60,47,166,179
1276,2,1981,27,1,3,82,-1,1934,253,479,0.528,0,9,0,253,470,0.538,0.528,135,159,0.849,126,202,328,251,90,67,151,238
1276,3,1982,28,1,3,59,24,1377,173,322,0.537,3,6,0.5,170,316,0.538,0.542,78,104,0.75,101,158,259,125,75,41,88,162
1276,4,1983,29,1,3,27,3,373,35,82,0.427,1,3,0.333,34,79,0.43,0.433,12,19,0.632,32,34,66,34,22,7,24,69
1281,1,1980,24,1,3,80,-1,1397,186,420,0.443,1,2,0.5,185,418,0.443,0.444,101,131,0.771,87,145,232,109,56,9,81,151
1281,2,1981,25,1,3,79,-1,1584,260,486,0.535,0,0,-1,260,486,0.535,0.535,75,101,0.743,31,175,206,205,60,15,88,155
1281,4,1983,27,1,3,77,0,1422,167,377,0.443,0,4,0,167,373,0.448,0.443,81,98,0.827,42,121,163,136,40,10,84,172
1281,6,1985,29,1,3,69,0,1061,188,384,0.49,2,8,0.25,186,376,0.495,0.492,77,104,0.74,41,110,151,105,50,7,40,129
1281,7,1986,30,1,3,76,0,1402,148,355,0.417,26,61,0.426,122,294,0.415,0.454,90,108,0.833,42,164,206,119,39,13,50,192
1282,3,1995,25,1,3,31,17,1018,162,357,0.454,28,88,0.318,134,269,0.498,0.493,93,122,0.762,49,173,222,139,61,28,81,86
1282,3,1995,25,1,3,77,63,2568,371,837,0.443,60,186,0.323,311,651,0.478,0.479,174,252,0.69,165,407,572,279,132,62,189,203
1282,6,1998,28,1,3,41,41,1582,319,635,0.502,2,17,0.118,317,618,0.513,0.504,183,223,0.821,106,250,356,167,61,22,109,102
1297,1,1980,32,1,3,45,-1,1457,329,729,0.451,2,11,0.182,327,718,0.455,0.453,123,152,0.809,63,183,246,178,29,36,123,112
1297,2,1981,33,1,3,23,-1,545,101,237,0.426,0,1,0,101,236,0.428,0.426,28,39,0.718,19,64,83,60,16,9,33,54
1297,3,1982,34,1,3,11,0,174,21,55,0.382,0,0,-1,21,55,0.382,0.382,10,17,0.588,4,13,17,13,5,2,11,25
1300,6,2009,28,1,3,54,43,1700,311,689,0.451,18,90,0.2,293,599,0.489,0.464,93,129,0.721,80,168,248,114,62,26,94,120
1300,7,2010,29,1,3,51,4,937,124,249,0.498,6,28,0.214,118,221,0.534,0.51,34,56,0.607,27,68,95,66,27,6,42,91
1300,8,2011,30,1,3,49,0,938,114,232,0.491,4,21,0.19,110,211,0.521,0.5,39,57,0.684,24,89,113,64,39,22,38,63
1300,10,2013,32,1,3,59,33,1085,132,351,0.376,20,72,0.278,112,279,0.401,0.405,40,54,0.741,48,102,150,65,51,10,45,77
1303,1,1980,23,1,3,68,-1,2674,730,1267,0.576,0,2,0,730,1265,0.577,0.576,443,526,0.842,183,333,516,191,96,14,233,211
1303,2,1981,24,1,3,80,-1,3417,909,1627,0.559,2,7,0.286,907,1620,0.56,0.559,632,784,0.806,192,317,509,322,109,18,282,245
1303,3,1982,25,1,3,81,81,3222,904,1586,0.57,1,3,0.333,903,1583,0.57,0.57,648,818,0.792,231,283,514,324,95,14,299,252
1303,4,1983,26,1,3,22,22,887,233,402,0.58,0,0,-1,233,402,0.58,0.58,210,248,0.847,58,82,140,105,20,0,81,62
1303,5,1984,27,1,3,79,79,2984,802,1438,0.558,1,4,0.25,801,1434,0.559,0.558,813,946,0.859,179,269,448,310,61,4,263,201
1303,6,1985,28,1,3,55,46,1971,512,964,0.531,0,0,-1,512,964,0.531,0.531,438,545,0.804,148,175,323,186,57,8,171,133
1303,7,1986,29,1,3,76,75,2744,818,1453,0.563,1,11,0.091,817,1442,0.567,0.563,630,796,0.791,178,217,395,264,64,4,231,206
1303,8,1987,30,1,3,81,81,2736,601,1126,0.534,1,6,0.167,600,1120,0.536,0.534,539,664,0.812,104,228,332,162,63,7,181,193
1303,9,1988,31,1,3,69,50,2144,444,863,0.514,0,2,0,444,861,0.516,0.514,492,572,0.86,84,143,227,171,39,10,135,144
1303,10,1989,32,1,3,31,25,1081,212,459,0.462,0,1,0,212,458,0.463,0.462,204,263,0.776,64,89,153,78,20,7,82,87
1303,10,1989,32,1,3,42,42,1341,258,495,0.521,0,0,-1,258,495,0.521,0.521,256,305,0.839,53,111,164,93,23,6,81,99
1303,10,1989,32,1,3,73,67,2422,470,954,0.493,0,1,0,470,953,0.493,0.493,460,568,0.81,117,200,317,171,43,13,163,186
1303,11,1990,33,1,3,45,45,1300,231,484,0.477,0,2,0,231,482,0.479,0.477,200,254,0.787,78,94,172,80,20,7,75,99
1303,12,1991,34,1,3,10,0,126,19,50,0.38,1,3,0.333,18,47,0.383,0.39,18,26,0.692,8,5,13,9,5,0,6,8
1311,1,2014,26,1,3,34,0,238,34,97,0.351,7,39,0.179,27,58,0.466,0.387,8,10,0.8,14,32,46,11,6,1,11,20
1315,1,1999,27,1,3,50,6,902,109,243,0.449,0,1,0,109,242,0.45,0.449,90,111,0.811,70,103,173,40,23,17,48,88
1315,2,2000,28,1,3,26,5,443,63,148,0.426,0,3,0,63,145,0.434,0.426,42,52,0.808,22,51,73,16,13,2,31,49
1315,2,2000,28,1,3,32,5,474,67,157,0.427,0,3,0,67,154,0.435,0.427,45,56,0.804,26,55,81,17,17,3,33,56
1315,3,2001,29,1,3,17,0,140,15,29,0.517,0,0,-1,15,29,0.517,0.517,12,13,0.923,9,24,33,4,2,3,7,20
1315,3,2001,29,1,3,27,0,209,25,51,0.49,0,0,-1,25,51,0.49,0.49,12,13,0.923,15,37,52,7,6,4,11,28
1319,1,2008,23,1,3,38,2,322,51,125,0.408,0,0,-1,51,125,0.408,0.408,18,28,0.643,21,41,62,13,7,15,17,46
1319,2,2009,24,1,3,14,0,111,17,35,0.486,0,0,-1,17,35,0.486,0.486,8,17,0.471,10,24,34,1,2,3,5,12
1323,1,1994,23,1,3,68,3,374,40,126,0.317,1,3,0.333,39,123,0.317,0.321,50,68,0.735,21,34,55,22,16,4,19,34
1337,1,1989,25,1,3,31,0,251,48,97,0.495,1,9,0.111,47,88,0.534,0.5,26,32,0.813,15,21,36,14,13,5,12,38
1337,1,1989,25,1,3,33,0,258,49,102,0.48,1,10,0.1,48,92,0.522,0.485,28,34,0.824,16,21,37,14,13,5,12,39
1338,1,1996,22,1,3,57,0,571,55,149,0.369,4,13,0.308,51,136,0.375,0.383,74,116,0.638,56,69,125,47,40,22,68,92
1338,2,1997,23,1,3,75,17,1705,251,535,0.469,24,93,0.258,227,442,0.514,0.492,113,168,0.673,138,185,323,135,85,31,118,230
1338,3,1998,24,1,3,71,12,906,109,244,0.447,0,6,0,109,238,0.458,0.447,64,101,0.634,64,94,158,73,49,18,91,95
1338,4,2000,26,1,3,23,7,464,56,137,0.409,0,2,0,56,135,0.415,0.409,31,47,0.66,31,53,84,38,25,4,40,52
1349,1,1980,25,1,3,75,-1,2309,657,1166,0.563,0,4,0,657,1162,0.565,0.563,299,365,0.819,75,197,272,337,114,19,242,202
1349,3,1982,27,1,3,55,12,1182,350,669,0.523,3,16,0.188,347,653,0.531,0.525,91,111,0.82,21,82,103,162,46,3,112,104
1349,9,1988,33,1,3,68,48,1951,488,1031,0.473,36,96,0.375,452,935,0.483,0.491,205,231,0.887,32,127,159,278,86,3,126,131
1349,13,1992,37,1,3,46,0,741,185,403,0.459,5,16,0.313,180,387,0.465,0.465,82,94,0.872,20,50,70,68,29,1,45,69
1350,3,2002,22,1,3,82,8,1954,376,781,0.481,11,35,0.314,365,746,0.489,0.488,196,248,0.79,63,180,243,178,69,23,148,145
1350,5,2004,24,1,3,57,5,1678,312,639,0.488,35,92,0.38,277,547,0.506,0.516,145,198,0.732,59,178,237,148,71,14,121,120
1350,5,2004,24,1,3,79,27,2474,446,950,0.469,52,140,0.371,394,810,0.486,0.497,196,273,0.718,77,281,358,259,96,22,189,171
1350,7,2006,26,1,3,36,36,1460,255,595,0.429,33,117,0.282,222,478,0.464,0.456,146,181,0.807,25,139,164,173,42,8,98,99
1350,8,2007,27,1,3,81,81,3021,506,1089,0.465,123,310,0.397,383,779,0.492,0.521,239,285,0.839,54,261,315,385,80,23,210,189
1350,9,2008,28,1,3,82,47,2963,420,971,0.433,135,333,0.405,285,638,0.447,0.502,155,197,0.787,55,298,353,276,87,14,191,187
1350,11,2010,30,1,3,36,2,499,62,143,0.434,16,42,0.381,46,101,0.455,0.49,18,31,0.581,10,47,57,39,11,3,29,39
1354,1,1980,22,1,3,57,-1,776,141,300,0.47,1,5,0.2,140,295,0.475,0.472,33,48,0.688,42,83,125,77,33,9,76,112
1357,1,1984,23,1,3,75,0,1174,180,408,0.441,0,6,0,180,402,0.448,0.441,95,133,0.714,90,98,188,176,38,12,96,154
1357,2,1985,24,1,3,80,8,1573,258,504,0.512,1,7,0.143,257,497,0.517,0.513,178,249,0.715,93,179,272,240,53,19,134,164
1357,3,1986,25,1,3,64,4,1075,198,399,0.496,1,3,0.333,197,396,0.497,0.497,159,237,0.671,71,112,183,109,46,11,98,121
1357,4,1987,26,1,3,61,2,724,101,202,0.5,0,0,-1,101,202,0.5,0.5,34,65,0.523,37,87,124,75,25,7,56,98
1357,4,1987,26,1,3,62,2,731,101,202,0.5,0,0,-1,101,202,0.5,0.5,34,65,0.523,37,88,125,76,25,7,57,100
1357,5,1988,27,1,3,47,8,655,112,217,0.516,0,1,0,112,216,0.519,0.516,59,87,0.678,30,46,76,71,29,4,44,68
1358,1,2010,21,1,3,69,4,915,137,295,0.464,29,95,0.305,108,200,0.54,0.514,46,56,0.821,34,140,174,34,25,26,48,114
1358,2,2011,22,1,3,72,16,1446,193,471,0.41,69,172,0.401,124,299,0.415,0.483,82,108,0.759,64,210,274,78,39,39,59,165
1358,3,2012,23,1,3,41,4,603,73,227,0.322,13,62,0.21,60,165,0.364,0.35,35,43,0.814,14,77,91,33,22,21,40,62
1358,4,2013,24,1,3,31,0,328,47,111,0.423,20,58,0.345,27,53,0.509,0.514,11,16,0.688,6,54,60,21,9,14,16,39
1358,4,2013,24,1,3,24,0,348,43,97,0.443,21,40,0.525,22,57,0.386,0.552,15,18,0.833,10,53,63,21,5,8,13,43
1358,4,2013,24,1,3,55,0,676,90,208,0.433,41,98,0.418,49,110,0.445,0.531,26,34,0.765,16,107,123,42,14,22,29,82
1358,5,2014,25,1,3,14,1,115,21,55,0.382,12,29,0.414,9,26,0.346,0.491,4,7,0.571,3,17,20,6,4,4,5,14
1358,5,2014,25,1,3,22,1,148,24,68,0.353,12,37,0.324,12,31,0.387,0.441,6,10,0.6,5,22,27,8,4,4,5,18
1359,2,2014,26,1,3,21,0,193,22,60,0.367,8,22,0.364,14,38,0.368,0.433,13,13,1,8,20,28,33,7,3,14,23
1359,2,2014,26,1,3,26,3,301,42,93,0.452,10,31,0.323,32,62,0.516,0.505,18,22,0.818,6,39,45,32,15,3,21,25
1359,2,2014,26,1,3,47,3,494,64,153,0.418,18,53,0.34,46,100,0.46,0.477,31,35,0.886,14,59,73,65,22,6,35,48
1378,1,2005,19,1,3,61,45,1663,280,645,0.434,31,117,0.265,249,528,0.472,0.458,120,162,0.741,92,230,322,135,48,27,118,98
1378,2,2006,20,1,3,78,56,2604,442,954,0.463,21,78,0.269,421,876,0.481,0.474,207,276,0.75,127,389,516,147,72,50,105,128
1378,3,2007,21,1,3,82,82,3071,630,1218,0.517,1,7,0.143,629,1211,0.519,0.518,279,359,0.777,148,431,579,204,97,48,153,167
1378,4,2008,22,1,3,63,59,2128,429,896,0.479,8,22,0.364,421,874,0.482,0.483,204,265,0.77,136,258,394,155,57,29,120,117
1378,5,2009,23,1,3,49,46,1665,265,591,0.448,8,20,0.4,257,571,0.45,0.455,152,191,0.796,80,215,295,94,60,25,72,85
1378,6,2010,24,1,3,70,69,2651,473,1014,0.466,32,83,0.386,441,931,0.474,0.482,252,330,0.764,131,381,512,143,66,61,134,129
1378,7,2011,25,1,3,82,82,3208,531,1155,0.46,115,333,0.345,416,822,0.506,0.51,253,336,0.753,116,360,476,230,78,48,156,162
1378,8,2012,26,1,3,54,54,2129,311,755,0.412,79,215,0.367,232,540,0.43,0.464,127,165,0.77,77,273,350,157,56,36,96,81
1378,9,2013,27,1,3,75,75,2903,466,1093,0.426,75,233,0.322,391,860,0.455,0.461,230,282,0.816,162,314,476,222,81,32,144,105
1378,10,2014,28,1,3,23,23,860,160,354,0.452,17,62,0.274,143,292,0.49,0.476,101,124,0.815,40,118,158,85,24,4,59,53
1378,10,2014,28,1,3,40,40,1353,211,506,0.417,40,127,0.315,171,379,0.451,0.457,111,144,0.771,59,144,203,98,38,5,55,58
1378,10,2014,28,1,3,63,63,2213,371,860,0.431,57,189,0.302,314,671,0.468,0.465,212,268,0.791,99,262,361,183,62,9,114,111
1378,11,2015,29,1,3,9,9,286,51,101,0.505,12,29,0.414,39,72,0.542,0.564,19,30,0.633,11,24,35,14,12,3,9,13
1388,3,2009,26,1,3,63,21,851,76,217,0.35,51,163,0.313,25,54,0.463,0.468,10,19,0.526,26,56,82,27,13,6,16,75
1438,1,1980,25,1,3,80,-1,2306,535,1182,0.453,0,7,0,535,1175,0.455,0.453,489,646,0.757,203,268,471,101,91,23,240,313
1438,2,1981,26,1,3,67,-1,2075,500,1096,0.456,0,7,0,500,1089,0.459,0.456,454,577,0.787,145,238,383,79,98,15,194,264
1438,3,1982,27,1,3,70,51,2040,465,957,0.486,4,12,0.333,461,945,0.488,0.488,364,491,0.741,169,206,375,96,64,3,178,250
1438,4,1983,28,1,3,44,33,1206,318,671,0.474,0,5,0,318,666,0.477,0.474,296,392,0.755,98,137,235,97,35,7,135,152
1438,5,1984,29,1,3,81,4,1797,511,1067,0.479,6,22,0.273,505,1045,0.483,0.482,402,517,0.778,146,192,338,135,88,2,192,208
1438,6,1985,30,1,3,19,16,463,107,260,0.412,0,4,0,107,256,0.418,0.412,94,122,0.77,36,46,82,35,22,2,42,65
1441,10,1993,30,1,3,49,49,1671,350,816,0.429,31,133,0.233,319,683,0.467,0.448,245,292,0.839,126,183,309,278,95,37,115,159
1451,2,2009,23,1,3,20,7,427,45,96,0.469,3,8,0.375,42,88,0.477,0.484,15,24,0.625,25,34,59,19,18,2,10,40
1451,2,2009,23,1,3,48,0,728,91,189,0.481,26,66,0.394,65,123,0.528,0.55,56,81,0.691,57,89,146,37,39,6,33,65
1451,2,2009,23,1,3,68,7,1155,136,285,0.477,29,74,0.392,107,211,0.507,0.528,71,105,0.676,82,123,205,56,57,8,43,105
1451,3,2010,24,1,3,82,1,1991,225,490,0.459,120,262,0.458,105,228,0.461,0.582,104,138,0.754,99,182,281,115,81,16,68,162
1451,4,2011,25,1,3,82,15,2140,300,629,0.477,105,253,0.415,195,376,0.519,0.56,162,218,0.743,111,207,318,108,87,20,77,139
1451,6,2013,27,1,3,79,50,2170,313,669,0.468,106,271,0.391,207,398,0.52,0.547,129,162,0.796,79,166,245,203,75,8,101,128
1451,7,2014,28,1,3,74,43,1729,196,447,0.438,81,225,0.36,115,222,0.518,0.529,38,58,0.655,36,124,160,104,41,10,56,146
1452,2,1981,24,1,3,18,-1,337,74,161,0.46,2,6,0.333,72,155,0.465,0.466,18,27,0.667,15,24,39,30,12,4,25,19
1459,11,1990,34,1,3,65,2,657,44,97,0.454,0,2,0,44,95,0.463,0.454,26,39,0.667,56,82,138,43,41,4,19,67
1462,1,2003,22,1,3,82,3,1305,168,417,0.403,52,150,0.347,116,267,0.434,0.465,78,100,0.78,66,148,214,106,53,19,86,120
1462,2,2004,23,1,3,75,69,2336,323,720,0.449,94,254,0.37,229,466,0.491,0.514,137,185,0.741,87,355,442,220,68,13,143,169
1462,3,2005,24,1,3,79,79,2570,408,905,0.451,107,276,0.388,301,629,0.479,0.51,134,172,0.779,97,338,435,203,79,26,132,198
1462,4,2006,25,1,3,81,68,2578,331,816,0.406,74,260,0.285,257,556,0.462,0.451,196,252,0.778,78,321,399,237,60,32,120,199
1462,8,2010,29,1,3,67,15,1486,229,558,0.41,75,236,0.318,154,322,0.478,0.478,133,158,0.842,25,211,236,103,38,15,72,105
1462,10,2012,31,1,3,55,3,1445,239,504,0.474,83,208,0.399,156,296,0.527,0.557,116,143,0.811,29,175,204,117,28,8,58,87
1462,11,2013,32,1,3,75,3,1943,276,624,0.442,128,299,0.428,148,325,0.455,0.545,105,128,0.82,31,260,291,145,39,35,90,135
1462,12,2014,33,1,3,82,61,2584,333,774,0.43,123,324,0.38,210,450,0.467,0.51,140,164,0.854,46,299,345,186,64,46,108,163
1462,13,2015,34,1,3,10,10,306,36,82,0.439,19,50,0.38,17,32,0.531,0.555,16,21,0.762,2,38,40,25,5,6,10,18
1463,2,2009,20,1,3,74,74,2885,661,1390,0.476,97,230,0.422,564,1160,0.486,0.51,452,524,0.863,77,405,482,205,96,53,225,134
1463,3,2010,21,1,3,82,82,3239,794,1668,0.476,128,351,0.365,666,1317,0.506,0.514,756,840,0.9,105,518,623,231,112,84,271,171
1463,4,2011,22,1,3,78,78,3038,711,1538,0.462,145,414,0.35,566,1124,0.504,0.509,594,675,0.88,57,476,533,214,88,76,218,159
1463,5,2012,23,1,3,66,66,2546,643,1297,0.496,133,344,0.387,510,953,0.535,0.547,431,501,0.86,40,487,527,231,88,77,248,133
1463,6,2013,24,1,3,81,81,3119,731,1433,0.51,139,334,0.416,592,1099,0.539,0.559,679,750,0.905,46,594,640,374,116,105,280,143
1463,7,2014,25,1,3,81,81,3122,849,1688,0.503,192,491,0.391,657,1197,0.549,0.56,703,805,0.873,58,540,598,445,103,59,285,174
1465,1,1985,24,1,3,59,8,756,114,274,0.416,0,3,0,114,271,0.421,0.416,72,102,0.706,49,75,124,80,19,10,77,106
1469,1,1982,22,1,3,32,0,103,17,37,0.459,2,4,0.5,15,33,0.455,0.486,7,9,0.778,3,9,12,15,2,0,7,19
1478,1,2004,23,1,3,45,3,516,47,132,0.356,23,63,0.365,24,69,0.348,0.443,21,29,0.724,8,62,70,30,14,14,23,72
1478,2,2005,24,1,3,16,2,204,15,43,0.349,10,21,0.476,5,22,0.227,0.465,9,12,0.75,4,26,30,9,1,0,5,30
1478,4,2007,26,1,3,76,1,1532,226,495,0.457,112,265,0.423,114,230,0.496,0.57,132,164,0.805,27,226,253,61,30,26,69,183
1481,3,2003,26,1,3,48,12,1103,129,231,0.558,0,1,0,129,230,0.561,0.558,62,91,0.681,90,133,223,47,40,22,23,129
1481,4,2004,27,1,3,58,7,720,72,162,0.444,2,4,0.5,70,158,0.443,0.451,30,46,0.652,67,89,156,25,35,19,29,90
1483,1,2001,25,1,3,42,0,469,66,136,0.485,0,1,0,66,135,0.489,0.485,32,43,0.744,29,63,92,24,9,5,27,60
1483,2,2002,26,1,3,79,41,1912,369,764,0.483,1,2,0.5,368,762,0.483,0.484,112,150,0.747,103,188,291,94,59,17,96,175
1483,3,2003,27,1,3,38,0,405,84,190,0.442,0,1,0,84,189,0.444,0.442,42,51,0.824,32,38,70,26,6,3,32,46
1483,4,2004,28,1,3,22,4,397,73,162,0.451,0,3,0,73,159,0.459,0.451,24,30,0.8,30,36,66,17,4,1,21,36
1483,5,2005,29,1,3,68,51,2017,415,869,0.478,0,2,0,415,867,0.479,0.478,133,165,0.806,128,170,298,109,36,16,110,190
1487,1,1980,23,1,3,25,-1,811,201,419,0.48,2,4,0.5,199,415,0.48,0.482,107,139,0.77,66,112,178,57,24,12,65,57
1487,1,1980,23,1,3,53,-1,2046,421,879,0.479,1,5,0.2,420,874,0.481,0.48,199,280,0.711,173,340,513,112,78,22,133,148
1487,1,1980,23,1,3,78,-1,2857,622,1298,0.479,3,9,0.333,619,1289,0.48,0.48,306,419,0.73,239,452,691,169,102,34,198,205
1487,2,1981,24,1,3,74,-1,2111,395,794,0.497,4,8,0.5,391,786,0.497,0.5,200,283,0.707,149,282,431,159,73,18,163,188
1487,3,1982,25,1,3,75,71,2599,515,894,0.576,2,8,0.25,513,886,0.579,0.577,294,392,0.75,193,420,613,150,62,36,140,175
1487,4,1983,26,1,3,80,80,2879,644,1187,0.543,3,20,0.15,641,1167,0.549,0.544,339,428,0.792,214,385,599,171,63,29,203,184
1487,5,1984,27,1,3,79,74,2638,500,857,0.583,2,17,0.118,498,840,0.593,0.585,275,345,0.797,166,310,476,179,69,22,166,218
1487,9,1989,32,1,3,14,0,168,22,50,0.44,0,1,0,22,49,0.449,0.44,22,31,0.71,12,34,46,7,6,1,11,13
1487,9,1989,32,1,3,10,0,185,25,66,0.379,0,0,-1,25,66,0.379,0.379,35,48,0.729,16,16,32,11,2,2,19,19
1487,9,1989,32,1,3,24,0,353,47,116,0.405,0,1,0,47,115,0.409,0.405,57,79,0.722,28,50,78,18,8,3,30,32
1487,10,1990,33,1,3,14,0,164,20,31,0.645,0,0,-1,20,31,0.645,0.645,17,22,0.773,10,25,35,9,1,0,5,14
1503,1,1999,23,1,3,50,36,1288,182,405,0.449,35,96,0.365,147,309,0.476,0.493,104,133,0.782,57,118,175,82,77,20,53,143
1503,3,2001,25,1,3,48,22,1223,149,407,0.366,39,134,0.291,110,273,0.403,0.414,67,83,0.807,35,96,131,65,41,16,55,127
1503,3,2001,25,1,3,62,34,1556,189,530,0.357,49,180,0.272,140,350,0.4,0.403,85,106,0.802,51,122,173,76,51,20,65,155
1503,4,2002,26,1,3,70,9,1498,183,421,0.435,13,47,0.277,170,374,0.455,0.45,64,93,0.688,105,213,318,91,61,22,49,164
1514,1,1987,23,1,3,59,0,630,113,275,0.411,1,22,0.045,112,253,0.443,0.413,66,76,0.868,36,34,70,27,20,7,46,67
1514,2,1988,24,1,3,77,25,1589,270,620,0.435,26,93,0.28,244,527,0.463,0.456,207,246,0.841,87,72,159,62,72,11,103,204
1514,3,1989,25,1,3,81,80,2336,455,957,0.475,97,287,0.338,358,670,0.534,0.526,286,351,0.815,93,113,206,162,111,23,153,259
1514,4,1990,26,1,3,80,69,2277,374,786,0.476,45,142,0.317,329,644,0.511,0.504,239,299,0.799,60,131,191,180,95,22,143,254
1514,5,1991,27,1,3,81,81,2477,478,1017,0.47,30,84,0.357,448,933,0.48,0.485,385,476,0.809,94,160,254,188,100,17,189,278
1514,6,1992,28,1,3,55,55,1651,295,618,0.477,13,46,0.283,282,572,0.493,0.488,236,308,0.766,71,108,179,146,70,14,129,181
1514,7,1993,29,1,3,64,27,1471,279,534,0.522,12,45,0.267,267,489,0.546,0.534,194,240,0.808,72,71,143,117,45,19,90,154
1514,8,1994,30,1,3,18,18,429,91,174,0.523,4,16,0.25,87,158,0.551,0.534,48,59,0.814,21,37,58,29,18,5,28,44
1514,8,1994,30,1,3,63,0,1268,222,490,0.453,20,74,0.27,202,416,0.486,0.473,134,166,0.807,65,57,122,43,51,22,62,152
1514,8,1994,30,1,3,81,18,1697,313,664,0.471,24,90,0.267,289,574,0.503,0.489,182,225,0.809,86,94,180,72,69,27,90,196
1514,9,1995,31,1,3,82,11,1896,226,488,0.463,45,128,0.352,181,360,0.503,0.509,137,171,0.801,72,101,173,91,69,13,86,234
1514,11,1997,33,1,3,82,4,2060,246,547,0.45,34,98,0.347,212,449,0.472,0.481,189,247,0.765,66,120,186,116,73,17,115,257
1514,12,1998,34,1,3,74,15,2176,344,799,0.431,36,105,0.343,308,694,0.444,0.453,365,445,0.82,50,91,141,138,77,24,147,208
1514,13,1999,35,1,3,50,2,949,106,251,0.422,23,61,0.377,83,190,0.437,0.468,68,84,0.81,15,60,75,41,28,12,41,126
1514,14,2000,36,1,3,82,9,1763,278,623,0.446,72,190,0.379,206,433,0.476,0.504,192,229,0.838,39,115,154,65,53,11,89,207
1514,16,2002,38,1,3,47,17,724,67,148,0.453,22,57,0.386,45,91,0.495,0.527,42,58,0.724,9,40,49,14,29,4,21,88
1516,1,2001,26,1,3,27,6,184,21,55,0.382,4,9,0.444,17,46,0.37,0.418,8,16,0.5,13,22,35,6,2,4,7,18
1516,2,2002,27,1,3,42,35,1273,131,263,0.498,1,7,0.143,130,256,0.508,0.5,75,88,0.852,80,142,222,45,38,20,49,117
1516,3,2003,28,1,3,73,45,1931,231,467,0.495,32,84,0.381,199,383,0.52,0.529,70,90,0.778,86,185,271,99,50,26,69,174
1516,4,2004,29,1,3,64,25,1245,108,276,0.391,2,19,0.105,106,257,0.412,0.395,36,46,0.783,65,90,155,72,25,19,54,109
1516,7,2007,32,1,3,15,1,129,16,37,0.432,8,15,0.533,8,22,0.364,0.541,6,10,0.6,13,17,30,2,6,0,3,17
1521,1,1981,25,1,3,44,-1,231,48,138,0.348,2,4,0.5,46,134,0.343,0.355,17,37,0.459,26,32,58,15,8,1,25,41
1522,1,1990,22,1,3,20,0,109,14,39,0.359,0,0,-1,14,39,0.359,0.359,11,16,0.688,8,18,26,5,3,1,7,15
1525,1,2005,25,1,3,81,38,1892,241,601,0.401,25,97,0.258,216,504,0.429,0.422,170,222,0.766,69,317,386,122,37,34,135,208
1525,4,2008,28,1,3,82,27,2021,379,877,0.432,126,346,0.364,253,531,0.476,0.504,196,243,0.807,48,294,342,95,25,43,133,245
1525,5,2009,29,1,3,23,16,713,113,252,0.448,45,102,0.441,68,150,0.453,0.538,45,59,0.763,20,119,139,42,13,17,40,85
1525,6,2010,30,1,3,75,28,1477,234,587,0.399,96,249,0.386,138,338,0.408,0.48,71,99,0.717,32,190,222,75,32,26,67,160
1525,7,2011,31,1,3,54,17,931,118,277,0.426,42,118,0.356,76,159,0.478,0.502,49,61,0.803,19,150,169,45,14,15,47,100
1534,1,1988,23,1,3,66,28,1435,241,500,0.482,0,10,0,241,490,0.492,0.482,87,170,0.512,100,163,263,78,44,34,103,123
1534,2,1989,24,1,3,80,79,3020,638,1271,0.502,4,21,0.19,634,1250,0.507,0.504,170,270,0.63,245,422,667,277,106,66,206,223
1534,3,1990,25,1,3,70,64,2334,484,949,0.51,7,16,0.438,477,933,0.511,0.514,153,242,0.632,143,327,470,160,78,59,190,196
1534,4,1991,26,1,3,70,45,2309,520,1037,0.501,6,32,0.188,514,1005,0.511,0.504,173,275,0.629,177,320,497,159,63,63,139,192
1534,5,1992,27,1,3,77,24,2009,402,821,0.49,4,28,0.143,398,793,0.502,0.492,121,226,0.535,158,290,448,125,53,66,100,145
1534,6,1993,28,1,3,76,71,2477,498,975,0.511,10,38,0.263,488,937,0.521,0.516,131,220,0.595,209,362,571,165,59,58,125,156
1534,7,1994,29,1,3,82,75,2539,412,919,0.448,63,189,0.333,349,730,0.478,0.483,92,183,0.503,169,331,500,222,58,46,150,209
1534,8,1995,30,1,3,74,27,1879,388,856,0.453,98,285,0.344,290,571,0.508,0.511,64,140,0.457,103,259,362,94,34,20,96,154
1534,9,1996,31,1,3,34,28,770,127,273,0.465,33,84,0.393,94,189,0.497,0.526,17,48,0.354,40,92,132,63,15,16,46,68
1534,10,1997,32,1,3,17,0,220,27,94,0.287,6,38,0.158,21,56,0.375,0.319,4,12,0.333,8,31,39,12,7,3,18,17
1539,1,2007,23,1,3,35,1,191,18,50,0.36,13,39,0.333,5,11,0.455,0.49,2,2,1,4,22,26,6,5,0,4,21
1539,2,2008,24,1,3,35,0,264,49,102,0.48,34,71,0.479,15,31,0.484,0.647,3,4,0.75,4,31,35,6,2,3,4,17
1539,4,2010,26,1,3,54,0,362,42,108,0.389,22,71,0.31,20,37,0.541,0.491,7,9,0.778,1,32,33,6,7,2,2,21
1539,5,2011,27,1,3,23,0,197,31,59,0.525,23,42,0.548,8,17,0.471,0.72,8,8,1,4,19,23,3,1,5,4,11
1539,5,2011,27,1,3,30,0,215,35,67,0.522,26,46,0.565,9,21,0.429,0.716,8,8,1,4,24,28,3,1,5,4,14
1539,7,2013,29,1,3,81,1,1641,178,430,0.414,149,351,0.425,29,79,0.367,0.587,30,33,0.909,17,135,152,35,28,8,12,97
1541,1,2014,23,1,3,9,0,111,9,28,0.321,5,15,0.333,4,13,0.308,0.411,3,5,0.6,0,11,11,6,5,1,3,9
1541,1,2014,23,1,3,13,0,165,15,46,0.326,8,25,0.32,7,21,0.333,0.413,6,9,0.667,1,18,19,8,6,2,7,11
1548,2,2006,22,1,3,82,82,3086,344,688,0.5,56,158,0.354,288,530,0.543,0.541,263,349,0.754,117,364,481,255,135,21,153,198
1548,4,2008,24,1,3,82,82,3242,582,1277,0.456,101,307,0.329,481,970,0.496,0.495,365,506,0.721,85,361,446,391,171,49,214,187
1548,5,2009,25,1,3,82,82,3269,542,1147,0.473,80,261,0.307,462,886,0.521,0.507,377,521,0.724,92,379,471,434,131,36,222,152
1548,6,2010,26,1,3,82,82,3193,496,1120,0.443,94,303,0.31,402,817,0.492,0.485,315,430,0.733,82,447,529,472,141,55,218,145
1548,7,2011,27,1,3,67,67,2469,338,759,0.445,61,181,0.337,277,578,0.479,0.486,208,300,0.693,61,326,387,422,101,38,138,109
1548,8,2012,28,1,3,62,62,2209,287,632,0.454,76,193,0.394,211,439,0.481,0.514,121,196,0.617,56,325,381,339,107,30,115,92
1548,10,2014,30,1,3,63,63,2040,220,458,0.48,62,175,0.354,158,283,0.558,0.548,86,132,0.652,53,240,293,263,95,18,100,103
1570,1,1982,23,1,3,79,32,1516,210,484,0.434,0,3,0,210,481,0.437,0.434,134,173,0.775,113,150,263,47,40,20,112,225
1570,2,1983,24,1,3,73,20,1171,170,360,0.472,0,4,0,170,356,0.478,0.472,101,131,0.771,85,105,190,71,41,10,89,189
1574,2,1994,24,1,3,75,69,2487,517,1030,0.502,3,21,0.143,514,1009,0.509,0.503,328,398,0.824,140,327,467,160,47,22,152,169
1574,4,1996,26,1,3,56,5,1107,233,547,0.426,14,49,0.286,219,498,0.44,0.439,145,198,0.732,62,143,205,89,21,5,68,105
1574,5,1997,27,1,3,37,2,733,163,365,0.447,12,38,0.316,151,327,0.462,0.463,64,97,0.66,41,99,140,37,12,10,47,71
1577,1,2000,20,1,3,77,5,1370,224,469,0.478,2,11,0.182,222,458,0.485,0.48,196,261,0.751,123,180,303,61,24,26,138,169
1577,2,2001,21,1,3,69,9,1359,225,487,0.462,17,56,0.304,208,431,0.483,0.479,223,288,0.774,88,203,291,82,35,9,106,140
1577,5,2004,24,1,3,73,72,2628,453,1013,0.447,76,231,0.329,377,782,0.482,0.485,526,620,0.848,96,334,430,224,65,16,207,217
1577,7,2006,26,1,3,32,13,943,167,375,0.445,24,71,0.338,143,304,0.47,0.477,212,256,0.828,28,141,169,66,19,4,78,95
1577,8,2007,27,1,3,75,31,2291,367,808,0.454,13,65,0.2,354,743,0.476,0.462,519,633,0.82,90,352,442,208,65,14,201,244
1577,9,2008,28,1,3,70,65,2502,458,1000,0.458,78,203,0.384,380,797,0.477,0.497,553,681,0.812,78,316,394,189,71,7,195,210
1577,12,2011,31,1,3,67,18,1401,253,559,0.453,28,78,0.359,225,481,0.468,0.478,271,325,0.834,44,197,241,84,21,5,127,175
1577,13,2012,32,1,3,32,28,881,139,373,0.373,24,66,0.364,115,307,0.375,0.405,178,208,0.856,21,104,125,39,23,1,59,83
1577,14,2013,33,1,3,18,0,257,27,76,0.355,5,21,0.238,22,55,0.4,0.388,36,48,0.75,5,20,25,19,6,2,17,42
1586,3,1991,25,1,3,77,7,2281,397,821,0.484,30,86,0.349,367,735,0.499,0.502,227,298,0.762,168,250,418,216,106,40,114,162
1586,4,1992,26,1,3,82,15,2853,551,1153,0.478,87,228,0.382,464,925,0.502,0.516,229,303,0.756,148,335,483,274,131,43,102,158
1586,7,1995,29,1,3,82,46,3091,438,1031,0.425,199,548,0.363,239,483,0.495,0.521,206,282,0.73,104,271,375,340,96,38,105,155
1586,8,1996,30,1,3,82,15,2367,303,748,0.405,146,414,0.353,157,334,0.47,0.503,120,169,0.71,70,235,305,214,81,34,93,131
1586,9,1997,31,1,3,36,26,1264,141,347,0.406,68,201,0.338,73,146,0.5,0.504,40,59,0.678,45,117,162,116,54,14,50,75
1601,1,1984,23,1,3,57,0,469,50,126,0.397,3,13,0.231,47,113,0.416,0.409,18,23,0.783,23,36,59,47,25,2,23,63
1601,2,1985,24,1,3,34,0,190,27,63,0.429,0,1,0,27,62,0.435,0.429,16,23,0.696,12,11,23,27,16,3,18,17
1601,3,1986,25,1,3,57,0,673,97,214,0.453,8,42,0.19,89,172,0.517,0.472,53,82,0.646,26,56,82,55,32,5,41,68
1601,4,1987,26,1,3,23,3,284,31,94,0.33,3,9,0.333,28,85,0.329,0.346,18,31,0.581,10,29,39,45,18,4,23,32
1601,5,1988,27,1,3,35,1,477,48,118,0.407,2,12,0.167,46,106,0.434,0.415,25,37,0.676,17,34,51,55,13,7,24,53
1607,1,2000,21,1,3,51,38,1260,222,471,0.471,4,22,0.182,218,449,0.486,0.476,72,85,0.847,105,227,332,69,38,53,51,113
1607,2,2001,22,1,3,79,79,2857,557,1160,0.48,21,82,0.256,536,1078,0.497,0.489,234,289,0.81,220,628,848,160,132,108,129,211
1607,3,2002,23,1,3,81,81,3109,654,1395,0.469,48,122,0.393,606,1273,0.476,0.486,191,226,0.845,211,592,803,162,149,86,144,214
1607,4,2003,24,1,3,81,81,3373,662,1466,0.452,141,364,0.387,521,1102,0.473,0.5,251,295,0.851,199,574,773,198,185,95,157,208
1607,5,2004,25,1,3,79,79,3217,590,1341,0.44,90,265,0.34,500,1076,0.465,0.474,228,268,0.851,212,525,737,214,167,104,156,203
1607,8,2007,28,1,3,80,80,3010,561,1071,0.524,80,252,0.317,481,819,0.587,0.561,201,248,0.81,172,613,785,134,156,122,114,216
1607,10,2009,30,1,3,27,27,954,167,342,0.488,2,13,0.154,165,329,0.502,0.491,50,62,0.806,73,151,224,62,31,21,49,40
1607,10,2009,30,1,3,42,41,1516,215,446,0.482,8,40,0.2,207,406,0.51,0.491,67,85,0.788,107,258,365,77,57,45,56,92
1607,10,2009,30,1,3,69,68,2470,382,788,0.485,10,53,0.189,372,735,0.506,0.491,117,147,0.796,180,409,589,139,88,66,105,132
1607,11,2010,31,1,3,75,75,2385,395,778,0.508,3,19,0.158,392,759,0.516,0.51,105,139,0.755,158,319,477,107,69,61,99,141
1607,12,2011,32,1,3,80,27,2253,434,834,0.52,5,33,0.152,429,801,0.536,0.523,126,164,0.768,168,383,551,110,68,50,130,144
1607,13,2012,33,1,3,63,63,1919,288,646,0.446,20,68,0.294,268,578,0.464,0.461,74,93,0.796,145,320,465,132,67,36,98,87
1607,15,2014,35,1,3,76,76,2409,341,708,0.482,58,162,0.358,283,546,0.518,0.523,51,65,0.785,132,365,497,124,90,37,95,125
1607,16,2015,36,1,3,8,5,180,19,37,0.514,3,5,0.6,16,32,0.5,0.554,1,2,0.5,8,21,29,8,4,6,5,7
1612,1,2006,23,1,3,23,9,241,24,60,0.4,1,3,0.333,23,57,0.404,0.408,22,29,0.759,8,23,31,10,8,7,15,17
1615,1,1986,23,1,3,66,0,691,143,298,0.48,0,8,0,143,290,0.493,0.48,46,54,0.852,42,60,102,52,21,7,58,108
1615,2,1988,25,1,3,10,0,101,16,51,0.314,0,1,0,16,50,0.32,0.314,8,13,0.615,9,18,27,6,5,0,9,16
1616,1,1995,21,1,3,40,8,1036,158,423,0.374,32,106,0.302,126,317,0.397,0.411,83,122,0.68,64,132,196,57,25,50,58,63
1616,1,1995,21,1,3,32,23,1050,187,453,0.413,37,137,0.27,150,316,0.475,0.454,64,100,0.64,73,136,209,48,20,38,57,94
1616,1,1995,21,1,3,72,31,2086,345,876,0.394,69,243,0.284,276,633,0.436,0.433,147,222,0.662,137,268,405,105,45,88,115,157
1616,2,1996,22,1,3,62,6,934,125,314,0.398,28,94,0.298,97,220,0.441,0.443,64,83,0.771,65,148,213,49,22,31,48,83
1616,3,1997,23,1,3,61,20,1022,174,421,0.413,35,111,0.315,139,310,0.448,0.455,61,98,0.622,92,184,276,54,25,46,55,96
1616,4,1998,24,1,3,73,73,2611,451,1090,0.414,63,201,0.313,388,889,0.436,0.443,158,216,0.731,210,418,628,159,95,73,147,226
1616,5,1999,25,1,3,48,20,1250,208,494,0.421,26,72,0.361,182,422,0.431,0.447,88,121,0.727,115,227,342,66,47,37,80,123
1616,7,2001,27,1,3,81,49,2326,427,849,0.503,41,128,0.32,386,721,0.535,0.527,205,273,0.751,172,394,566,133,85,78,128,196
1616,8,2002,28,1,3,58,42,1750,343,661,0.519,13,42,0.31,330,619,0.533,0.529,160,226,0.708,158,285,443,101,50,67,124,150
1619,1,2009,24,1,3,33,1,266,28,77,0.364,10,33,0.303,18,44,0.409,0.429,20,25,0.8,7,26,33,13,8,4,9,33
1619,2,2010,25,1,3,8,0,114,18,48,0.375,7,18,0.389,11,30,0.367,0.448,8,9,0.889,8,13,21,7,3,1,6,12
1619,2,2010,25,1,3,10,2,276,32,88,0.364,10,31,0.323,22,57,0.386,0.42,16,21,0.762,17,30,47,9,8,0,13,36
1619,2,2010,25,1,3,18,2,390,50,136,0.368,17,49,0.347,33,87,0.379,0.43,24,30,0.8,25,43,68,16,11,1,19,48
1619,4,2012,27,1,3,17,2,391,59,134,0.44,29,75,0.387,30,59,0.508,0.549,11,19,0.579,12,46,58,10,11,2,13,35
1619,5,2013,28,1,3,41,3,694,96,252,0.381,58,146,0.397,38,106,0.358,0.496,20,28,0.714,11,89,100,20,19,6,32,58
1619,6,2014,29,1,3,53,6,822,106,256,0.414,56,146,0.384,50,110,0.455,0.523,46,61,0.754,12,93,105,31,26,7,33,68
1619,6,2014,29,1,3,59,6,870,111,264,0.42,59,151,0.391,52,113,0.46,0.532,48,65,0.738,13,97,110,33,27,7,34,71
1627,1,1994,21,1,3,79,73,2896,561,1382,0.406,85,299,0.284,476,1083,0.44,0.437,306,438,0.699,107,246,353,266,89,14,245,205
1627,2,1995,22,1,3,80,80,2980,683,1566,0.436,113,344,0.328,570,1222,0.466,0.472,447,605,0.739,116,215,331,298,82,8,235,190
1627,3,1996,23,1,3,18,18,669,145,383,0.379,35,102,0.343,110,281,0.391,0.424,97,133,0.729,37,60,97,50,14,3,55,39
1627,4,1997,24,1,3,37,21,975,140,376,0.372,42,131,0.321,98,245,0.4,0.428,72,111,0.649,28,87,115,93,35,5,57,69
1627,4,1997,24,1,3,32,30,1189,146,367,0.398,48,146,0.329,98,221,0.443,0.463,88,117,0.752,41,138,179,111,43,7,57,117
1627,4,1997,24,1,3,69,51,2164,286,743,0.385,90,277,0.325,196,466,0.421,0.445,160,228,0.702,69,225,294,204,78,12,114,186
1627,5,1998,25,1,3,48,48,1729,251,577,0.435,37,122,0.303,214,455,0.47,0.467,184,231,0.797,72,164,236,132,43,14,108,137
1627,6,1999,26,1,3,24,23,855,134,297,0.451,13,30,0.433,121,267,0.453,0.473,75,104,0.721,24,122,146,75,20,3,60,58
1627,7,2000,27,1,3,76,76,2828,515,1158,0.445,112,278,0.403,403,880,0.458,0.493,186,239,0.778,64,317,381,298,79,14,180,215
1627,8,2001,28,1,3,76,76,2989,573,1388,0.413,103,289,0.356,470,1099,0.428,0.45,279,364,0.766,92,484,576,411,85,13,211,185
1627,9,2002,29,1,3,40,40,1601,303,744,0.407,41,112,0.366,262,632,0.415,0.435,211,241,0.876,31,211,242,171,45,6,110,80
1627,10,2003,30,1,3,82,81,3321,670,1586,0.422,119,306,0.389,551,1280,0.43,0.46,313,369,0.848,66,432,498,462,83,17,230,196
1627,11,2004,31,1,3,19,18,730,156,398,0.392,19,67,0.284,137,331,0.414,0.416,65,80,0.813,19,98,117,47,14,5,37,42
1628,1,1987,22,1,3,43,0,286,51,135,0.378,3,15,0.2,48,120,0.4,0.389,42,66,0.636,12,29,41,35,13,6,33,48
1628,2,1988,23,1,3,26,0,136,23,61,0.377,1,4,0.25,22,57,0.386,0.385,10,21,0.476,13,11,24,14,6,3,10,21
1636,1,2001,23,1,3,78,14,1522,189,439,0.431,18,67,0.269,171,372,0.46,0.451,67,91,0.736,72,177,249,63,39,20,53,146
1636,2,2002,24,1,3,75,20,2420,357,769,0.464,16,59,0.271,341,710,0.48,0.475,201,237,0.848,92,259,351,104,67,27,104,170
1636,3,2003,25,1,3,28,25,952,166,350,0.474,5,17,0.294,161,333,0.483,0.481,78,102,0.765,66,122,188,68,20,11,41,74
1636,3,2003,25,1,3,52,15,1811,291,667,0.436,16,55,0.291,275,612,0.449,0.448,134,181,0.74,88,247,335,95,47,21,74,136
1636,3,2003,25,1,3,80,40,2763,457,1017,0.449,21,72,0.292,436,945,0.461,0.46,212,283,0.749,154,369,523,163,67,32,115,210
1636,4,2004,26,1,3,82,31,2534,409,867,0.472,9,39,0.231,400,828,0.483,0.477,356,463,0.769,93,266,359,152,60,24,148,191
1636,5,2005,27,1,3,80,71,2893,478,1079,0.443,1,8,0.125,477,1071,0.445,0.443,420,524,0.802,85,227,312,217,58,27,164,198
1636,6,2006,28,1,3,70,55,2102,275,690,0.399,1,6,0.167,274,684,0.401,0.399,206,302,0.682,64,234,298,66,42,17,113,136
1636,7,2007,29,1,3,75,75,2575,407,900,0.452,0,0,-1,407,900,0.452,0.452,214,323,0.663,124,221,345,115,52,22,192,174
1636,8,2008,30,1,3,59,56,1702,230,477,0.482,0,0,-1,230,477,0.482,0.482,114,173,0.659,75,181,256,121,40,30,83,106
1644,1,1980,24,1,3,80,80,2744,457,750,0.609,0,0,-1,457,750,0.609,0.609,436,554,0.787,284,420,704,199,76,61,230,266
1644,2,1981,25,1,3,81,81,2730,441,750,0.588,0,1,0,441,749,0.589,0.588,352,450,0.782,222,303,525,219,79,68,180,256
1644,3,1982,26,1,3,78,73,2590,397,724,0.548,0,3,0,397,721,0.551,0.548,357,478,0.747,218,281,499,183,79,49,174,263
1644,4,1983,27,1,3,79,71,2252,331,663,0.499,0,1,0,331,662,0.5,0.499,280,345,0.812,185,237,422,186,65,39,165,202
1644,5,1984,28,1,3,80,78,2502,317,596,0.532,1,6,0.167,316,590,0.536,0.533,320,425,0.753,201,260,461,205,63,24,203,224
1644,6,1985,29,1,3,57,51,1495,201,377,0.533,0,2,0,201,375,0.536,0.533,231,278,0.831,98,144,242,102,36,15,98,140
1644,7,1986,30,1,3,76,72,2458,314,661,0.475,0,3,0,314,658,0.477,0.475,447,562,0.795,241,383,624,215,61,29,206,252
1644,8,1987,31,1,3,46,0,836,103,188,0.548,0,1,0,103,187,0.551,0.548,126,163,0.773,72,112,184,75,13,5,48,76
1644,8,1987,31,1,3,35,31,1132,150,289,0.519,0,0,-1,150,289,0.519,0.519,177,228,0.776,103,148,251,122,26,9,88,102
1644,8,1987,31,1,3,81,31,1968,253,477,0.53,0,1,0,253,476,0.532,0.53,303,391,0.775,175,260,435,197,39,14,136,178
1644,9,1988,32,1,3,71,0,848,80,171,0.468,0,2,0,80,169,0.473,0.468,110,143,0.769,74,105,179,60,22,12,54,75
1646,1,1980,25,1,3,54,-1,1298,264,587,0.45,0,4,0,264,583,0.453,0.45,144,172,0.837,78,140,218,104,45,5,77,126
1646,2,1981,26,1,3,63,-1,815,165,338,0.488,0,0,-1,165,338,0.488,0.488,113,149,0.758,62,93,155,63,35,7,71,83
1646,3,1982,27,1,3,65,7,1187,212,417,0.508,0,4,0,212,413,0.513,0.508,159,193,0.824,85,133,218,133,50,6,92,151
1646,4,1983,28,1,3,9,1,155,21,50,0.42,0,0,-1,21,50,0.42,0.42,17,21,0.81,10,16,26,12,5,2,13,24
1656,5,2013,26,1,3,58,45,1326,151,377,0.401,13,37,0.351,138,340,0.406,0.418,72,126,0.571,89,167,256,55,42,14,70,82
1656,6,2014,27,1,3,9,5,196,15,32,0.469,1,3,0.333,14,29,0.483,0.484,9,13,0.692,9,18,27,15,9,5,4,18
1664,1,1986,22,1,3,45,4,461,69,180,0.383,1,9,0.111,68,171,0.398,0.386,18,35,0.514,14,16,30,67,38,4,40,61
1665,2,1998,23,1,3,82,64,2340,295,730,0.404,54,175,0.309,241,555,0.434,0.441,144,194,0.742,141,223,364,177,110,44,141,274
1665,7,2003,28,1,3,82,8,1949,173,418,0.414,91,248,0.367,82,170,0.482,0.523,61,98,0.622,64,224,288,106,78,28,67,188
1665,10,2006,31,1,3,36,1,353,33,99,0.333,10,45,0.222,23,54,0.426,0.384,12,21,0.571,15,53,68,23,8,5,19,52
1673,1,1984,22,1,3,79,36,2081,335,672,0.499,1,4,0.25,334,668,0.5,0.499,182,249,0.731,173,277,450,176,53,54,120,205
1673,2,1985,23,1,3,82,82,3001,476,890,0.535,0,6,0,476,884,0.538,0.535,231,313,0.738,201,338,539,355,90,75,178,215
1673,3,1986,24,1,3,82,82,2610,338,629,0.537,0,3,0,338,626,0.54,0.537,171,222,0.77,159,361,520,292,50,58,130,197
1673,4,1987,25,1,3,81,81,3136,432,783,0.552,0,9,0,432,774,0.558,0.552,306,393,0.779,190,388,578,434,88,53,208,172
1673,5,1988,26,1,3,81,80,2689,359,746,0.481,0,4,0,359,742,0.484,0.481,288,367,0.785,232,399,631,264,57,51,144,166
1673,6,1989,27,1,3,68,65,2435,340,729,0.466,5,22,0.227,335,707,0.474,0.47,169,234,0.722,143,371,514,293,57,36,168,121
1673,7,1990,28,1,3,82,82,3238,537,1043,0.515,11,42,0.262,526,1001,0.525,0.52,273,348,0.784,192,477,669,377,60,70,174,176
1673,9,1992,30,1,3,75,48,2106,271,622,0.436,25,85,0.294,246,537,0.458,0.456,110,153,0.719,149,319,468,219,48,30,115,180
1673,10,1993,31,1,3,64,5,1019,92,204,0.451,2,5,0.4,90,199,0.452,0.456,36,52,0.692,53,105,158,81,12,15,53,99
1678,1,1986,23,1,3,21,0,266,28,58,0.483,0,1,0,28,57,0.491,0.483,5,8,0.625,15,23,38,9,7,1,10,30
1688,1,1982,22,1,3,39,0,352,80,172,0.465,0,4,0,80,168,0.476,0.465,31,53,0.585,34,15,49,16,18,3,34,59
1688,2,1983,23,1,3,39,7,381,69,163,0.423,1,7,0.143,68,156,0.436,0.426,17,23,0.739,33,20,53,26,11,5,27,50
1688,3,1984,24,1,3,77,45,1425,347,584,0.594,2,12,0.167,345,572,0.603,0.596,61,113,0.54,117,76,193,81,49,6,111,176
1688,4,1985,25,1,3,76,3,1170,329,612,0.538,22,61,0.361,307,551,0.557,0.556,94,160,0.588,97,68,165,71,39,7,81,147
1688,5,1986,26,1,3,71,19,1213,252,544,0.463,41,114,0.36,211,430,0.491,0.501,42,64,0.656,51,89,140,83,53,7,70,131
1688,6,1987,27,1,3,76,6,1420,311,677,0.459,86,229,0.376,225,448,0.502,0.523,80,137,0.584,71,88,159,149,61,2,104,156
1688,7,1988,28,1,3,37,0,886,201,478,0.421,48,141,0.34,153,337,0.454,0.471,74,96,0.771,51,61,112,58,47,6,58,75
1688,7,1988,28,1,3,48,0,1003,223,530,0.421,53,160,0.331,170,370,0.459,0.471,76,102,0.745,55,73,128,71,52,6,65,81
1688,9,1990,30,1,3,14,7,280,42,87,0.483,8,23,0.348,34,64,0.531,0.529,10,21,0.476,11,25,36,16,8,1,14,28
1691,1,1998,18,1,3,64,17,1179,179,398,0.45,14,41,0.341,165,357,0.462,0.467,79,111,0.712,105,164,269,98,49,61,66,86
1691,2,1999,19,1,3,49,2,1106,168,385,0.436,8,35,0.229,160,350,0.457,0.447,114,157,0.726,120,158,278,113,52,66,80,94
1691,3,2000,20,1,3,79,34,2462,459,1018,0.451,18,65,0.277,441,953,0.463,0.46,277,392,0.707,188,313,501,263,90,151,160,201
1691,8,2005,25,1,3,78,78,3182,715,1660,0.431,142,435,0.326,573,1225,0.468,0.473,431,557,0.774,71,413,484,448,135,52,201,167
1691,9,2006,26,1,3,47,47,1745,410,1011,0.406,73,234,0.312,337,777,0.434,0.442,254,340,0.747,46,261,307,225,59,41,120,88
1691,15,2012,32,1,3,52,0,837,101,231,0.437,15,33,0.455,86,198,0.434,0.47,56,83,0.675,23,131,154,110,16,15,53,35
1697,2,2009,23,1,3,79,57,2072,140,324,0.432,2,4,0.5,138,320,0.431,0.435,74,102,0.725,113,315,428,198,62,74,92,153
1697,3,2010,24,1,3,41,0,240,15,40,0.375,0,0,-1,15,40,0.375,0.375,0,5,0,17,44,61,8,4,3,10,32
1697,3,2010,24,1,3,51,2,307,19,52,0.365,0,0,-1,19,52,0.365,0.365,0,7,0,23,56,79,11,5,4,17,35
1697,4,2011,25,1,3,52,8,760,72,182,0.396,0,2,0,72,180,0.4,0.396,30,39,0.769,63,136,199,43,10,33,25,94
1697,6,2013,27,1,3,9,0,145,9,21,0.429,0,0,-1,9,21,0.429,0.429,1,2,0.5,7,21,28,9,8,3,5,13
1697,6,2013,27,1,3,15,9,230,15,32,0.469,0,0,-1,15,32,0.469,0.469,2,6,0.333,11,37,48,10,5,8,7,26
1697,6,2013,27,1,3,26,10,387,24,56,0.429,0,0,-1,24,56,0.429,0.429,3,10,0.3,19,59,78,20,13,11,12,39
1705,1,1988,21,1,3,82,4,1706,255,519,0.491,11,30,0.367,244,489,0.499,0.502,173,224,0.772,115,213,328,107,70,63,108,237
1705,2,1989,22,1,3,82,82,2804,487,970,0.502,30,89,0.337,457,881,0.519,0.518,301,375,0.803,167,297,464,219,105,70,188,264
1705,3,1990,23,1,3,80,80,2748,468,949,0.493,3,23,0.13,465,926,0.502,0.495,315,403,0.782,170,319,489,187,87,81,192,247
1705,4,1991,24,1,3,73,55,2503,438,847,0.517,4,19,0.211,434,828,0.524,0.519,235,278,0.845,172,251,423,169,91,56,158,220
1705,5,1992,25,1,3,52,44,1757,285,604,0.472,19,50,0.38,266,554,0.48,0.488,188,222,0.847,95,173,268,120,61,47,114,142
1705,6,1993,26,1,3,77,68,2439,387,780,0.496,40,112,0.357,347,668,0.519,0.522,220,297,0.741,121,206,327,197,105,58,152,208
1705,7,1994,27,1,3,76,76,2613,355,710,0.5,9,31,0.29,346,679,0.51,0.506,192,254,0.756,129,273,402,327,111,49,228,248
1705,8,1995,28,1,3,81,81,2805,411,833,0.493,32,89,0.36,379,744,0.509,0.513,221,297,0.744,125,269,394,276,125,49,168,260
1705,9,1996,29,1,3,75,75,2440,346,712,0.486,17,68,0.25,329,644,0.511,0.498,170,221,0.769,123,238,361,262,83,44,143,246
1705,10,1997,30,1,3,50,49,1449,148,379,0.391,15,58,0.259,133,321,0.414,0.41,89,123,0.724,80,161,241,135,47,30,83,141
1705,11,1998,31,1,3,57,4,1316,150,327,0.459,4,17,0.235,146,310,0.471,0.465,55,77,0.714,74,137,211,88,57,30,79,156
1705,12,1999,32,1,3,13,0,244,23,52,0.442,0,1,0,23,51,0.451,0.442,14,17,0.824,18,23,41,13,12,4,12,24
1705,13,2000,33,1,3,32,0,634,43,108,0.398,10,23,0.435,33,85,0.388,0.444,43,56,0.768,29,106,135,35,29,13,19,81
1705,14,2001,34,1,3,66,20,987,60,136,0.441,4,20,0.2,56,116,0.483,0.456,21,27,0.778,49,127,176,74,48,13,47,136
1705,15,2002,35,1,3,41,1,784,52,122,0.426,5,12,0.417,47,110,0.427,0.447,10,14,0.714,48,79,127,45,41,4,22,90
1706,4,1998,25,1,3,24,1,472,43,104,0.413,3,17,0.176,40,87,0.46,0.428,20,23,0.87,24,44,68,38,23,1,24,47
1706,4,1998,25,1,3,57,31,1341,96,277,0.347,9,46,0.196,87,231,0.377,0.363,22,32,0.688,34,129,163,137,78,12,52,117
1706,4,1998,25,1,3,81,32,1813,139,381,0.365,12,63,0.19,127,318,0.399,0.381,42,55,0.764,58,173,231,175,101,13,76,164
1706,9,2003,30,1,3,80,40,2374,286,666,0.429,37,112,0.33,249,554,0.449,0.457,112,134,0.836,61,289,350,278,131,9,109,177
1706,10,2004,31,1,3,75,41,2112,265,577,0.459,75,172,0.436,190,405,0.469,0.524,84,111,0.757,45,208,253,195,85,23,103,142
1706,13,2007,34,1,3,10,0,131,11,17,0.647,0,0,-1,11,17,0.647,0.647,0,0,-1,1,17,18,13,4,0,8,14
1712,1,1999,23,1,3,34,0,348,62,163,0.38,1,10,0.1,61,153,0.399,0.383,37,45,0.822,12,38,50,14,2,1,23,24
1712,2,2000,24,1,3,44,20,860,131,332,0.395,2,13,0.154,129,319,0.404,0.398,54,70,0.771,41,97,138,52,16,5,59,84
1712,3,2001,25,1,3,34,25,907,144,330,0.436,2,21,0.095,142,309,0.46,0.439,45,51,0.882,37,81,118,58,23,8,57,88
1712,3,2001,25,1,3,35,25,922,145,332,0.437,2,22,0.091,143,310,0.461,0.44,45,51,0.882,38,82,120,58,23,8,58,90
1748,8,2005,28,1,3,18,3,390,65,158,0.411,0,3,0,65,155,0.419,0.411,7,10,0.7,9,31,40,20,16,2,14,20
1753,2,2014,22,1,3,82,64,2460,376,854,0.44,120,290,0.414,256,564,0.454,0.511,118,137,0.861,60,250,310,169,83,20,123,243
1761,5,2010,22,1,3,63,28,1497,241,562,0.429,74,217,0.341,167,345,0.484,0.495,66,95,0.695,42,126,168,105,58,17,81,190
1761,6,2011,23,1,3,78,19,1969,366,899,0.407,109,339,0.322,257,560,0.459,0.468,159,196,0.811,54,201,255,135,74,38,93,221
1761,8,2013,25,1,3,65,13,1364,255,614,0.415,126,328,0.384,129,286,0.451,0.518,93,107,0.869,24,150,174,63,49,17,69,138
1763,1,1998,20,1,3,33,0,163,39,64,0.609,3,6,0.5,36,58,0.621,0.633,11,17,0.647,10,15,25,12,10,0,21,17
1767,1,2013,22,1,3,52,2,694,44,108,0.407,22,56,0.393,22,52,0.423,0.509,8,8,1,8,70,78,44,17,12,23,89
1767,2,2014,23,1,3,45,7,723,73,166,0.44,25,77,0.325,48,89,0.539,0.515,29,36,0.806,9,43,52,43,24,9,22,88
1776,1,2001,20,1,3,82,62,2390,368,845,0.436,148,364,0.407,220,481,0.457,0.523,91,128,0.711,66,261,327,140,51,19,97,200
1776,2,2002,21,1,3,63,53,2123,351,802,0.438,116,303,0.383,235,499,0.471,0.51,138,181,0.762,49,224,273,198,47,23,108,145
1776,3,2003,22,1,3,16,13,360,77,151,0.51,22,44,0.5,55,107,0.514,0.583,29,36,0.806,6,49,55,31,6,5,26,34
1776,3,2003,22,1,3,49,39,1826,296,708,0.418,87,256,0.34,209,452,0.462,0.48,127,150,0.847,40,246,286,139,36,16,99,139
1776,3,2003,22,1,3,65,52,2186,373,859,0.434,109,300,0.363,264,559,0.472,0.498,156,186,0.839,46,295,341,170,42,21,125,173
1776,4,2004,23,1,3,65,65,1770,270,616,0.438,80,215,0.372,190,401,0.474,0.503,102,141,0.723,42,174,216,232,59,14,107,162
1776,5,2005,24,1,3,76,51,2278,387,766,0.505,140,323,0.433,247,443,0.558,0.597,108,150,0.72,36,264,300,220,54,23,127,197
1776,9,2009,28,1,3,73,47,2356,264,548,0.482,85,225,0.378,179,323,0.554,0.559,109,149,0.732,73,410,483,326,30,31,145,139
1776,13,2013,32,1,3,59,17,900,100,231,0.433,73,175,0.417,27,56,0.482,0.591,8,11,0.727,18,139,157,99,21,4,35,63
1776,14,2014,33,1,3,82,4,1707,213,443,0.481,107,233,0.459,106,210,0.505,0.602,46,56,0.821,30,177,207,130,26,5,77,95
1777,1,2014,21,1,3,52,16,789,94,256,0.367,30,94,0.319,64,162,0.395,0.426,39,55,0.709,36,111,147,26,22,32,48,70
1780,1,1994,24,1,3,79,18,2022,284,677,0.419,38,122,0.311,246,555,0.443,0.448,137,176,0.778,134,267,401,128,54,50,89,232
1780,2,1995,25,1,3,80,79,2814,359,855,0.42,94,240,0.392,265,615,0.431,0.475,174,213,0.817,99,267,366,154,59,35,120,242
1780,3,1996,26,1,3,80,80,3060,454,971,0.468,79,210,0.376,375,761,0.493,0.508,218,263,0.829,112,331,443,188,73,52,121,241
1780,4,1997,27,1,3,80,79,3167,405,894,0.453,86,220,0.391,319,674,0.473,0.501,176,209,0.842,118,379,497,198,86,41,120,222
1780,5,1998,28,1,3,80,29,2183,292,675,0.433,40,137,0.292,252,538,0.468,0.462,152,189,0.804,120,288,408,133,45,30,107,218
1780,6,1999,29,1,3,47,24,1395,186,453,0.411,32,115,0.278,154,338,0.456,0.446,79,96,0.823,49,188,237,103,39,14,58,125
1780,7,2000,30,1,3,20,11,649,123,292,0.421,8,30,0.267,115,262,0.439,0.435,68,84,0.81,46,77,123,47,18,4,25,60
1780,8,2001,31,1,3,15,8,493,71,191,0.372,7,25,0.28,64,166,0.386,0.39,31,36,0.861,24,69,93,18,9,5,20,43
1780,9,2002,32,1,3,66,0,1237,178,427,0.417,48,127,0.378,130,300,0.433,0.473,85,107,0.794,51,139,190,72,31,13,56,120
1785,3,1997,25,1,3,23,15,547,94,196,0.48,1,8,0.125,93,188,0.495,0.482,31,36,0.861,30,50,80,34,15,2,22,45
1793,1,1989,22,1,3,22,0,320,41,88,0.466,0,0,-1,41,88,0.466,0.466,36,60,0.6,17,30,47,20,15,2,29,49
1793,1,1989,22,1,3,24,0,353,43,97,0.443,0,0,-1,43,97,0.443,0.443,37,64,0.578,18,32,50,21,16,2,33,51
1795,1,1980,24,1,3,82,-1,2802,775,1482,0.523,0,6,0,775,1476,0.525,0.523,270,343,0.787,206,385,591,93,70,77,172,259
1795,2,1981,25,1,3,82,-1,3194,853,1791,0.476,4,9,0.444,849,1782,0.476,0.477,302,385,0.784,215,287,502,139,63,52,175,199
1795,3,1982,26,1,3,27,26,973,229,504,0.454,0,6,0,229,498,0.46,0.454,72,100,0.72,71,70,141,39,27,15,55,77
1795,3,1982,26,1,3,57,57,2090,524,973,0.539,0,1,0,524,972,0.539,0.539,148,202,0.733,173,276,449,43,33,28,98,200
1795,3,1982,26,1,3,84,83,3063,753,1477,0.51,0,7,0,753,1470,0.512,0.51,220,302,0.728,244,346,590,82,60,43,153,277
1795,4,1983,27,1,3,80,79,2803,686,1342,0.511,0,3,0,686,1339,0.512,0.511,219,289,0.758,188,349,537,98,57,52,126,248
1795,5,1984,28,1,3,79,79,2853,779,1597,0.488,6,14,0.429,773,1583,0.488,0.49,275,353,0.779,188,382,570,93,62,73,141,251
1795,6,1985,29,1,3,82,82,2853,775,1558,0.497,5,23,0.217,770,1535,0.502,0.499,269,346,0.777,145,272,417,151,61,27,144,219
1795,7,1986,30,1,3,82,82,2970,802,1697,0.473,0,12,0,802,1685,0.476,0.473,317,392,0.809,134,275,409,188,56,25,184,175
1795,8,1987,31,1,3,40,18,922,208,478,0.435,1,2,0.5,207,476,0.435,0.436,92,112,0.821,38,65,103,38,19,9,51,68
1795,9,1988,32,1,3,68,20,1501,378,784,0.482,3,12,0.25,375,772,0.486,0.484,160,194,0.825,54,144,198,68,31,13,52,101
1799,4,1993,29,1,3,81,1,1402,215,483,0.445,4,23,0.174,211,460,0.459,0.449,150,185,0.811,93,155,248,76,23,10,51,207
1799,6,1995,31,1,3,81,12,1377,201,413,0.487,1,10,0.1,200,403,0.496,0.488,126,174,0.724,95,148,243,61,43,20,54,206
1799,7,1996,32,1,3,78,42,2145,303,618,0.49,1,18,0.056,302,600,0.503,0.491,237,291,0.814,107,232,339,74,49,26,87,220
1799,8,1997,33,1,3,82,5,2044,269,603,0.446,4,25,0.16,265,578,0.458,0.449,224,295,0.759,112,214,326,79,51,20,93,232
1799,9,1998,34,1,3,81,33,2239,371,800,0.464,15,43,0.349,356,757,0.47,0.473,243,292,0.832,118,267,385,107,64,22,66,200
1799,10,1999,35,1,3,50,20,1344,213,522,0.408,9,38,0.237,204,484,0.421,0.417,126,165,0.764,55,127,182,98,35,16,34,111
1799,11,2000,36,1,3,66,24,1227,168,376,0.447,10,23,0.435,158,353,0.448,0.46,81,92,0.88,28,110,138,111,27,14,44,116
1799,12,2001,37,1,3,82,4,983,118,289,0.408,9,43,0.209,109,246,0.443,0.424,40,55,0.727,28,95,123,57,26,10,36,117
1799,13,2002,38,1,3,74,10,726,98,227,0.432,10,35,0.286,88,192,0.458,0.454,38,49,0.776,18,64,82,45,12,4,26,79
1800,8,2006,30,1,3,79,74,2979,429,1008,0.426,83,245,0.339,346,763,0.453,0.467,229,273,0.839,50,291,341,238,93,36,145,208
1810,1,2006,22,1,3,23,15,336,29,85,0.341,9,33,0.273,20,52,0.385,0.394,8,12,0.667,11,40,51,19,6,5,12,41
1810,1,2006,22,1,3,26,15,343,29,87,0.333,9,34,0.265,20,53,0.377,0.385,10,14,0.714,11,41,52,19,7,5,12,41
1815,1,2008,27,1,3,78,75,2166,279,575,0.485,40,122,0.328,239,453,0.528,0.52,63,85,0.741,92,392,484,90,80,108,51,152
1815,2,2009,28,1,3,26,21,689,72,157,0.459,27,73,0.37,45,84,0.536,0.545,13,15,0.867,10,106,116,25,21,16,12,48
1815,2,2009,28,1,3,54,39,1379,150,317,0.473,38,110,0.345,112,207,0.541,0.533,55,65,0.846,48,201,249,70,65,44,31,85
1815,2,2009,28,1,3,80,60,2068,222,474,0.468,65,183,0.355,157,291,0.54,0.537,68,80,0.85,58,307,365,95,86,60,43,133
1815,3,2010,29,1,3,61,2,1052,114,247,0.462,32,100,0.32,82,147,0.558,0.526,36,45,0.8,26,165,191,49,34,30,23,69
1815,4,2011,30,1,3,19,7,278,25,59,0.424,11,28,0.393,14,31,0.452,0.517,5,6,0.833,9,38,47,7,3,6,5,26
1815,4,2011,30,1,3,40,13,764,76,189,0.402,27,95,0.284,49,94,0.521,0.474,10,11,0.909,14,104,118,45,25,27,17,39
1815,4,2011,30,1,3,59,20,1042,101,248,0.407,38,123,0.309,63,125,0.504,0.484,15,17,0.882,23,142,165,52,28,33,22,65
1815,5,2012,31,1,3,8,0,123,7,24,0.292,2,10,0.2,5,14,0.357,0.333,2,2,1,2,20,22,5,1,5,8,5
1818,1,1992,23,1,3,38,0,313,53,144,0.368,6,27,0.222,47,117,0.402,0.389,19,23,0.826,12,21,33,27,12,2,23,19
1832,1,1993,23,1,3,25,0,102,26,57,0.456,0,0,-1,26,57,0.456,0.456,3,4,0.75,6,6,12,4,3,1,8,14
1833,2,2013,23,1,3,23,6,370,51,126,0.405,12,39,0.308,39,87,0.448,0.452,17,42,0.405,17,41,58,15,18,4,24,40
1833,3,2014,24,1,3,82,1,1800,288,651,0.442,99,260,0.381,189,391,0.483,0.518,121,159,0.761,84,235,319,88,72,18,95,157
1836,1,1989,23,1,3,76,48,2096,414,905,0.457,64,175,0.366,350,730,0.479,0.493,182,254,0.717,188,209,397,119,102,60,190,250
1836,2,1990,24,1,3,80,76,2449,449,1065,0.422,61,193,0.316,388,872,0.445,0.45,228,316,0.722,194,228,422,143,130,79,185,219
1836,3,1991,25,1,3,79,68,2553,409,962,0.425,45,179,0.251,364,783,0.465,0.449,179,244,0.734,210,311,521,220,138,96,167,248
1836,4,1992,26,1,3,77,74,2394,346,726,0.477,22,110,0.2,324,616,0.526,0.492,165,231,0.714,199,295,494,197,129,81,171,211
1836,5,1993,27,1,3,77,57,2302,436,907,0.481,17,76,0.224,419,831,0.504,0.49,197,248,0.794,227,227,454,106,144,52,119,171
1836,6,1994,28,1,3,50,27,1349,203,454,0.447,53,147,0.361,150,307,0.489,0.506,85,118,0.72,91,137,228,83,55,49,52,120
1836,7,1995,29,1,3,71,49,2131,351,856,0.41,106,317,0.334,245,539,0.455,0.472,142,195,0.728,181,221,402,147,86,51,117,155
1836,9,1997,31,1,3,73,1,977,122,299,0.408,31,113,0.274,91,186,0.489,0.46,39,54,0.722,37,125,162,43,29,24,45,121
1836,10,1998,32,1,3,54,1,538,85,207,0.411,19,62,0.306,66,145,0.455,0.457,44,61,0.721,35,79,114,24,25,17,33,61
1836,11,1999,33,1,3,44,2,535,64,149,0.43,16,56,0.286,48,93,0.516,0.483,40,46,0.87,54,67,121,23,16,11,21,54
1839,2,2010,24,1,3,69,37,2018,329,703,0.468,140,307,0.456,189,396,0.477,0.568,101,114,0.886,61,198,259,104,65,16,84,158
1839,5,2013,27,1,3,24,1,301,47,111,0.423,15,38,0.395,32,73,0.438,0.491,16,18,0.889,10,16,26,9,12,1,4,33
1839,5,2013,27,1,3,41,1,383,64,145,0.441,16,43,0.372,48,102,0.471,0.497,20,22,0.909,11,19,30,13,13,1,8,43
1841,2,1991,23,1,3,66,2,1207,120,274,0.438,4,12,0.333,116,262,0.443,0.445,113,139,0.813,41,62,103,243,61,18,107,112
1841,3,1992,24,1,3,21,0,216,33,81,0.407,2,15,0.133,31,66,0.47,0.42,24,29,0.828,3,16,19,27,12,1,24,20
1841,3,1992,24,1,3,25,0,270,36,93,0.387,2,16,0.125,34,77,0.442,0.398,32,38,0.842,6,20,26,32,13,1,28,23
1848,1,2001,24,1,3,73,3,989,123,277,0.444,0,3,0,123,274,0.449,0.444,73,90,0.811,49,125,174,25,11,9,67,163
1857,3,1988,24,1,3,60,55,2033,470,926,0.508,34,97,0.351,436,829,0.526,0.526,239,270,0.885,58,147,205,290,113,32,156,136
1857,4,1989,25,1,3,82,82,3093,830,1630,0.509,23,100,0.23,807,1530,0.527,0.516,493,553,0.892,152,331,483,415,176,39,296,178
1857,5,1990,26,1,3,78,78,2830,682,1272,0.536,87,234,0.372,595,1038,0.573,0.57,505,568,0.889,130,333,463,319,123,45,239,142
1857,6,1991,27,1,3,82,82,3315,777,1449,0.536,40,133,0.301,737,1316,0.56,0.55,513,580,0.884,141,302,443,329,173,63,245,176
1857,7,1992,28,1,3,81,81,3346,830,1584,0.524,64,175,0.366,766,1409,0.544,0.544,350,420,0.833,127,323,450,286,173,62,202,171
1857,8,1993,29,1,3,46,46,1902,474,930,0.51,60,133,0.451,414,797,0.519,0.542,183,226,0.81,42,190,232,166,68,41,139,76
1857,9,1994,30,1,3,62,39,2324,410,869,0.472,55,151,0.364,355,718,0.494,0.503,165,219,0.753,64,281,345,315,107,53,178,114
1857,10,1995,31,1,3,25,23,890,170,348,0.489,42,93,0.452,128,255,0.502,0.549,94,107,0.879,25,90,115,125,38,19,93,53
1857,11,1996,32,1,3,55,19,1617,269,539,0.499,59,150,0.393,210,389,0.54,0.554,137,160,0.856,44,115,159,194,75,32,122,127
1857,12,1997,33,1,3,79,63,2733,438,792,0.553,83,202,0.411,355,590,0.602,0.605,184,213,0.864,75,242,317,322,130,33,192,155
1857,13,1998,34,1,3,82,82,2177,333,692,0.481,107,243,0.44,226,449,0.503,0.559,154,164,0.939,38,211,249,186,95,39,117,186
1857,14,1999,35,1,3,50,50,1179,177,371,0.477,73,157,0.465,104,214,0.486,0.575,80,92,0.87,25,135,160,81,47,13,60,101
1857,16,2001,37,1,3,20,8,374,36,106,0.34,19,52,0.365,17,54,0.315,0.429,24,28,0.857,10,31,41,19,16,10,19,28
1868,2,1986,23,1,3,14,0,100,16,45,0.356,0,2,0,16,43,0.372,0.356,9,14,0.643,7,8,15,3,4,3,5,12
1871,1,1993,21,1,3,48,14,495,108,260,0.415,21,70,0.3,87,190,0.458,0.456,35,40,0.875,40,43,83,11,8,5,31,59
1871,2,1994,22,1,3,66,1,820,167,355,0.47,50,109,0.459,117,246,0.476,0.541,50,72,0.694,43,68,111,31,21,20,37,76
1871,3,1995,23,1,3,25,0,203,32,80,0.4,19,45,0.422,13,35,0.371,0.519,5,8,0.625,2,20,22,5,7,3,15,31
1871,3,1995,23,1,3,29,3,313,63,153,0.412,16,41,0.39,47,112,0.42,0.464,28,34,0.824,18,19,37,14,7,1,20,42
1871,3,1995,23,1,3,54,3,516,95,233,0.408,35,86,0.407,60,147,0.408,0.483,33,42,0.786,20,39,59,19,14,4,35,73
1871,4,1996,24,1,3,82,37,2458,496,1092,0.454,151,358,0.422,345,734,0.47,0.523,182,219,0.831,114,238,352,131,87,40,132,208
1871,5,1997,25,1,3,82,1,1814,288,678,0.425,106,300,0.353,182,378,0.481,0.503,135,161,0.839,84,169,253,78,69,19,86,150
1871,6,1998,26,1,3,82,12,2227,449,1007,0.446,158,403,0.392,291,604,0.482,0.524,182,209,0.871,75,202,277,84,67,25,102,167
1871,7,1999,27,1,3,36,0,653,83,237,0.35,33,103,0.32,50,134,0.373,0.42,34,42,0.81,18,63,81,27,21,6,29,65
1871,8,2000,28,1,3,80,8,1831,290,670,0.433,113,263,0.43,177,407,0.435,0.517,120,141,0.851,63,208,271,72,45,24,84,185
1871,9,2001,29,1,3,13,0,135,17,55,0.309,7,23,0.304,10,32,0.313,0.373,9,10,0.9,4,18,22,9,4,1,6,8
1871,9,2001,29,1,3,38,1,453,77,193,0.399,29,80,0.363,48,113,0.425,0.474,24,32,0.75,18,41,59,14,8,6,20,45
1871,9,2001,29,1,3,51,1,588,94,248,0.379,36,103,0.35,58,145,0.4,0.452,33,42,0.786,22,59,81,23,12,7,26,53
1871,10,2002,30,1,3,40,3,473,85,207,0.411,40,104,0.385,45,103,0.437,0.507,17,21,0.81,18,35,53,19,11,8,25,38
1871,11,2003,31,1,3,31,0,193,23,71,0.324,8,38,0.211,15,33,0.455,0.38,7,9,0.778,5,18,23,12,5,3,14,22
1887,1,2014,20,1,3,22,1,156,12,35,0.343,4,19,0.211,8,16,0.5,0.4,9,10,0.9,0,16,16,6,3,1,11,22
1891,1,2004,22,1,3,41,3,427,52,129,0.403,21,44,0.477,31,85,0.365,0.484,20,24,0.833,19,36,55,14,13,2,21,41
1891,2,2005,23,1,3,81,14,1491,269,671,0.401,80,194,0.412,189,477,0.396,0.461,70,85,0.824,32,132,164,61,40,6,46,132
1891,3,2006,24,1,3,51,2,665,79,177,0.446,21,53,0.396,58,124,0.468,0.506,28,33,0.848,12,59,71,37,7,3,20,89
1891,4,2007,25,1,3,67,35,1767,278,563,0.494,108,210,0.514,170,353,0.482,0.59,66,74,0.892,26,154,180,81,38,2,70,135
1891,5,2008,26,1,3,81,7,1530,243,498,0.488,57,118,0.483,186,380,0.489,0.545,37,43,0.86,31,89,120,65,34,2,58,131
1891,7,2010,28,1,3,57,12,976,126,301,0.419,63,171,0.368,63,130,0.485,0.523,9,15,0.6,14,52,66,39,21,6,34,80
1891,8,2011,29,1,3,24,2,112,7,28,0.25,1,8,0.125,6,20,0.3,0.268,1,2,0.5,3,8,11,4,2,1,2,4
1900,3,1995,24,1,3,75,0,1270,172,298,0.577,0,0,-1,172,298,0.577,0.577,117,173,0.676,135,192,327,30,36,25,62,141
1912,1,1980,22,1,3,50,-1,1233,280,593,0.472,3,15,0.2,277,578,0.479,0.475,146,203,0.719,124,152,276,108,60,34,140,176
1912,2,1981,23,1,3,25,-1,654,120,285,0.421,0,2,0,120,283,0.424,0.421,68,106,0.642,53,67,120,45,34,29,78,89
1912,3,1982,24,1,3,11,0,183,35,86,0.407,0,3,0,35,83,0.422,0.407,27,41,0.659,13,26,39,12,5,7,22,32
1912,3,1982,24,1,3,49,10,558,81,185,0.438,0,0,-1,81,185,0.438,0.438,78,119,0.655,67,87,154,45,13,14,62,99
1912,3,1982,24,1,3,60,10,741,116,271,0.428,0,3,0,116,268,0.433,0.428,105,160,0.656,80,113,193,57,18,21,84,131
1912,4,1983,25,1,3,80,9,1507,247,450,0.549,0,3,0,247,447,0.553,0.549,173,257,0.673,158,245,403,97,52,35,149,243
1912,5,1984,26,1,3,80,21,1783,313,603,0.519,2,6,0.333,311,597,0.521,0.521,250,356,0.702,188,203,391,91,68,31,195,249
1912,6,1985,27,1,3,10,0,114,21,53,0.396,0,1,0,21,52,0.404,0.396,20,28,0.714,6,13,19,13,7,0,12,16
1920,2,1981,28,1,3,77,-1,2161,454,946,0.48,0,0,-1,454,946,0.48,0.48,180,245,0.735,179,219,398,120,75,18,161,160
1922,1,1985,22,1,3,77,0,958,178,372,0.478,0,3,0,178,369,0.482,0.478,117,181,0.646,95,111,206,63,49,29,66,147
1922,2,1986,23,1,3,79,2,1217,258,470,0.549,0,6,0,258,464,0.556,0.549,156,229,0.681,137,156,293,83,85,32,113,208
1922,3,1987,24,1,3,82,8,2088,373,733,0.509,1,23,0.043,372,710,0.524,0.51,262,364,0.72,201,295,496,194,122,77,149,328
1922,4,1988,25,1,3,79,75,2888,611,1225,0.499,3,15,0.2,608,1210,0.502,0.5,291,396,0.735,211,446,657,243,127,65,161,302
1922,5,1989,26,1,3,76,76,2716,533,1137,0.469,6,21,0.286,527,1116,0.472,0.471,258,372,0.694,246,383,629,243,137,84,167,277
1922,6,1990,27,1,3,82,82,2843,519,1085,0.478,3,20,0.15,516,1065,0.485,0.48,269,390,0.69,251,439,690,188,121,63,144,304
1922,7,1991,28,1,3,73,72,2359,424,887,0.478,4,13,0.308,420,874,0.481,0.48,232,327,0.709,169,312,481,227,101,76,149,251
1922,8,1992,29,1,3,77,76,2553,398,852,0.467,1,8,0.125,397,844,0.47,0.468,174,262,0.664,241,392,633,243,114,71,151,254
1922,9,1993,30,1,3,65,50,1719,281,642,0.438,8,28,0.286,273,614,0.445,0.444,116,183,0.634,126,280,406,121,80,41,84,181
1922,10,1994,31,1,3,78,6,1276,203,469,0.433,1,8,0.125,202,461,0.438,0.434,101,135,0.748,130,201,331,75,71,49,63,213
1922,11,1995,32,1,3,63,0,1143,203,489,0.415,7,27,0.259,196,462,0.424,0.422,95,124,0.766,93,163,256,82,52,35,64,173
1922,12,1996,33,1,3,76,58,1620,205,500,0.41,3,17,0.176,202,483,0.418,0.413,97,147,0.66,154,209,363,114,91,45,75,205
1922,13,1997,34,1,3,70,44,1766,194,449,0.432,17,65,0.262,177,384,0.461,0.451,71,118,0.602,112,251,363,89,119,49,74,219
1922,14,1998,35,1,3,37,2,717,97,233,0.416,1,10,0.1,96,223,0.43,0.418,39,65,0.6,56,79,135,44,52,14,36,104
1922,15,1999,36,1,3,45,0,699,68,200,0.34,3,14,0.214,65,186,0.349,0.348,6,14,0.429,42,88,130,41,37,14,30,92
1922,16,2000,37,1,3,72,18,1310,146,354,0.412,0,9,0,146,345,0.423,0.412,29,41,0.707,58,167,225,69,67,47,51,161
1922,17,2001,38,1,3,22,2,243,32,69,0.464,0,1,0,32,68,0.471,0.464,8,16,0.5,8,37,45,15,14,8,6,36
1929,1,2005,22,1,3,32,5,523,54,124,0.435,4,11,0.364,50,113,0.442,0.452,23,42,0.548,28,80,108,25,20,18,33,80
1929,2,2006,23,1,3,69,53,1492,158,342,0.462,10,30,0.333,148,312,0.474,0.477,77,111,0.694,114,193,307,88,50,29,84,209
1932,1,2013,19,1,3,78,77,2025,281,613,0.458,2,9,0.222,279,604,0.462,0.46,140,187,0.749,131,324,455,117,54,70,101,164
1932,2,2014,20,1,3,62,62,1502,167,353,0.473,1,9,0.111,166,344,0.483,0.475,113,184,0.614,109,215,324,52,43,39,60,145
1932,3,2015,21,1,3,6,6,140,20,32,0.625,0,0,-1,20,32,0.625,0.625,19,27,0.704,7,26,33,8,1,5,6,13
1933,1,1980,28,1,3,26,-1,212,32,96,0.333,0,0,-1,32,96,0.333,0.333,18,25,0.72,12,28,40,19,10,2,30,43
1942,1,2000,27,1,3,62,28,1060,139,277,0.502,0,0,-1,139,277,0.502,0.502,49,66,0.742,84,166,250,49,34,15,41,132
1942,2,2001,28,1,3,45,3,706,90,176,0.511,0,0,-1,90,176,0.511,0.511,36,45,0.8,39,90,129,31,14,11,47,94
1946,3,1982,24,1,3,80,76,2609,383,752,0.509,0,0,-1,383,752,0.509,0.509,201,285,0.705,162,361,523,173,84,29,155,221
1946,4,1983,25,1,3,58,5,995,104,225,0.462,0,0,-1,104,225,0.462,0.462,73,96,0.76,91,149,240,58,28,11,65,94
1946,5,1984,26,1,3,77,42,2086,233,448,0.52,0,2,0,233,446,0.522,0.52,136,206,0.66,134,336,470,179,54,24,127,159
1946,6,1985,27,1,3,60,5,860,63,149,0.423,0,0,-1,63,149,0.423,0.423,41,59,0.695,44,78,122,53,28,11,42,74
1963,1,1980,27,1,3,75,-1,1910,385,722,0.533,4,15,0.267,381,707,0.539,0.536,212,262,0.809,136,225,361,155,82,9,132,96
1963,3,1982,29,1,3,81,19,1803,378,764,0.495,9,32,0.281,369,732,0.504,0.501,233,282,0.826,97,160,257,118,63,14,137,132
1963,5,1984,31,1,3,75,39,1885,358,729,0.491,4,14,0.286,354,715,0.495,0.494,243,283,0.859,89,166,255,160,54,6,155,122
1963,6,1985,32,1,3,52,1,611,125,285,0.439,10,24,0.417,115,261,0.441,0.456,51,57,0.895,40,56,96,59,14,1,57,48
1963,6,1985,32,1,3,68,1,800,156,354,0.441,11,25,0.44,145,329,0.441,0.456,64,73,0.877,50,68,118,80,16,2,70,62
1981,1,2006,18,1,3,24,0,127,9,30,0.3,2,7,0.286,7,23,0.304,0.333,7,10,0.7,5,8,13,9,3,0,6,11
1982,1,2004,22,1,3,74,0,882,115,327,0.352,81,207,0.391,34,120,0.283,0.476,19,24,0.792,30,81,111,40,25,8,41,102
1982,2,2005,23,1,3,82,57,2667,317,759,0.418,226,558,0.405,91,201,0.453,0.567,82,96,0.854,40,339,379,182,103,33,106,265
1982,3,2006,24,1,3,82,43,2563,327,761,0.43,184,438,0.42,143,323,0.443,0.551,101,119,0.849,27,243,270,163,65,26,98,224
1982,4,2007,25,1,3,74,1,2288,372,845,0.44,132,307,0.43,240,538,0.446,0.518,191,209,0.914,30,229,259,105,57,20,117,188
1982,6,2009,27,1,3,78,2,1874,245,560,0.438,103,267,0.386,142,293,0.485,0.529,112,127,0.882,35,223,258,137,47,30,90,170
1982,10,2013,31,1,3,74,60,2259,277,601,0.461,189,414,0.457,88,187,0.471,0.618,67,78,0.859,23,270,293,146,70,37,70,170
2009,1,2009,23,1,3,40,5,442,51,131,0.389,15,38,0.395,36,93,0.387,0.447,40,50,0.8,33,48,81,20,14,19,16,78
2010,1,1994,25,1,3,75,8,1808,313,726,0.431,32,118,0.271,281,608,0.462,0.453,156,210,0.743,98,199,297,252,81,33,167,122
2010,2,1995,26,1,3,81,55,2584,487,967,0.504,62,198,0.313,425,769,0.553,0.536,235,314,0.748,155,285,440,372,102,16,165,163
2010,3,1996,27,1,3,81,20,2103,386,787,0.49,87,216,0.403,299,571,0.524,0.546,206,267,0.772,115,208,323,287,64,28,114,150
2010,4,1997,28,1,3,57,15,1610,285,605,0.471,50,151,0.331,235,454,0.518,0.512,134,174,0.77,94,167,261,256,60,29,91,97
2010,5,1998,29,1,3,74,52,2235,383,841,0.455,63,174,0.362,320,667,0.48,0.493,155,219,0.708,121,206,327,314,76,37,154,149
2010,6,1999,30,1,3,44,44,1654,315,750,0.42,39,137,0.285,276,613,0.45,0.446,159,215,0.74,65,245,310,235,49,11,121,82
2010,7,2000,31,1,3,24,23,868,148,388,0.381,18,78,0.231,130,310,0.419,0.405,118,155,0.761,37,93,130,124,44,19,75,51
2010,7,2000,31,1,3,32,8,916,149,340,0.438,26,90,0.289,123,250,0.492,0.476,74,110,0.673,38,105,143,141,33,9,71,61
2010,7,2000,31,1,3,56,31,1784,297,728,0.408,44,168,0.262,253,560,0.452,0.438,192,265,0.725,75,198,273,265,77,28,146,112
2010,8,2001,32,1,3,17,14,618,124,252,0.492,38,79,0.481,86,173,0.497,0.567,49,72,0.681,19,78,97,106,13,5,51,36
2010,8,2001,32,1,3,48,5,979,151,330,0.458,32,78,0.41,119,252,0.472,0.506,52,88,0.591,47,115,162,93,35,6,60,62
2010,8,2001,32,1,3,65,19,1597,275,582,0.473,70,157,0.446,205,425,0.482,0.533,101,160,0.631,66,193,259,199,48,11,111,98
2010,9,2002,33,1,3,59,9,1494,211,504,0.419,53,171,0.31,158,333,0.474,0.471,109,153,0.712,43,175,218,210,48,17,113,91
2010,12,2005,36,1,3,53,6,1099,105,256,0.41,42,116,0.362,63,140,0.45,0.492,44,61,0.721,31,129,160,160,39,13,64,70
2027,1,2013,20,1,3,23,0,147,24,68,0.353,9,30,0.3,15,38,0.395,0.419,14,14,1,5,13,18,5,2,2,6,13
2029,1,2003,23,1,3,35,0,487,56,129,0.434,0,4,0,56,125,0.448,0.434,57,82,0.695,26,57,83,31,7,3,25,43
2032,1,2010,24,1,3,17,0,108,16,41,0.39,9,26,0.346,7,15,0.467,0.5,3,5,0.6,5,14,19,0,1,2,6,14
2032,1,2010,24,1,3,18,0,111,16,43,0.372,9,28,0.321,7,15,0.467,0.477,3,5,0.6,5,14,19,0,1,2,6,14
2037,1,1996,23,1,3,41,0,367,41,77,0.532,0,2,0,41,75,0.547,0.532,34,47,0.723,17,36,53,12,14,12,24,61
2040,1,2001,23,1,3,33,0,241,37,99,0.374,0,1,0,37,98,0.378,0.374,16,29,0.552,13,28,41,4,7,1,8,16
2040,2,2002,24,1,3,34,8,434,49,125,0.392,1,4,0.25,48,121,0.397,0.396,8,11,0.727,22,45,67,14,8,5,9,25
2040,3,2003,25,1,3,60,0,541,81,202,0.401,9,31,0.29,72,171,0.421,0.423,12,20,0.6,19,68,87,21,15,6,16,58
2069,1,2006,22,1,3,67,14,1129,137,230,0.596,0,0,-1,137,230,0.596,0.596,71,123,0.577,109,194,303,43,30,20,51,124
2074,1,1991,23,1,3,48,0,265,19,71,0.268,3,15,0.2,16,56,0.286,0.289,25,28,0.893,7,23,30,34,11,2,20,39
2084,1,2012,20,1,3,64,39,1534,199,404,0.493,41,109,0.376,158,295,0.536,0.543,68,88,0.773,104,223,327,70,85,24,44,88
2084,2,2013,21,1,3,58,57,1810,260,526,0.494,65,174,0.374,195,352,0.554,0.556,104,126,0.825,63,283,346,93,97,32,62,99
2084,3,2014,22,1,3,66,65,1923,337,645,0.522,69,182,0.379,268,463,0.579,0.576,101,126,0.802,76,336,412,133,114,50,80,127
2084,4,2015,23,1,3,8,8,250,41,90,0.456,7,25,0.28,34,65,0.523,0.494,22,26,0.846,14,44,58,19,13,5,11,19
2097,1,1996,20,1,3,16,0,189,29,60,0.483,2,7,0.286,27,53,0.509,0.5,15,25,0.6,15,14,29,3,8,3,14,21
2100,1,1999,19,1,3,20,7,145,19,52,0.365,1,6,0.167,18,46,0.391,0.375,8,14,0.571,13,12,25,4,8,1,20,19
2100,2,2000,20,1,3,82,8,1575,275,566,0.486,40,120,0.333,235,446,0.527,0.521,84,123,0.683,127,209,336,70,62,36,78,163
2100,4,2002,22,1,3,71,70,2585,455,972,0.468,123,316,0.389,332,656,0.506,0.531,162,200,0.81,139,359,498,123,104,40,97,174
2100,5,2003,23,1,3,77,77,3044,519,1149,0.452,75,217,0.346,444,932,0.476,0.484,283,345,0.82,152,351,503,133,99,35,143,205
2100,6,2004,24,1,3,80,80,2931,535,1229,0.435,145,386,0.376,390,843,0.463,0.494,206,270,0.763,133,385,518,175,99,54,135,233
2100,7,2005,25,1,3,71,71,2697,532,1151,0.462,173,432,0.4,359,719,0.499,0.537,220,283,0.777,110,278,388,94,75,62,123,158
2100,8,2006,26,1,3,78,77,2876,538,1151,0.467,142,370,0.384,396,781,0.507,0.529,350,428,0.818,111,279,390,182,102,50,141,191
2100,9,2007,27,1,3,60,60,2348,463,1005,0.461,151,387,0.39,312,618,0.505,0.536,265,315,0.841,91,305,396,145,68,39,118,143
2100,13,2011,31,1,3,32,27,1014,139,312,0.446,43,124,0.347,96,188,0.511,0.514,43,51,0.843,48,136,184,63,30,20,52,96
2100,13,2011,31,1,3,57,52,1824,252,582,0.433,87,244,0.357,165,338,0.488,0.508,77,96,0.802,71,219,290,92,52,30,87,159
2100,14,2012,32,1,3,28,15,729,85,221,0.385,16,67,0.239,69,154,0.448,0.421,31,37,0.838,34,75,109,27,23,10,32,49
2100,16,2014,34,1,3,60,6,971,98,236,0.415,46,134,0.343,52,102,0.51,0.513,26,33,0.788,24,86,110,57,53,8,35,90
2101,2,1989,23,1,3,81,57,2657,604,1242,0.486,3,22,0.136,601,1220,0.493,0.488,284,361,0.787,116,261,377,218,124,72,142,258
2102,1,1991,22,1,3,76,18,1171,216,513,0.421,17,57,0.298,199,456,0.436,0.438,58,92,0.63,117,104,221,64,48,19,71,153
2102,2,1992,23,1,3,75,13,1527,275,621,0.443,17,50,0.34,258,571,0.452,0.457,131,180,0.728,144,164,308,58,66,29,90,165
2102,3,1993,24,1,3,78,32,1585,252,620,0.406,22,59,0.373,230,561,0.41,0.424,102,156,0.654,131,204,335,105,64,21,79,143
2102,4,1994,25,1,3,35,0,274,36,116,0.31,10,27,0.37,26,89,0.292,0.353,18,37,0.486,26,30,56,15,11,4,22,29
2102,4,1994,25,1,3,38,0,285,40,123,0.325,10,28,0.357,30,95,0.316,0.366,19,39,0.487,26,35,61,17,11,4,24,34
2105,1,2012,23,1,3,17,0,115,12,25,0.48,0,4,0,12,21,0.571,0.48,9,19,0.474,6,9,15,5,6,0,10,6
2126,1,1982,22,1,3,71,13,1139,208,448,0.464,0,11,0,208,437,0.476,0.464,77,107,0.72,69,126,195,88,35,30,68,147
2126,2,1983,23,1,3,66,13,818,138,300,0.46,5,9,0.556,133,291,0.457,0.468,53,80,0.663,37,88,125,72,29,8,64,98
2126,3,1984,24,1,3,10,0,133,19,43,0.442,1,3,0.333,18,40,0.45,0.453,9,13,0.692,7,11,18,14,3,5,11,15
2126,3,1984,24,1,3,11,0,137,19,43,0.442,1,3,0.333,18,40,0.45,0.453,9,13,0.692,7,11,18,14,3,5,11,16
2128,2,2003,30,1,3,19,0,131,19,50,0.38,1,1,1,18,49,0.367,0.39,1,5,0.2,13,27,40,2,2,8,9,22
2128,2,2003,30,1,3,26,0,211,28,75,0.373,2,3,0.667,26,72,0.361,0.387,2,10,0.2,21,39,60,6,5,11,20,35
2158,1,1994,23,1,3,71,46,1762,291,573,0.508,0,5,0,291,568,0.512,0.508,99,166,0.596,220,190,410,96,102,27,87,177
2158,2,1995,24,1,3,56,15,953,138,295,0.468,3,21,0.143,135,274,0.493,0.473,62,86,0.721,75,109,184,62,51,10,73,86
2158,3,1996,25,1,3,76,6,1012,117,272,0.43,4,13,0.308,113,259,0.436,0.438,53,80,0.663,82,127,209,51,47,10,40,106
2158,4,1997,26,1,3,41,27,1059,137,291,0.471,8,31,0.258,129,260,0.496,0.485,60,97,0.619,98,163,261,76,63,17,64,97
2158,5,1998,27,1,3,82,0,1493,248,516,0.481,9,30,0.3,239,486,0.492,0.489,111,158,0.703,147,215,362,122,65,41,104,161
2158,6,1999,28,1,3,43,43,1315,147,349,0.421,9,23,0.391,138,326,0.423,0.434,53,84,0.631,110,169,279,76,85,22,79,142
2158,7,2000,29,1,3,75,75,2416,297,644,0.461,15,36,0.417,282,608,0.464,0.473,113,183,0.617,216,366,582,136,119,38,120,231
2158,8,2001,30,1,3,82,80,2649,274,616,0.445,15,57,0.263,259,559,0.463,0.457,123,171,0.719,200,390,590,139,99,30,109,222
2158,9,2002,31,1,3,45,18,893,73,198,0.369,1,6,0.167,72,192,0.375,0.371,25,40,0.625,70,116,186,54,40,14,41,75
2158,11,2004,33,1,3,78,51,1701,149,375,0.397,43,139,0.309,106,236,0.449,0.455,34,51,0.667,96,216,312,117,48,18,64,159
2158,12,2005,34,1,3,44,27,933,68,189,0.36,11,37,0.297,57,152,0.375,0.389,17,23,0.739,55,119,174,88,32,12,57,83
2163,2,1997,24,1,3,19,0,175,17,72,0.236,1,10,0.1,16,62,0.258,0.243,11,12,0.917,9,27,36,11,5,2,6,19
2163,2,1997,24,1,3,45,5,634,76,207,0.367,17,60,0.283,59,147,0.401,0.408,20,23,0.87,41,71,112,28,24,10,14,78
2163,2,1997,24,1,3,64,5,809,93,279,0.333,18,70,0.257,75,209,0.359,0.366,31,35,0.886,50,98,148,39,29,12,20,97
2176,1,1981,22,1,3,79,-1,2473,365,751,0.486,5,18,0.278,360,733,0.491,0.489,135,212,0.637,179,299,478,252,86,27,146,243
2176,2,1982,23,1,3,80,32,2018,383,778,0.492,8,23,0.348,375,755,0.497,0.497,135,189,0.714,111,194,305,192,83,13,147,175
2176,3,1983,24,1,3,46,14,803,136,259,0.525,2,9,0.222,134,250,0.536,0.529,34,48,0.708,42,72,114,82,42,11,62,67
2176,4,1984,25,1,3,73,25,1191,186,385,0.483,5,28,0.179,181,357,0.507,0.49,53,87,0.609,71,104,175,95,34,11,75,148
2176,5,1985,26,1,3,43,29,1119,194,393,0.494,8,21,0.381,186,372,0.5,0.504,42,67,0.627,46,120,166,102,32,16,51,115
2176,6,1986,27,1,3,67,11,1031,160,336,0.476,7,27,0.259,153,309,0.495,0.487,23,39,0.59,33,102,135,118,29,9,54,134
2176,7,1987,28,1,3,15,0,123,16,42,0.381,0,2,0,16,40,0.4,0.381,0,2,0,6,8,14,13,2,0,6,10
2191,1,2000,20,1,3,76,70,2767,449,1024,0.438,59,164,0.36,390,860,0.453,0.467,302,420,0.719,159,436,595,317,91,95,258,291
2191,3,2002,22,1,3,29,25,999,151,360,0.419,16,84,0.19,135,276,0.489,0.442,61,93,0.656,31,145,176,171,23,36,97,91
2191,4,2003,23,1,3,49,47,1679,268,611,0.439,42,129,0.326,226,482,0.469,0.473,136,175,0.777,59,267,326,178,42,41,140,181
2191,13,2012,32,1,3,50,4,1027,123,349,0.352,28,111,0.252,95,238,0.399,0.393,58,98,0.592,36,172,208,83,20,18,52,97
2196,1,1980,23,1,3,75,-1,2111,291,609,0.478,0,3,0,291,606,0.48,0.478,210,264,0.795,83,335,418,327,67,22,180,274
2196,2,1981,24,1,3,82,-1,2408,348,685,0.508,1,7,0.143,347,678,0.512,0.509,315,380,0.829,146,325,471,277,75,31,202,307
2209,1,1981,22,1,3,82,-1,1787,348,709,0.491,0,6,0,348,703,0.495,0.491,163,202,0.807,172,189,361,132,55,25,123,153
2209,2,1982,23,1,3,80,41,1951,357,719,0.497,1,8,0.125,356,711,0.501,0.497,203,254,0.799,127,204,331,134,56,26,137,182
2209,3,1983,24,1,3,82,14,1666,274,593,0.462,0,2,0,274,591,0.464,0.462,140,175,0.8,94,134,228,94,64,24,93,134
2209,4,1984,25,1,3,78,20,1640,262,572,0.458,0,0,-1,262,572,0.458,0.458,173,211,0.82,101,127,228,61,66,17,95,142
2209,6,1986,27,1,3,74,64,2237,330,741,0.445,0,4,0,330,737,0.448,0.445,218,278,0.784,123,189,312,179,61,26,118,177
2209,7,1987,28,1,3,65,8,1440,166,389,0.427,1,5,0.2,165,384,0.43,0.428,125,172,0.727,102,130,232,110,47,18,70,123
2209,8,1988,29,1,3,29,0,180,16,50,0.32,0,1,0,16,49,0.327,0.32,8,16,0.5,13,21,34,9,6,0,14,27
2218,1,1994,22,1,3,37,14,871,98,167,0.587,0,2,0,98,165,0.594,0.587,61,103,0.592,81,131,212,36,36,37,31,94
2219,1,2005,20,1,3,59,2,793,133,267,0.498,4,10,0.4,129,257,0.502,0.506,49,75,0.653,40,81,121,35,30,40,39,77
2219,5,2009,24,1,3,81,6,2246,385,850,0.453,89,236,0.377,296,614,0.482,0.505,175,242,0.723,70,261,331,83,47,57,94,168
2219,6,2010,25,1,3,11,0,231,38,101,0.376,12,31,0.387,26,70,0.371,0.436,21,24,0.875,13,25,38,8,7,8,12,13
2219,6,2010,25,1,3,23,6,499,72,180,0.4,28,74,0.378,44,106,0.415,0.478,28,35,0.8,20,63,83,26,11,9,20,30
2219,6,2010,25,1,3,34,6,730,110,281,0.391,40,105,0.381,70,176,0.398,0.463,49,59,0.831,33,88,121,34,18,17,32,43
2219,7,2011,26,1,3,82,55,2358,274,731,0.375,76,252,0.302,198,479,0.413,0.427,132,171,0.772,54,271,325,84,34,36,71,148
2219,8,2012,27,1,3,39,5,500,60,175,0.343,16,60,0.267,44,115,0.383,0.389,31,46,0.674,19,42,61,16,19,21,20,34
2219,9,2013,28,1,3,38,2,444,74,177,0.418,14,50,0.28,60,127,0.472,0.458,38,52,0.731,17,44,61,21,11,8,19,35
2219,10,2014,29,1,3,63,4,1065,130,326,0.399,41,117,0.35,89,209,0.426,0.462,42,52,0.808,36,132,168,48,20,19,26,94
2224,1,2011,28,1,3,5,0,112,12,26,0.462,5,10,0.5,7,16,0.438,0.558,2,5,0.4,1,10,11,7,7,5,5,14
2224,1,2011,28,1,3,12,0,143,15,32,0.469,6,13,0.462,9,19,0.474,0.563,4,9,0.444,1,14,15,8,9,5,5,18
2227,5,1996,26,1,3,22,11,594,84,200,0.42,5,12,0.417,79,188,0.42,0.433,45,70,0.643,49,76,125,70,19,16,51,60
2227,5,1996,26,1,3,40,40,1388,239,473,0.505,0,6,0,239,467,0.512,0.505,112,177,0.633,94,192,286,134,30,22,113,132
2227,5,1996,26,1,3,62,51,1982,323,673,0.48,5,18,0.278,318,655,0.485,0.484,157,247,0.636,143,268,411,204,49,38,164,192
2227,6,1997,27,1,3,66,56,1995,299,640,0.467,25,72,0.347,274,568,0.482,0.487,101,145,0.697,134,258,392,187,62,25,133,187
2227,7,1998,28,1,3,78,78,2348,338,728,0.464,26,70,0.371,312,658,0.474,0.482,116,197,0.589,170,412,582,219,93,38,153,231
2227,8,1999,29,1,3,21,19,451,65,165,0.394,5,11,0.455,60,154,0.39,0.409,28,35,0.8,35,45,80,38,12,4,33,37
2227,9,2000,30,1,3,16,4,386,38,100,0.38,2,7,0.286,36,93,0.387,0.39,25,42,0.595,36,73,109,38,7,5,24,47
2247,1,1980,24,1,3,82,-1,2849,483,988,0.489,0,2,0,483,986,0.49,0.489,237,302,0.785,166,298,464,254,173,32,163,195
2247,3,1982,26,1,3,71,0,899,116,245,0.473,0,0,-1,116,245,0.473,0.473,48,72,0.667,73,104,177,89,39,11,51,101
2253,1,1990,23,1,3,28,1,181,27,79,0.342,0,1,0,27,78,0.346,0.342,18,22,0.818,15,15,30,10,3,7,21,37
2259,1,2012,23,1,3,63,57,1804,248,549,0.452,60,178,0.337,188,371,0.507,0.506,43,78,0.551,90,210,300,134,73,29,81,142
2259,2,2013,24,1,3,76,76,2758,456,939,0.486,152,395,0.385,304,544,0.559,0.567,113,155,0.729,79,325,404,269,75,32,147,148
2259,3,2014,25,1,3,74,74,2783,466,987,0.472,130,351,0.37,336,636,0.528,0.538,164,221,0.742,69,340,409,298,88,29,144,168
2259,4,2015,26,1,3,10,10,311,50,125,0.4,16,49,0.327,34,76,0.447,0.464,24,30,0.8,14,32,46,21,9,5,10,17
2268,1,1999,23,1,3,24,2,144,21,51,0.412,1,6,0.167,20,45,0.444,0.422,22,31,0.71,17,13,30,2,5,3,12,16
2268,2,2000,24,1,3,81,74,2097,354,661,0.536,12,27,0.444,342,634,0.539,0.545,222,321,0.692,218,216,434,126,94,40,144,190
2268,3,2001,25,1,3,76,22,2059,370,749,0.494,2,36,0.056,368,713,0.516,0.495,246,361,0.681,183,199,382,161,103,45,155,176
2268,4,2002,26,1,3,75,13,1765,319,619,0.515,9,36,0.25,310,583,0.532,0.523,192,274,0.701,155,143,298,107,79,37,114,140
2268,5,2003,27,1,3,78,17,1655,254,516,0.492,3,20,0.15,251,496,0.506,0.495,138,220,0.627,120,144,264,101,73,29,117,161
2268,6,2004,28,1,3,73,1,1651,200,395,0.506,2,12,0.167,198,383,0.517,0.509,105,190,0.553,129,139,268,139,84,21,105,152
2268,7,2005,29,1,3,70,36,1957,319,601,0.531,2,25,0.08,317,576,0.55,0.532,169,282,0.599,126,147,273,138,106,21,143,164
2268,8,2006,30,1,3,45,2,1056,188,379,0.496,0,7,0,188,372,0.505,0.496,138,226,0.611,73,81,154,60,42,12,82,79
2268,8,2006,30,1,3,71,22,1792,327,635,0.515,1,13,0.077,326,622,0.524,0.516,203,338,0.601,118,126,244,127,76,21,150,150
2268,9,2007,31,1,3,81,53,2508,475,867,0.548,3,19,0.158,472,848,0.557,0.55,241,376,0.641,190,250,440,232,110,25,199,232
2268,10,2008,32,1,3,20,5,327,39,86,0.453,0,2,0,39,84,0.464,0.453,24,43,0.558,24,40,64,17,21,7,27,37
2272,1,2004,20,1,3,79,14,1144,149,376,0.396,19,70,0.271,130,306,0.425,0.422,65,84,0.774,44,115,159,60,41,16,67,187
2272,6,2009,25,1,3,66,12,1053,116,275,0.422,48,117,0.41,68,158,0.43,0.509,25,54,0.463,31,96,127,72,22,16,48,122
2272,7,2010,26,1,3,71,0,877,109,300,0.363,35,118,0.297,74,182,0.407,0.422,10,26,0.385,12,105,117,58,23,6,53,84
2272,8,2011,27,1,3,10,6,163,15,35,0.429,7,16,0.438,8,19,0.421,0.529,4,5,0.8,0,12,12,7,5,3,5,15
2272,8,2011,27,1,3,31,7,362,29,72,0.403,12,31,0.387,17,41,0.415,0.486,6,10,0.6,1,31,32,16,10,7,12,34
2272,9,2012,28,1,3,45,7,527,50,128,0.391,17,58,0.293,33,70,0.471,0.457,3,8,0.375,4,68,72,18,20,15,20,54
2276,1,1990,23,1,3,35,4,216,47,108,0.435,4,10,0.4,43,98,0.439,0.454,16,18,0.889,11,15,26,10,7,6,20,37
2276,2,1991,24,1,3,47,6,444,68,189,0.36,4,18,0.222,64,171,0.374,0.37,26,29,0.897,17,49,66,16,10,6,21,43
2276,3,1992,25,1,3,49,3,353,65,145,0.448,5,12,0.417,60,133,0.451,0.466,9,13,0.692,13,41,54,17,16,8,19,34
2276,4,1993,26,1,3,13,0,154,38,90,0.422,4,18,0.222,34,72,0.472,0.444,4,4,1,4,20,24,18,5,2,7,15
2283,1,1980,22,1,3,52,-1,628,73,169,0.432,0,2,0,73,167,0.437,0.432,34,55,0.618,66,117,183,33,17,23,48,100
2301,6,1990,28,1,3,76,70,2668,435,883,0.493,6,28,0.214,429,855,0.502,0.496,330,424,0.778,209,363,572,175,88,64,148,225
2304,11,2005,33,1,3,16,3,206,25,57,0.439,8,21,0.381,17,36,0.472,0.509,4,4,1,1,21,22,11,6,0,7,6
2304,11,2005,33,1,3,25,0,461,82,169,0.485,33,68,0.485,49,101,0.485,0.583,5,9,0.556,2,59,61,28,13,4,10,24
2304,11,2005,33,1,3,41,3,667,107,226,0.473,41,89,0.461,66,137,0.482,0.564,9,13,0.692,3,80,83,39,19,4,17,30
2309,2,2002,24,1,3,63,56,1988,336,768,0.438,84,231,0.364,252,537,0.469,0.492,127,169,0.751,91,132,223,153,73,11,86,174
2309,3,2003,25,1,3,82,80,2949,421,1073,0.392,116,344,0.337,305,729,0.418,0.446,195,247,0.789,97,266,363,188,88,32,128,232
2309,4,2004,26,1,3,82,29,2148,238,587,0.405,126,340,0.371,112,247,0.453,0.513,76,94,0.809,35,226,261,113,88,14,69,206
2309,7,2007,29,1,3,71,12,1515,222,517,0.429,106,295,0.359,116,222,0.523,0.532,84,123,0.683,32,205,237,47,45,12,53,126
2323,1,1983,21,1,3,48,0,416,56,138,0.406,0,2,0,56,136,0.412,0.406,40,59,0.678,27,50,77,29,14,8,50,58
2326,1,1999,21,1,3,48,47,1632,284,647,0.439,84,204,0.412,200,443,0.451,0.504,139,195,0.713,117,192,309,115,82,50,113,139
2326,2,2000,22,1,3,73,72,2583,486,1099,0.442,96,280,0.343,390,819,0.476,0.486,359,450,0.798,83,313,396,221,152,62,178,237
2326,3,2001,23,1,3,82,82,3120,687,1513,0.454,147,384,0.383,540,1129,0.478,0.503,550,738,0.745,94,428,522,253,138,69,262,251
2326,7,2005,27,1,3,82,82,2960,556,1223,0.455,108,292,0.37,448,931,0.481,0.499,549,668,0.822,78,461,539,348,133,39,230,255
2326,8,2006,28,1,3,79,79,3084,689,1462,0.471,111,314,0.354,578,1148,0.503,0.509,627,812,0.772,77,453,530,375,107,34,273,223
2326,10,2008,30,1,3,80,80,2874,509,1098,0.464,143,365,0.392,366,733,0.499,0.529,409,485,0.843,53,358,411,363,101,36,221,200
2326,11,2009,31,1,3,81,81,3035,540,1181,0.457,119,304,0.391,421,877,0.48,0.508,459,553,0.83,56,401,457,294,80,27,228,215
2326,12,2010,32,1,3,71,71,2411,409,867,0.472,109,263,0.414,300,604,0.497,0.535,369,433,0.852,39,271,310,218,84,31,166,196
2326,13,2011,33,1,3,80,80,2774,507,1021,0.497,111,297,0.374,396,724,0.547,0.551,386,449,0.86,34,396,430,260,80,51,171,231
2326,14,2012,34,1,3,61,61,2075,394,890,0.443,100,273,0.366,294,617,0.476,0.499,293,344,0.852,37,280,317,274,70,26,173,147
2326,15,2013,35,1,3,77,77,2575,476,1092,0.436,145,382,0.38,331,710,0.466,0.502,333,423,0.787,45,442,487,370,84,30,214,210
2326,16,2014,36,1,3,75,68,2098,321,712,0.451,112,300,0.373,209,412,0.507,0.529,256,310,0.826,26,322,348,178,86,31,153,190
2326,17,2015,37,1,3,9,9,247,32,93,0.344,8,32,0.25,24,61,0.393,0.387,34,38,0.895,7,42,49,25,8,3,8,18
2328,6,2000,29,1,3,75,23,1712,238,573,0.415,93,243,0.383,145,330,0.439,0.497,85,100,0.85,74,148,222,81,44,13,57,140
2328,10,2004,33,1,3,49,0,703,72,191,0.377,43,122,0.352,29,69,0.42,0.49,14,16,0.875,10,63,73,26,16,5,29,42
2328,13,2008,37,1,3,16,0,113,12,33,0.364,11,26,0.423,1,7,0.143,0.53,4,4,1,1,11,12,10,0,1,6,11
2330,2,2005,22,1,3,67,3,1340,214,501,0.427,67,195,0.344,147,306,0.48,0.494,141,202,0.698,65,124,189,82,46,18,92,139
2330,3,2006,23,1,3,52,18,1179,169,418,0.404,56,176,0.318,113,242,0.467,0.471,87,143,0.608,58,105,163,44,33,10,78,132
2330,4,2007,24,1,3,72,38,1937,286,586,0.488,93,240,0.388,193,346,0.558,0.567,136,210,0.648,81,246,327,62,48,55,105,220
2330,5,2008,25,1,3,66,16,1316,170,387,0.439,66,183,0.361,104,204,0.51,0.525,66,98,0.673,67,175,242,49,66,43,48,200
2330,7,2010,27,1,3,75,24,1687,233,539,0.432,116,306,0.379,117,233,0.502,0.54,69,109,0.633,39,176,215,49,53,31,69,138
2330,8,2011,28,1,3,19,0,418,45,115,0.391,34,87,0.391,11,28,0.393,0.539,3,6,0.5,6,44,50,10,10,3,14,35
2330,10,2013,30,1,3,19,16,386,34,98,0.347,20,64,0.313,14,34,0.412,0.449,12,18,0.667,5,31,36,9,12,6,16,33
2332,1,1986,22,1,3,80,24,1602,255,457,0.558,0,2,0,255,455,0.56,0.558,171,254,0.673,95,213,308,90,71,37,148,190
2332,2,1987,23,1,3,80,65,2250,290,497,0.584,0,2,0,290,495,0.586,0.584,257,348,0.739,179,401,580,116,86,54,135,196
2337,3,1985,26,1,3,68,3,1001,107,227,0.471,0,2,0,107,225,0.476,0.471,109,146,0.747,90,137,227,69,20,21,100,144
2338,1,1988,22,1,3,79,0,1650,261,564,0.463,4,23,0.174,257,541,0.475,0.466,99,172,0.576,115,183,298,169,91,52,131,214
2338,2,1989,23,1,3,73,56,2413,413,867,0.476,21,77,0.273,392,790,0.496,0.488,201,301,0.668,138,307,445,256,139,61,199,261
2338,3,1990,24,1,3,82,82,3148,562,1150,0.489,28,112,0.25,534,1038,0.514,0.501,199,295,0.675,150,397,547,444,211,101,278,298
2338,4,1991,25,1,3,82,82,3014,600,1153,0.52,21,68,0.309,579,1085,0.534,0.529,240,340,0.706,163,432,595,511,193,93,232,270
2338,5,1992,26,1,3,82,82,3164,687,1359,0.506,16,80,0.2,671,1279,0.525,0.511,330,434,0.76,185,445,630,572,155,93,253,242
2338,6,1993,27,1,3,81,81,3123,628,1327,0.473,22,93,0.237,606,1234,0.491,0.482,232,350,0.663,203,418,621,507,173,73,246,219
2338,7,1994,28,1,3,72,72,2759,627,1278,0.491,63,197,0.32,564,1081,0.522,0.515,270,409,0.66,173,456,629,403,211,58,232,227
2338,8,1995,29,1,3,79,79,3014,634,1320,0.48,109,316,0.345,525,1004,0.523,0.522,315,440,0.716,175,464,639,409,232,89,271,238
2338,9,1996,30,1,3,77,77,2825,563,1216,0.463,150,401,0.374,413,815,0.507,0.525,220,324,0.679,152,344,496,452,133,57,207,198
2338,10,1997,31,1,3,82,82,3095,648,1366,0.474,156,424,0.368,492,942,0.522,0.531,204,291,0.701,160,371,531,467,154,45,214,213
2338,11,1998,32,1,3,44,44,1652,315,704,0.447,61,192,0.318,254,512,0.496,0.491,150,193,0.777,53,174,227,254,79,43,109,116
2338,12,1999,33,1,3,50,50,2011,261,604,0.432,72,212,0.34,189,392,0.482,0.492,132,183,0.721,63,260,323,293,98,37,159,118
2338,13,2000,34,1,3,82,82,2749,388,860,0.451,86,263,0.327,302,597,0.506,0.501,160,223,0.717,114,399,513,406,117,41,208,208
2338,14,2001,35,1,3,64,60,2133,269,596,0.451,64,186,0.344,205,410,0.5,0.505,119,161,0.739,70,263,333,294,94,35,154,158
2338,15,2002,36,1,3,62,60,1996,246,599,0.411,54,177,0.305,192,422,0.455,0.456,113,146,0.774,77,244,321,363,101,35,171,162
2338,16,2003,37,1,3,64,58,1911,265,597,0.444,38,133,0.286,227,464,0.489,0.476,121,148,0.818,57,221,278,285,105,25,164,149
2338,17,2004,38,1,3,23,6,412,53,140,0.379,13,48,0.271,40,92,0.435,0.425,17,27,0.63,20,48,68,50,21,9,29,38
2349,1,2011,22,1,3,66,6,734,73,180,0.406,18,50,0.36,55,130,0.423,0.456,24,34,0.706,23,65,88,28,17,10,16,63
2349,2,2012,23,1,3,64,8,1002,108,239,0.452,22,73,0.301,86,166,0.518,0.498,33,53,0.623,55,71,126,27,27,5,30,90
2349,3,2013,24,1,3,59,1,1243,128,299,0.428,60,152,0.395,68,147,0.463,0.528,59,75,0.787,43,89,132,61,35,6,42,95
2350,1,1985,22,1,3,22,0,129,17,53,0.321,0,1,0,17,52,0.327,0.321,7,13,0.538,9,9,18,5,3,3,7,30
2352,1,2001,22,1,3,51,35,1147,173,445,0.389,0,5,0,173,440,0.393,0.389,94,141,0.667,89,100,189,61,45,6,59,111
2354,1,2014,20,1,3,37,0,319,33,91,0.363,4,21,0.19,29,70,0.414,0.385,8,12,0.667,21,36,57,10,8,1,14,26
2354,2,2015,21,1,3,9,0,218,30,55,0.545,4,9,0.444,26,46,0.565,0.582,13,17,0.765,7,22,29,11,9,3,6,14
2360,4,2010,26,1,3,20,2,236,21,49,0.429,0,0,-1,21,49,0.429,0.429,37,63,0.587,19,42,61,0,6,2,11,36
2362,1,2000,23,1,3,81,77,2052,230,536,0.429,82,220,0.373,148,316,0.468,0.506,120,150,0.8,85,232,317,146,98,33,95,207
2362,2,2001,24,1,3,82,82,2255,243,590,0.412,65,217,0.3,178,373,0.477,0.467,115,141,0.816,125,306,431,163,93,40,102,226
2362,3,2002,25,1,3,73,63,2238,277,736,0.376,67,237,0.283,210,499,0.421,0.422,161,203,0.793,109,320,429,180,114,39,127,224
2362,4,2003,26,1,3,25,24,872,121,324,0.373,24,88,0.273,97,236,0.411,0.41,86,102,0.843,38,107,145,78,29,6,66,63
2362,4,2003,26,1,3,58,47,1646,188,428,0.439,46,141,0.326,142,287,0.495,0.493,119,144,0.826,52,229,281,106,77,9,78,134
2362,4,2003,26,1,3,83,71,2518,309,752,0.411,70,229,0.306,239,523,0.457,0.457,205,246,0.833,90,336,426,184,106,15,144,197
2362,6,2005,28,1,3,50,18,1382,127,356,0.357,55,178,0.309,72,178,0.404,0.434,96,111,0.865,45,174,219,88,48,23,69,134
2362,7,2006,29,1,3,67,63,1914,159,395,0.403,117,290,0.403,42,105,0.4,0.551,48,61,0.787,33,286,319,89,54,20,58,196
2362,8,2007,30,1,3,71,19,1919,186,432,0.431,97,259,0.375,89,173,0.514,0.543,81,98,0.827,66,291,357,94,71,23,55,193
2362,11,2010,33,1,3,77,2,1731,126,345,0.365,81,242,0.335,45,103,0.437,0.483,66,80,0.825,32,297,329,117,42,19,51,204
2362,12,2011,34,1,3,49,0,839,81,241,0.336,67,212,0.316,14,29,0.483,0.475,11,15,0.733,10,137,147,34,24,6,24,103
2365,1,2008,26,1,3,11,4,304,35,95,0.368,8,33,0.242,27,62,0.435,0.411,6,9,0.667,8,36,44,18,9,2,5,18
2368,3,1985,26,1,3,80,80,2876,480,928,0.517,7,20,0.35,473,908,0.521,0.521,317,418,0.758,149,280,429,543,129,56,247,258
2368,4,1986,27,1,3,80,80,2704,411,843,0.488,8,44,0.182,403,799,0.504,0.492,316,392,0.806,127,272,399,623,168,71,240,247
2368,5,1987,28,1,3,61,60,2057,294,616,0.477,16,55,0.291,278,561,0.496,0.49,242,328,0.738,98,198,296,441,110,47,186,213
2371,1,1987,23,1,3,67,23,913,134,317,0.423,7,28,0.25,127,289,0.439,0.434,35,48,0.729,68,108,176,120,40,21,63,96
2371,2,1988,24,1,3,80,49,2029,318,702,0.453,36,110,0.327,282,592,0.476,0.479,103,130,0.792,139,230,369,185,84,55,135,211
2371,4,1990,26,1,3,72,10,1603,240,566,0.424,46,148,0.311,194,418,0.464,0.465,110,141,0.78,94,215,309,149,58,36,88,148
2386,1,2003,22,1,3,42,5,435,53,118,0.449,20,47,0.426,33,71,0.465,0.534,11,17,0.647,5,40,45,24,10,14,21,25
2386,2,2004,23,1,3,82,80,2701,338,723,0.467,57,157,0.363,281,566,0.496,0.507,108,141,0.766,93,297,390,191,63,69,119,149
2386,3,2005,24,1,3,82,82,3039,469,963,0.487,47,138,0.341,422,825,0.512,0.511,221,274,0.807,133,302,435,247,56,71,135,161
2386,4,2006,25,1,3,82,82,2898,455,999,0.455,64,183,0.35,391,816,0.479,0.487,182,238,0.765,104,242,346,186,62,39,91,96
2386,5,2007,26,1,3,82,82,3001,459,997,0.46,81,210,0.386,378,787,0.48,0.501,172,224,0.768,144,285,429,227,51,55,98,116
2386,6,2008,27,1,3,82,82,2694,421,940,0.448,53,146,0.363,368,794,0.463,0.476,185,241,0.768,109,289,398,268,42,33,91,90
2386,7,2009,28,1,3,82,82,3057,459,1020,0.45,56,141,0.397,403,879,0.458,0.477,189,243,0.778,128,348,476,253,44,51,101,104
2386,8,2010,29,1,3,49,49,1664,282,580,0.486,27,73,0.37,255,507,0.503,0.509,70,98,0.714,71,177,248,161,34,22,60,77
2386,9,2011,30,1,3,78,78,2562,473,1001,0.473,34,98,0.347,439,903,0.486,0.49,118,168,0.702,78,251,329,215,30,41,82,90
2386,10,2012,31,1,3,63,63,2087,336,798,0.421,37,104,0.356,299,694,0.431,0.444,89,115,0.774,72,209,281,153,27,32,74,77
2386,11,2013,32,1,3,37,36,1174,144,336,0.429,15,41,0.366,129,295,0.437,0.451,22,37,0.595,29,126,155,85,27,12,35,41
2386,11,2013,32,1,3,45,45,1457,215,484,0.444,23,53,0.434,192,431,0.445,0.468,74,93,0.796,43,166,209,111,21,13,54,45
2386,11,2013,32,1,3,82,81,2631,359,820,0.438,38,94,0.404,321,726,0.442,0.461,96,130,0.738,72,292,364,196,48,25,89,86
2386,12,2014,33,1,3,76,76,1948,200,492,0.407,20,69,0.29,180,423,0.426,0.427,34,60,0.567,32,202,234,119,39,19,41,63
2386,13,2015,34,1,3,6,4,122,14,38,0.368,3,8,0.375,11,30,0.367,0.408,4,6,0.667,2,11,13,4,3,0,1,5
2397,1,2006,24,1,3,36,0,315,29,85,0.341,12,36,0.333,17,49,0.347,0.412,26,33,0.788,16,24,40,25,11,2,31,30
2397,2,2007,25,1,3,10,2,122,18,35,0.514,4,13,0.308,14,22,0.636,0.571,5,9,0.556,2,7,9,9,5,1,6,12
2397,2,2007,25,1,3,13,2,138,19,43,0.442,5,17,0.294,14,26,0.538,0.5,5,9,0.556,2,8,10,13,5,1,7,15
2397,3,2008,26,1,3,14,1,228,26,80,0.325,11,30,0.367,15,50,0.3,0.394,16,23,0.696,7,26,33,17,8,0,9,22
2400,1,1993,22,1,3,28,28,938,184,466,0.395,21,73,0.288,163,393,0.415,0.417,68,92,0.739,42,80,122,131,40,11,115,80
2400,5,1997,26,1,3,31,31,1155,184,441,0.417,40,108,0.37,144,333,0.432,0.463,104,122,0.852,51,133,184,160,29,17,101,81
2400,8,2000,29,1,3,79,76,2767,507,1235,0.411,117,303,0.386,390,932,0.418,0.458,186,212,0.877,101,293,394,230,57,10,185,167
2400,9,2001,30,1,3,17,14,550,77,217,0.355,16,38,0.421,61,179,0.341,0.392,73,85,0.859,17,62,79,50,19,4,48,42
2400,9,2001,30,1,3,39,26,1140,162,415,0.39,10,42,0.238,152,373,0.408,0.402,66,84,0.786,36,109,145,113,34,6,82,97
2400,9,2001,30,1,3,56,40,1690,239,632,0.378,26,80,0.325,213,552,0.386,0.399,139,169,0.822,53,171,224,163,53,10,130,139
2400,10,2002,31,1,3,55,19,1825,238,538,0.442,38,81,0.469,200,457,0.438,0.478,75,87,0.862,54,236,290,140,42,14,106,145
2400,11,2003,32,1,3,63,0,1309,204,462,0.442,32,71,0.451,172,391,0.44,0.476,47,55,0.855,84,178,262,118,31,4,80,132
2400,12,2004,33,1,3,80,80,3119,382,900,0.424,162,405,0.4,220,495,0.444,0.514,107,127,0.843,52,435,487,226,86,23,175,227
2400,13,2005,34,1,3,24,24,990,118,283,0.417,54,147,0.367,64,136,0.471,0.512,30,33,0.909,10,105,115,86,23,1,56,67
2400,13,2005,34,1,3,40,3,997,130,299,0.435,68,148,0.459,62,151,0.411,0.548,24,25,0.96,23,131,154,97,12,4,59,86
2400,13,2005,34,1,3,64,27,1987,248,582,0.426,122,295,0.414,126,287,0.439,0.531,54,58,0.931,33,236,269,183,35,5,115,153
2400,14,2006,35,1,3,27,1,420,38,129,0.295,14,63,0.222,24,66,0.364,0.349,9,13,0.692,11,53,64,31,10,6,30,46
2400,14,2006,35,1,3,40,1,512,47,160,0.294,18,74,0.243,29,86,0.337,0.35,9,13,0.692,11,65,76,35,12,6,35,51
2413,1,2001,22,1,3,77,40,1660,243,572,0.425,52,155,0.335,191,417,0.458,0.47,97,135,0.719,41,167,208,140,86,14,130,166
2413,2,2002,23,1,3,23,1,227,34,91,0.374,9,36,0.25,25,55,0.455,0.423,12,17,0.706,3,23,26,11,15,3,23,29
2413,4,2004,25,1,3,80,78,2940,536,1261,0.425,145,427,0.34,391,834,0.469,0.483,233,297,0.785,97,273,370,244,142,20,223,216
2413,5,2005,26,1,3,51,49,1806,330,819,0.403,103,286,0.36,227,533,0.426,0.466,190,229,0.83,44,206,250,119,64,14,123,154
2413,7,2007,28,1,3,38,37,1293,229,514,0.446,59,173,0.341,170,341,0.499,0.503,123,153,0.804,44,83,127,173,51,14,102,113
2413,7,2007,28,1,3,75,69,2479,409,944,0.433,100,311,0.322,309,633,0.488,0.486,243,299,0.813,61,161,222,287,84,34,183,200
2413,8,2008,29,1,3,73,73,2855,488,1204,0.405,182,501,0.363,306,703,0.435,0.481,308,370,0.832,67,251,318,300,92,29,197,171
2413,9,2009,30,1,3,59,59,2339,413,997,0.414,103,305,0.338,310,692,0.448,0.466,294,356,0.826,70,233,303,381,88,31,229,153
2413,12,2012,33,1,3,21,1,500,62,153,0.405,19,62,0.306,43,91,0.473,0.467,44,54,0.815,6,75,81,41,28,7,37,38
2413,12,2012,33,1,3,26,13,712,97,272,0.357,30,108,0.278,67,164,0.409,0.412,50,60,0.833,16,66,82,77,26,6,66,61
2413,12,2012,33,1,3,47,14,1212,159,425,0.374,49,170,0.288,110,255,0.431,0.432,94,114,0.825,22,141,163,118,54,13,103,99
2413,13,2013,34,1,3,55,6,1075,123,330,0.373,46,170,0.271,77,160,0.481,0.442,49,70,0.7,22,133,155,80,37,14,77,89
2413,14,2014,35,1,3,9,0,107,6,26,0.231,1,14,0.071,5,12,0.417,0.25,2,4,0.5,2,8,10,5,6,1,6,11
2418,1,2011,23,1,3,25,9,403,46,103,0.447,0,3,0,46,100,0.46,0.447,18,28,0.643,17,68,85,20,16,12,25,36
2418,2,2012,24,1,3,7,7,170,13,35,0.371,0,1,0,13,34,0.382,0.371,8,12,0.667,7,26,33,3,7,7,12,17
2421,2,2005,20,1,3,80,80,3388,795,1684,0.472,108,308,0.351,687,1376,0.499,0.504,477,636,0.75,111,477,588,577,177,52,262,146
2421,3,2006,21,1,3,79,79,3361,875,1823,0.48,127,379,0.335,748,1444,0.518,0.515,601,814,0.738,75,481,556,521,123,66,260,181
2421,4,2007,22,1,3,78,78,3190,772,1621,0.476,99,310,0.319,673,1311,0.513,0.507,489,701,0.698,83,443,526,470,125,55,250,171
2421,5,2008,23,1,3,75,74,3027,794,1642,0.484,113,359,0.315,681,1283,0.531,0.518,549,771,0.712,133,459,592,539,138,81,255,165
2421,6,2009,24,1,3,81,81,3054,789,1613,0.489,132,384,0.344,657,1229,0.535,0.53,594,762,0.78,106,507,613,587,137,93,241,139
2421,7,2010,25,1,3,76,76,2966,768,1528,0.503,129,387,0.333,639,1141,0.56,0.545,593,773,0.767,71,483,554,651,125,77,261,119
2421,8,2011,26,1,3,79,79,3063,758,1485,0.51,92,279,0.33,666,1206,0.552,0.541,503,663,0.759,80,510,590,554,124,50,284,163
2421,9,2012,27,1,3,62,62,2326,621,1169,0.531,54,149,0.362,567,1020,0.556,0.554,387,502,0.771,94,398,492,387,115,50,213,96
2421,12,2015,30,1,3,8,8,312,77,157,0.49,16,38,0.421,61,119,0.513,0.541,52,65,0.8,6,45,51,54,10,5,31,15
2422,1,2001,24,1,3,30,0,197,16,52,0.308,1,3,0.333,15,49,0.306,0.317,12,14,0.857,15,20,35,8,2,5,8,27
2423,1,1999,22,1,3,47,24,1058,178,394,0.452,3,10,0.3,175,384,0.456,0.456,90,153,0.588,131,170,301,34,38,16,68,102
2423,2,2000,23,1,3,43,41,1556,356,756,0.471,2,7,0.286,354,749,0.473,0.472,127,208,0.611,172,187,359,90,30,15,113,115
2423,3,2001,24,1,3,82,82,3394,800,1812,0.442,62,205,0.302,738,1607,0.459,0.459,382,534,0.715,280,435,715,164,114,28,199,225
2423,4,2002,25,1,3,82,82,3033,614,1375,0.447,68,210,0.324,546,1165,0.469,0.471,323,440,0.734,211,345,556,161,70,45,161,187
2423,5,2003,26,1,3,82,82,3226,691,1471,0.47,65,209,0.311,626,1262,0.496,0.492,375,475,0.789,195,383,578,156,76,45,177,197
2423,6,2004,27,1,3,82,2,2376,488,913,0.535,16,40,0.4,472,873,0.541,0.543,220,294,0.748,233,287,520,70,83,30,81,174
2423,8,2006,29,1,3,82,80,3288,660,1494,0.442,147,373,0.394,513,1121,0.458,0.491,217,297,0.731,167,598,765,158,90,12,137,189
2426,1,2003,24,1,3,66,12,1379,179,446,0.401,53,166,0.319,126,280,0.45,0.461,79,105,0.752,35,125,160,193,97,11,103,125
2431,1,1980,25,1,3,77,-1,1286,288,565,0.51,0,6,0,288,559,0.515,0.51,161,204,0.789,114,156,270,95,40,40,117,155
2431,2,1981,26,1,3,66,-1,1108,187,440,0.425,0,1,0,187,439,0.426,0.425,179,220,0.814,83,147,230,65,44,31,87,123
2432,1,2003,22,1,3,51,10,666,75,194,0.387,18,54,0.333,57,140,0.407,0.433,29,43,0.674,16,43,59,22,19,16,45,56
2432,2,2004,23,1,3,19,2,187,24,66,0.364,16,39,0.41,8,27,0.296,0.485,12,19,0.632,5,23,28,6,4,7,18,36
2432,2,2004,23,1,3,21,2,195,27,72,0.375,17,42,0.405,10,30,0.333,0.493,13,20,0.65,5,24,29,7,4,7,19,36
2433,1,2003,21,1,3,20,1,292,30,63,0.476,3,6,0.5,27,57,0.474,0.5,16,29,0.552,26,32,58,16,8,5,21,28
2433,3,2005,23,1,3,77,71,2007,203,434,0.468,16,51,0.314,187,383,0.488,0.486,101,173,0.584,152,222,374,151,66,35,114,206
2433,5,2007,25,1,3,55,43,1307,95,206,0.461,2,20,0.1,93,186,0.5,0.466,31,68,0.456,111,127,238,67,44,30,61,150
2433,6,2008,26,1,3,73,19,1325,108,270,0.4,4,25,0.16,104,245,0.424,0.407,49,93,0.527,118,125,243,66,36,23,64,132
2433,7,2009,27,1,3,56,36,1310,120,273,0.44,1,12,0.083,119,261,0.456,0.441,55,90,0.611,128,103,231,80,47,33,65,153
2433,8,2010,28,1,3,18,0,332,36,84,0.429,1,9,0.111,35,75,0.467,0.435,15,27,0.556,31,34,65,18,9,13,14,46
2439,1,2002,21,1,3,79,9,1917,270,591,0.457,13,56,0.232,257,535,0.48,0.468,189,265,0.713,85,208,293,140,64,48,107,211
2439,2,2003,22,1,3,80,80,2879,456,911,0.501,6,24,0.25,450,887,0.507,0.504,324,436,0.743,150,364,514,201,80,44,156,216
2439,3,2004,23,1,3,82,82,3133,555,1115,0.498,48,132,0.364,507,983,0.516,0.519,357,468,0.763,109,355,464,315,92,28,198,224
2439,4,2005,24,1,3,33,33,1355,238,564,0.422,30,89,0.337,208,475,0.438,0.449,227,269,0.844,49,191,240,133,33,17,132,109
2439,5,2006,25,1,3,78,78,3059,495,1005,0.493,60,188,0.319,435,817,0.532,0.522,471,580,0.812,95,439,534,297,59,17,174,193
2439,6,2007,26,1,3,55,53,1956,303,665,0.456,52,145,0.359,251,520,0.483,0.495,239,326,0.733,48,192,240,148,34,8,120,123
2439,7,2008,27,1,3,82,82,3200,619,1328,0.466,77,213,0.362,542,1115,0.486,0.495,542,679,0.798,93,249,342,252,76,21,199,225
2439,8,2009,28,1,3,82,82,2939,537,1222,0.439,116,292,0.397,421,930,0.453,0.487,417,518,0.805,57,317,374,199,66,14,165,252
2439,9,2010,29,1,3,81,70,2520,362,775,0.467,59,187,0.316,303,588,0.515,0.505,211,287,0.735,58,298,356,158,45,40,105,178
2439,10,2011,30,1,3,81,81,2459,304,642,0.474,135,307,0.44,169,335,0.504,0.579,148,195,0.759,54,256,310,107,38,34,93,164
2439,11,2012,31,1,3,22,3,580,71,169,0.42,33,79,0.418,38,90,0.422,0.518,24,35,0.686,8,68,76,33,12,7,18,38
2439,11,2012,31,1,3,41,41,1168,132,319,0.414,80,190,0.421,52,129,0.403,0.539,35,50,0.7,18,125,143,55,25,12,32,83
2439,11,2012,31,1,3,63,44,1748,203,488,0.416,113,269,0.42,90,219,0.411,0.532,59,85,0.694,26,193,219,88,37,19,50,121
2439,12,2013,32,1,3,56,1,568,62,136,0.456,14,45,0.311,48,91,0.527,0.507,38,53,0.717,5,79,84,31,14,7,23,45
2439,13,2014,33,1,3,82,78,2213,294,654,0.45,123,301,0.409,171,353,0.484,0.544,120,162,0.741,18,201,219,130,56,14,94,168
2439,14,2015,34,1,3,9,0,103,11,32,0.344,2,11,0.182,9,21,0.429,0.375,7,10,0.7,6,17,23,5,5,2,8,11
2452,1,1987,23,1,3,60,3,520,94,201,0.468,0,1,0,94,200,0.47,0.468,40,58,0.69,38,50,88,40,17,15,37,81
2452,2,1988,24,1,3,70,2,879,155,298,0.52,1,8,0.125,154,290,0.531,0.522,67,91,0.736,77,91,168,49,30,26,54,127
2452,3,1989,25,1,3,67,51,1850,270,515,0.524,1,9,0.111,269,506,0.532,0.525,101,134,0.754,114,172,286,126,64,35,110,213
2452,4,1990,26,1,3,82,82,2832,504,1019,0.495,2,17,0.118,502,1002,0.501,0.496,205,270,0.759,113,268,381,252,104,62,167,321
2452,5,1991,27,1,3,73,70,2279,416,873,0.477,2,15,0.133,414,858,0.483,0.478,157,216,0.727,108,222,330,142,81,47,122,240
2452,6,1992,28,1,3,80,69,2202,290,633,0.458,1,9,0.111,289,624,0.463,0.459,104,143,0.727,95,217,312,158,72,49,104,234
2452,7,1993,29,1,3,73,19,1287,193,403,0.479,0,3,0,193,400,0.483,0.479,92,126,0.73,78,117,195,89,36,18,70,187
2459,1,2013,22,1,3,8,0,102,11,25,0.44,6,18,0.333,5,7,0.714,0.56,1,2,0.5,5,6,11,2,4,0,3,5
2459,2,2014,23,1,3,40,0,789,85,214,0.397,43,127,0.339,42,87,0.483,0.498,37,43,0.86,31,66,97,31,27,4,22,63
2459,3,2015,24,1,3,9,2,187,19,60,0.317,10,39,0.256,9,21,0.429,0.4,6,8,0.75,3,23,26,3,9,5,9,19
2471,4,1983,26,1,3,82,64,2297,409,858,0.477,7,38,0.184,402,820,0.49,0.481,126,172,0.733,176,369,545,220,77,53,242,279
2471,5,1984,27,1,3,81,20,2073,411,884,0.465,11,47,0.234,400,837,0.478,0.471,223,270,0.826,139,321,460,195,82,49,186,256
2471,6,1985,28,1,3,55,3,756,107,263,0.407,1,10,0.1,106,253,0.419,0.409,49,56,0.875,48,116,164,38,31,16,49,99
2479,1,1980,32,1,3,81,-1,2533,377,772,0.488,0,0,-1,377,772,0.488,0.488,161,201,0.801,163,263,426,424,76,35,247,213
2479,2,1981,33,1,3,80,-1,2324,373,866,0.431,0,1,0,373,865,0.431,0.431,173,214,0.808,135,227,362,312,57,25,230,202
2479,3,1982,34,1,3,14,1,187,22,45,0.489,0,0,-1,22,45,0.489,0.489,15,20,0.75,3,15,18,29,4,3,17,20
2480,2,2011,23,1,3,13,0,123,17,41,0.415,2,9,0.222,15,32,0.469,0.439,6,13,0.462,6,18,24,14,8,9,18,25
2480,2,2011,23,1,3,25,25,699,91,196,0.464,6,25,0.24,85,171,0.497,0.48,41,58,0.707,31,87,118,75,25,28,46,70
2480,2,2011,23,1,3,38,25,822,108,237,0.456,8,34,0.235,100,203,0.493,0.473,47,71,0.662,37,105,142,89,33,37,64,95
2480,3,2012,24,1,3,62,40,1561,233,518,0.45,19,60,0.317,214,458,0.467,0.468,81,115,0.704,74,218,292,122,71,84,101,177
2480,4,2013,25,1,3,54,11,878,117,283,0.413,2,21,0.095,115,262,0.439,0.417,40,67,0.597,49,96,145,58,41,50,68,99
2480,5,2014,26,1,3,52,4,956,143,308,0.464,22,87,0.253,121,221,0.548,0.5,76,90,0.844,60,106,166,111,42,57,66,102
2481,4,2005,23,1,3,82,82,3240,544,1179,0.461,177,370,0.478,367,809,0.454,0.536,135,180,0.75,120,302,422,291,79,24,148,167
2483,6,1997,27,1,3,76,76,2613,376,735,0.512,34,105,0.324,342,630,0.543,0.535,190,274,0.693,165,228,393,174,64,36,136,249
2483,7,1998,28,1,3,70,70,2412,429,884,0.485,15,63,0.238,414,821,0.504,0.494,214,283,0.756,175,226,401,150,40,13,127,193
2485,1,2004,23,1,3,41,20,734,72,203,0.355,7,33,0.212,65,170,0.382,0.372,22,37,0.595,59,124,183,27,37,32,37,90
2485,2,2006,25,1,3,27,7,489,56,139,0.403,13,36,0.361,43,103,0.417,0.45,17,23,0.739,40,75,115,12,10,12,24,54
2485,2,2006,25,1,3,36,7,524,61,149,0.409,13,36,0.361,48,113,0.425,0.453,18,27,0.667,40,82,122,14,12,12,28,61
2488,1,1980,30,1,3,79,-1,1535,262,527,0.497,1,11,0.091,261,516,0.506,0.498,82,93,0.882,50,113,163,161,59,24,96,165
2488,2,1981,31,1,3,40,-1,372,87,158,0.551,1,6,0.167,86,152,0.566,0.554,27,31,0.871,8,47,55,30,20,2,25,45
2488,3,1982,32,1,3,26,0,150,27,54,0.5,1,3,0.333,26,51,0.51,0.509,6,7,0.857,7,15,22,10,13,3,13,28
2491,3,1983,25,1,3,29,8,549,69,154,0.448,0,0,-1,69,154,0.448,0.448,22,30,0.733,32,58,90,23,8,17,35,82
2491,3,1983,25,1,3,50,0,992,178,355,0.501,1,4,0.25,177,351,0.504,0.503,73,100,0.73,75,126,201,48,18,26,69,150
2491,3,1983,25,1,3,79,8,1541,247,509,0.485,1,4,0.25,246,505,0.487,0.486,95,130,0.731,107,184,291,71,26,43,104,232
2498,2,2012,24,1,3,65,64,1469,158,397,0.398,53,169,0.314,105,228,0.461,0.465,24,34,0.706,24,153,177,59,35,48,60,115
2498,3,2013,25,1,3,50,21,953,161,396,0.407,50,155,0.323,111,241,0.461,0.47,27,35,0.771,21,102,123,34,22,18,48,56
2498,4,2014,26,1,3,79,62,2240,277,651,0.425,100,271,0.369,177,380,0.466,0.502,61,77,0.792,70,278,348,124,86,77,90,207
2498,5,2015,27,1,3,9,9,289,28,64,0.438,9,25,0.36,19,39,0.487,0.508,11,11,1,5,24,29,9,5,5,5,24
2508,3,2006,25,1,3,71,4,967,109,263,0.414,3,21,0.143,106,242,0.438,0.42,60,93,0.645,20,84,104,39,38,15,50,108
2508,7,2010,29,1,3,76,26,1892,287,623,0.461,4,32,0.125,283,591,0.479,0.464,198,257,0.77,48,181,229,150,40,39,129,237
2508,9,2012,31,1,3,65,3,1052,115,281,0.409,33,77,0.429,82,204,0.402,0.468,83,99,0.838,23,94,117,63,23,11,46,119
2508,10,2013,32,1,3,50,15,635,50,140,0.357,8,37,0.216,42,103,0.408,0.386,66,82,0.805,13,57,70,28,10,5,22,73
2508,10,2013,32,1,3,78,19,1016,82,222,0.369,11,49,0.224,71,173,0.41,0.394,87,113,0.77,24,77,101,48,22,6,38,119
2510,1,2007,23,1,3,44,5,336,43,93,0.462,1,9,0.111,42,84,0.5,0.468,23,41,0.561,22,35,57,16,11,1,18,59
2510,2,2008,24,1,3,9,2,137,14,36,0.389,3,13,0.231,11,23,0.478,0.431,9,10,0.9,10,17,27,11,5,2,5,17
2510,2,2008,24,1,3,6,0,143,17,32,0.531,6,15,0.4,11,17,0.647,0.625,8,13,0.615,8,16,24,5,2,0,7,18
2515,1,2013,22,1,3,63,17,803,95,218,0.436,9,35,0.257,86,183,0.47,0.456,34,51,0.667,17,88,105,16,19,22,30,55
2522,5,1999,27,1,3,30,30,1157,164,368,0.446,28,78,0.359,136,290,0.469,0.484,153,191,0.801,30,88,118,125,90,34,72,86
2522,5,1999,27,1,3,50,50,1881,260,595,0.437,48,142,0.338,212,453,0.468,0.477,212,271,0.782,50,144,194,186,125,58,93,128
2522,11,2005,33,1,3,80,80,2839,351,820,0.428,142,382,0.372,209,438,0.477,0.515,174,216,0.806,38,367,405,212,86,38,99,251
2523,7,2009,29,1,3,52,21,1495,129,317,0.407,54,147,0.367,75,170,0.441,0.492,66,81,0.815,23,103,126,188,53,11,66,112
2528,1,2005,24,1,3,75,24,1330,126,318,0.396,66,166,0.398,60,152,0.395,0.5,53,62,0.855,39,135,174,57,31,28,43,123
2528,2,2006,25,1,3,75,24,1772,243,581,0.418,110,285,0.386,133,296,0.449,0.513,103,121,0.851,44,209,253,57,38,49,35,142
2528,3,2007,26,1,3,76,7,1376,162,440,0.368,90,238,0.378,72,202,0.356,0.47,71,81,0.877,33,143,176,45,28,42,28,115
2528,4,2008,27,1,3,58,3,1276,143,327,0.437,91,205,0.444,52,122,0.426,0.576,86,98,0.878,43,118,161,34,24,15,28,96
2528,5,2009,28,1,3,40,1,630,55,149,0.369,33,96,0.344,22,53,0.415,0.48,26,31,0.839,12,50,62,20,12,14,12,58
2528,6,2010,29,1,3,36,6,503,43,119,0.361,37,90,0.411,6,29,0.207,0.517,23,28,0.821,4,41,45,17,11,4,11,45
2528,7,2011,30,1,3,81,8,1549,146,346,0.422,123,287,0.429,23,59,0.39,0.6,60,72,0.833,23,137,160,43,29,19,21,129
2528,9,2013,32,1,3,38,0,221,21,61,0.344,16,53,0.302,5,8,0.625,0.475,2,4,0.5,0,22,22,13,2,6,3,16
2528,10,2014,33,1,3,20,6,236,31,68,0.456,28,54,0.519,3,14,0.214,0.662,7,11,0.636,2,21,23,9,3,4,4,6
2533,1,2000,20,1,3,33,0,138,22,58,0.379,2,4,0.5,20,54,0.37,0.397,11,18,0.611,16,22,38,5,6,5,14,10
2533,2,2001,21,1,3,65,0,866,122,275,0.444,20,60,0.333,102,215,0.474,0.48,40,53,0.755,63,126,189,32,30,15,39,68
2533,4,2003,23,1,3,80,12,2204,308,710,0.434,111,314,0.354,197,396,0.497,0.512,57,83,0.687,106,299,405,112,67,22,107,176
2533,6,2005,25,1,3,76,23,1830,210,486,0.432,102,261,0.391,108,225,0.48,0.537,55,75,0.733,107,291,398,65,44,24,49,165
2533,8,2007,27,1,3,18,0,138,14,51,0.275,10,32,0.313,4,19,0.211,0.373,2,2,1,6,17,23,1,5,1,7,19
2534,1,2005,29,1,3,10,0,116,9,31,0.29,0,4,0,9,27,0.333,0.29,5,10,0.5,6,7,13,6,5,2,3,16
2536,1,2013,21,1,3,38,1,280,39,99,0.394,0,2,0,39,97,0.402,0.394,10,15,0.667,12,50,62,10,5,6,15,23
2536,3,2015,23,1,3,5,5,164,27,59,0.458,7,21,0.333,20,38,0.526,0.517,14,19,0.737,2,17,19,6,2,1,11,13
2541,1,1989,22,1,3,42,34,577,81,179,0.453,0,1,0,81,178,0.455,0.453,50,67,0.746,24,71,95,33,16,13,39,50
2541,1,1989,22,1,3,51,34,682,93,209,0.445,0,1,0,93,208,0.447,0.445,58,80,0.725,32,81,113,42,21,15,47,58
2552,1,1981,24,1,3,30,-1,207,29,75,0.387,0,0,-1,29,75,0.387,0.387,10,17,0.588,23,19,42,11,11,5,17,35
2566,1,1980,23,1,3,65,0,674,139,276,0.504,11,27,0.407,128,249,0.514,0.524,62,76,0.816,32,34,66,47,29,5,49,91
2566,2,1981,24,1,3,62,-1,666,92,216,0.426,9,28,0.321,83,188,0.441,0.447,45,51,0.882,29,64,93,59,16,2,30,84
2566,3,1982,25,1,3,30,0,251,31,81,0.383,1,10,0.1,30,71,0.423,0.389,16,26,0.615,14,20,34,14,6,5,9,33
2566,4,1983,26,1,3,34,0,309,39,88,0.443,2,8,0.25,37,80,0.463,0.455,25,30,0.833,18,25,43,17,15,2,17,39
2576,1,2013,23,1,3,77,29,1507,172,399,0.431,53,154,0.344,119,245,0.486,0.497,75,103,0.728,51,99,150,63,47,15,48,136
2576,2,2014,24,1,3,26,8,629,82,218,0.376,18,67,0.269,64,151,0.424,0.417,26,47,0.553,15,45,60,22,13,5,25,62
2578,1,1998,23,1,3,12,0,108,13,37,0.351,1,2,0.5,12,35,0.343,0.365,11,16,0.688,4,9,13,1,3,2,8,22
2578,2,1999,24,1,3,36,9,724,82,198,0.414,26,68,0.382,56,130,0.431,0.48,17,23,0.739,30,71,101,24,28,17,34,97
2587,2,2014,28,1,3,72,7,1396,221,529,0.418,136,349,0.39,85,180,0.472,0.546,44,62,0.71,60,206,266,57,29,23,54,143
2589,7,1989,28,1,3,66,41,1569,409,859,0.476,2,12,0.167,407,847,0.481,0.477,182,225,0.809,110,153,263,96,79,17,116,173
2589,8,1990,29,1,3,82,49,2376,538,1122,0.48,3,14,0.214,535,1108,0.483,0.481,244,294,0.83,114,253,367,155,91,15,144,231
2598,1,1985,23,1,3,51,1,461,94,195,0.482,0,2,0,94,193,0.487,0.482,43,67,0.642,29,40,69,17,11,17,34,85
2598,2,1986,24,1,3,42,8,531,100,233,0.429,2,5,0.4,98,228,0.43,0.433,29,48,0.604,28,47,75,28,23,15,39,82
2600,1,1983,22,1,3,49,2,521,74,170,0.435,1,7,0.143,73,163,0.448,0.438,45,78,0.577,28,44,72,36,19,4,48,93
2600,2,1984,23,1,3,46,0,291,31,72,0.431,0,1,0,31,71,0.437,0.431,15,31,0.484,9,22,31,27,10,3,19,44
2600,3,1985,24,1,3,10,1,115,12,23,0.522,0,1,0,12,22,0.545,0.522,5,11,0.455,4,4,8,1,3,2,12,16
2600,3,1985,24,1,3,18,3,183,20,38,0.526,0,1,0,20,37,0.541,0.526,11,19,0.579,10,7,17,4,5,3,14,22
2611,2,2013,24,1,3,59,9,646,53,106,0.5,0,0,-1,53,106,0.5,0.5,43,59,0.729,44,71,115,17,11,7,14,78
2611,3,2015,26,1,3,10,6,276,27,73,0.37,0,0,-1,27,73,0.37,0.37,13,20,0.65,15,32,47,15,5,0,13,12
2615,1,1998,20,1,3,77,48,1779,306,684,0.447,62,171,0.363,244,513,0.476,0.493,171,231,0.74,107,181,288,90,54,17,118,185
2615,2,1999,21,1,3,17,0,188,27,67,0.403,5,19,0.263,22,48,0.458,0.44,19,24,0.792,7,26,33,15,3,3,15,21
2615,2,1999,21,1,3,33,26,624,105,212,0.495,16,49,0.327,89,163,0.546,0.533,54,88,0.614,42,51,93,31,23,9,31,86
2615,2,1999,21,1,3,50,26,812,132,279,0.473,21,68,0.309,111,211,0.526,0.511,73,112,0.652,49,77,126,46,26,12,46,107
2615,3,2000,22,1,3,80,1,2093,347,753,0.461,63,182,0.346,284,571,0.497,0.503,188,243,0.774,100,232,332,113,59,31,129,227
2615,5,2002,24,1,3,74,22,1987,316,753,0.42,95,291,0.326,221,462,0.478,0.483,142,179,0.793,64,236,300,105,65,32,127,200
2615,6,2003,25,1,3,80,70,2358,412,930,0.443,97,265,0.366,315,665,0.474,0.495,145,186,0.78,97,292,389,102,70,49,133,257
2615,7,2004,26,1,3,24,23,746,137,303,0.452,26,64,0.406,111,239,0.464,0.495,78,96,0.813,26,89,115,34,24,5,43,69
2615,7,2004,26,1,3,42,42,1343,226,510,0.443,47,130,0.362,179,380,0.471,0.489,93,122,0.762,38,167,205,90,40,15,73,127
2615,7,2004,26,1,3,66,65,2089,363,813,0.446,73,194,0.376,290,619,0.468,0.491,171,218,0.784,64,256,320,124,64,20,116,196
2615,8,2005,27,1,3,71,68,1940,315,718,0.439,85,208,0.409,230,510,0.451,0.498,136,173,0.786,45,192,237,110,41,17,113,222
2615,13,2010,32,1,3,18,1,285,49,106,0.462,16,43,0.372,33,63,0.524,0.538,21,24,0.875,13,28,41,14,10,2,14,31
2620,1,1985,22,1,3,59,0,535,79,212,0.373,0,8,0,79,204,0.387,0.373,39,51,0.765,37,39,76,52,31,10,35,79
2620,3,1987,24,1,3,24,2,331,42,105,0.4,0,3,0,42,102,0.412,0.4,27,33,0.818,20,11,31,18,11,5,16,53
2620,4,1988,25,1,3,37,7,566,74,159,0.465,0,2,0,74,157,0.471,0.465,43,60,0.717,40,36,76,51,21,1,21,75
2621,1,1987,23,1,3,59,0,762,142,261,0.544,0,1,0,142,260,0.546,0.544,48,74,0.649,69,102,171,60,15,30,61,148
2621,2,1989,25,1,3,79,58,2273,349,716,0.487,0,4,0,349,712,0.49,0.487,156,224,0.696,241,331,572,176,56,105,189,260
2621,3,1990,26,1,3,79,45,2142,375,727,0.516,2,4,0.5,373,723,0.516,0.517,115,185,0.622,238,313,551,166,54,89,156,237
2621,4,1991,27,1,3,73,46,1481,205,411,0.499,0,4,0,205,407,0.504,0.499,89,124,0.718,120,192,312,111,32,48,117,161
2626,1,2014,22,1,3,77,41,1742,171,372,0.46,67,167,0.401,104,205,0.507,0.55,52,73,0.712,73,174,247,73,53,12,60,144
2632,1,1984,22,1,3,82,10,1731,309,662,0.467,9,39,0.231,300,623,0.482,0.474,115,149,0.772,120,192,312,122,70,37,73,192
2632,2,1985,23,1,3,16,0,227,41,105,0.39,0,7,0,41,98,0.418,0.39,24,34,0.706,21,21,42,20,15,5,15,42
2632,2,1985,23,1,3,33,27,715,148,354,0.418,6,23,0.261,142,331,0.429,0.427,45,53,0.849,36,80,116,58,41,20,42,77
2632,2,1985,23,1,3,49,27,942,189,459,0.412,6,30,0.2,183,429,0.427,0.418,69,87,0.793,57,101,158,78,56,25,57,119
2632,3,1986,24,1,3,23,8,432,70,194,0.361,2,12,0.167,68,182,0.374,0.366,37,43,0.86,27,36,63,24,15,17,30,49
2642,2,2009,25,1,3,71,67,2654,469,1051,0.446,20,79,0.253,449,972,0.462,0.456,236,313,0.754,122,246,368,103,59,62,130,227
2642,3,2010,26,1,3,24,16,674,100,216,0.463,6,17,0.353,94,199,0.472,0.477,50,72,0.694,31,71,102,29,20,13,36,62
2642,3,2010,26,1,3,51,30,1405,220,460,0.478,5,14,0.357,215,446,0.482,0.484,103,139,0.741,85,107,192,61,25,22,66,144
2642,3,2010,26,1,3,75,46,2079,320,676,0.473,11,31,0.355,309,645,0.479,0.482,153,211,0.725,116,178,294,90,45,35,102,206
2642,4,2011,27,1,3,49,23,1069,154,327,0.471,4,25,0.16,150,302,0.497,0.477,81,107,0.757,46,110,156,51,28,9,44,103
2642,4,2011,27,1,3,71,23,1383,205,431,0.476,4,26,0.154,201,405,0.496,0.48,110,142,0.775,56,157,213,62,35,12,64,143
2652,3,2011,25,1,3,65,4,1362,141,313,0.45,47,115,0.409,94,198,0.475,0.526,105,131,0.802,92,203,295,82,28,28,49,145
2652,4,2012,26,1,3,51,0,882,71,182,0.39,25,101,0.248,46,81,0.568,0.459,41,55,0.745,50,103,153,22,18,19,35,86
2652,5,2013,27,1,3,62,11,963,82,216,0.38,45,133,0.338,37,83,0.446,0.484,44,51,0.863,31,124,155,32,15,12,36,66
2653,1,1989,23,1,3,14,0,117,17,37,0.459,0,3,0,17,34,0.5,0.459,6,12,0.5,7,14,21,7,2,4,2,20
2653,6,1994,28,1,3,49,6,640,74,177,0.418,6,16,0.375,68,161,0.422,0.435,33,45,0.733,36,72,108,30,13,15,39,61
2663,1,1983,23,1,3,55,0,516,105,234,0.449,9,25,0.36,96,209,0.459,0.468,28,38,0.737,30,35,65,31,19,5,33,81
2670,5,2000,25,1,3,11,11,301,70,142,0.493,0,2,0,70,140,0.5,0.493,11,21,0.524,20,32,52,22,8,3,25,28
2670,8,2003,28,1,3,80,22,1222,208,389,0.535,0,2,0,208,387,0.537,0.535,60,101,0.594,106,185,291,77,32,23,59,142
2674,1,1982,22,1,3,82,82,3077,636,1281,0.496,5,22,0.227,631,1259,0.501,0.498,495,621,0.797,219,224,443,270,89,16,280,241
2674,2,1983,23,1,3,58,58,2252,565,1156,0.489,14,37,0.378,551,1119,0.492,0.495,392,464,0.845,126,138,264,237,67,20,187,157
2674,3,1984,24,1,3,76,75,2493,595,1296,0.459,2,17,0.118,593,1279,0.464,0.46,426,523,0.815,119,187,306,228,65,17,190,190
2674,4,1985,25,1,3,55,43,1675,396,831,0.477,2,5,0.4,394,826,0.477,0.478,255,288,0.885,66,152,218,135,49,14,118,118
2674,5,1986,26,1,3,81,81,2626,615,1236,0.498,12,25,0.48,603,1211,0.498,0.502,380,444,0.856,116,232,348,265,93,10,183,167
2674,6,1987,27,1,3,79,76,1865,291,621,0.469,19,52,0.365,272,569,0.478,0.484,197,226,0.872,54,188,242,243,85,11,167,147
2674,7,1988,28,1,3,49,21,976,139,303,0.459,31,74,0.419,108,229,0.472,0.51,59,68,0.868,30,87,117,105,34,4,68,68
2674,8,1989,29,1,3,71,65,2302,568,1215,0.467,30,84,0.357,538,1131,0.476,0.48,440,508,0.866,79,188,267,224,88,16,236,196
2674,9,1990,30,1,3,79,73,2404,442,1029,0.43,38,104,0.365,404,925,0.437,0.448,310,351,0.883,82,240,322,224,75,16,176,220
2674,10,1991,31,1,3,77,1,1289,187,412,0.454,15,45,0.333,172,367,0.469,0.472,152,167,0.91,46,130,176,159,33,13,92,130
2679,1,1995,25,1,3,62,13,982,96,210,0.457,0,1,0,96,209,0.459,0.457,51,83,0.614,44,126,170,68,46,11,56,129
2682,1,2003,19,1,3,81,16,1320,115,393,0.293,37,152,0.243,78,241,0.324,0.34,48,65,0.738,64,117,181,91,31,29,84,136
2689,1,1982,22,1,3,80,62,1996,282,639,0.441,0,4,0,282,635,0.444,0.441,97,138,0.703,143,158,301,189,75,2,116,182
2689,2,1983,23,1,3,59,16,879,96,238,0.403,2,3,0.667,94,235,0.4,0.408,20,30,0.667,68,84,152,88,47,0,59,75
2689,3,1984,24,1,3,47,1,536,54,150,0.36,1,9,0.111,53,141,0.376,0.363,28,34,0.824,42,51,93,59,26,0,29,40
2689,4,1985,25,1,3,81,2,1491,181,388,0.466,1,6,0.167,180,382,0.471,0.468,51,65,0.785,88,128,216,158,96,7,70,152
2689,6,1987,27,1,3,70,4,936,112,252,0.444,1,8,0.125,111,244,0.455,0.446,23,31,0.742,34,81,115,102,30,4,31,97
2689,7,1989,29,1,3,78,12,1746,151,353,0.428,2,7,0.286,149,346,0.431,0.431,33,56,0.589,109,178,287,144,90,8,60,209
2690,2,2012,23,1,3,65,20,1713,263,590,0.446,11,49,0.224,252,541,0.466,0.455,73,108,0.676,27,349,376,180,40,20,105,117
2690,3,2013,24,1,3,82,82,2892,441,1053,0.419,58,159,0.365,383,894,0.428,0.446,154,208,0.74,56,461,517,354,71,17,187,197
2690,4,2014,25,1,3,27,2,571,78,190,0.411,12,24,0.5,66,166,0.398,0.442,24,34,0.706,12,74,86,64,11,2,34,48
2690,4,2014,25,1,3,54,54,1886,356,831,0.428,38,132,0.288,318,699,0.455,0.451,189,228,0.829,50,272,322,198,56,5,155,147
2690,4,2014,25,1,3,81,56,2457,434,1021,0.425,50,156,0.321,384,865,0.444,0.45,213,262,0.813,62,346,408,262,67,7,189,195
2693,1,2001,21,1,3,74,7,1245,138,335,0.412,28,86,0.326,110,249,0.442,0.454,87,112,0.777,49,161,210,69,52,24,55,139
2693,2,2002,22,1,3,80,10,1970,290,687,0.422,63,171,0.368,227,516,0.44,0.468,167,230,0.726,63,300,363,163,57,31,81,184
2693,3,2003,23,1,3,67,11,1175,165,391,0.422,29,78,0.372,136,313,0.435,0.459,88,110,0.8,35,153,188,87,25,12,50,125
2693,4,2004,24,1,3,80,44,2073,262,645,0.406,101,241,0.419,161,404,0.399,0.484,114,161,0.708,52,306,358,154,80,32,94,165
2693,5,2005,25,1,3,67,11,1757,328,782,0.419,93,245,0.38,235,537,0.438,0.479,188,225,0.836,62,171,233,153,41,18,119,140
2693,6,2006,26,1,3,78,59,2615,398,877,0.454,114,283,0.403,284,594,0.478,0.519,255,296,0.861,70,263,333,216,70,21,130,234
2693,7,2007,27,1,3,73,73,2268,345,823,0.419,109,281,0.388,236,542,0.435,0.485,171,219,0.781,57,236,293,233,70,16,143,221
2693,8,2008,28,1,3,82,82,3026,556,1219,0.456,166,415,0.4,390,804,0.485,0.524,324,391,0.829,83,388,471,409,74,25,246,244
2693,9,2009,29,1,3,77,77,2815,423,1025,0.413,134,376,0.356,289,649,0.445,0.478,314,389,0.807,45,365,410,375,64,19,204,218
2693,10,2010,30,1,3,74,69,2272,276,674,0.409,108,289,0.374,168,385,0.436,0.49,175,226,0.774,42,301,343,304,55,32,125,220
2693,11,2011,31,1,3,56,56,1910,237,529,0.448,86,213,0.404,151,316,0.478,0.529,80,120,0.667,25,231,256,285,54,20,101,170
2693,11,2011,31,1,3,81,72,2540,322,722,0.446,127,310,0.41,195,412,0.473,0.534,106,156,0.679,45,311,356,343,72,34,132,247
2693,12,2012,32,1,3,53,53,1653,209,504,0.415,91,258,0.353,118,246,0.48,0.505,67,95,0.705,24,175,199,233,45,17,142,139
2693,13,2013,33,1,3,11,1,189,14,53,0.264,1,24,0.042,13,29,0.448,0.274,3,6,0.5,4,22,26,23,7,1,12,11
2693,14,2014,34,1,3,38,0,392,42,109,0.385,22,50,0.44,20,59,0.339,0.486,9,18,0.5,11,78,89,33,19,10,16,50
2698,1,1992,24,1,3,42,0,345,43,98,0.439,0,0,-1,43,98,0.439,0.439,31,59,0.525,38,40,78,12,6,4,32,40
2701,1,1980,23,1,3,82,-1,2670,430,925,0.465,2,12,0.167,428,913,0.469,0.466,143,187,0.765,228,399,627,129,107,220,175,237
2701,2,1981,24,1,3,82,-1,2549,476,895,0.532,0,8,0,476,887,0.537,0.532,148,250,0.592,198,369,567,136,112,180,163,215
2701,4,1983,26,1,3,82,56,2543,421,880,0.478,2,15,0.133,419,865,0.484,0.48,146,196,0.745,180,360,540,157,103,160,120,221
2701,5,1984,27,1,3,82,7,1602,313,691,0.453,2,13,0.154,311,678,0.459,0.454,94,132,0.712,104,181,285,76,63,59,78,151
2701,6,1985,28,1,3,82,53,2004,422,855,0.494,0,8,0,422,847,0.498,0.494,106,148,0.716,148,275,423,63,49,90,76,192
2701,7,1986,29,1,3,71,52,1651,295,649,0.455,0,3,0,295,646,0.457,0.455,84,112,0.75,109,204,313,94,64,108,94,159
2701,8,1987,30,1,3,82,48,1930,329,664,0.495,1,3,0.333,328,661,0.496,0.496,101,140,0.721,116,212,328,73,55,78,78,151
2701,9,1988,31,1,3,74,28,1185,184,407,0.452,1,7,0.143,183,400,0.458,0.453,41,64,0.641,87,155,242,56,43,47,43,85
2701,10,1989,32,1,3,70,11,1057,169,360,0.469,1,9,0.111,168,351,0.479,0.471,47,62,0.758,74,135,209,40,24,39,51,90
2718,1,2009,21,1,3,29,0,216,36,58,0.621,0,1,0,36,57,0.632,0.621,16,23,0.696,8,21,29,13,6,2,18,51
2725,1,1980,25,1,3,70,-1,844,139,274,0.507,0,0,-1,139,274,0.507,0.507,48,64,0.75,64,106,170,53,21,4,50,102
2725,2,1981,26,1,3,82,-1,1796,290,626,0.463,0,3,0,290,623,0.465,0.463,109,169,0.645,105,210,315,122,53,15,115,168
2725,3,1982,27,1,3,70,70,1965,302,629,0.48,0,2,0,302,627,0.482,0.48,90,134,0.672,108,197,305,218,36,28,111,215
2725,4,1983,28,1,3,82,59,2251,362,806,0.449,1,4,0.25,361,802,0.45,0.45,72,116,0.621,137,236,373,199,37,22,144,202
2725,5,1984,29,1,3,58,18,612,118,241,0.49,2,6,0.333,116,235,0.494,0.494,6,18,0.333,26,66,92,55,17,4,33,65
2728,1,2002,19,1,3,54,1,430,75,175,0.429,0,7,0,75,168,0.446,0.429,23,46,0.5,49,40,89,27,19,6,22,46
2728,2,2003,20,1,3,47,7,571,90,183,0.492,1,4,0.25,89,179,0.497,0.495,39,74,0.527,38,90,128,23,24,15,44,68
2728,3,2004,21,1,3,37,1,337,32,89,0.36,0,2,0,32,87,0.368,0.36,11,24,0.458,35,39,74,19,14,14,8,37
2728,4,2005,22,1,3,70,68,2147,286,637,0.449,17,62,0.274,269,575,0.468,0.462,191,289,0.661,118,268,386,137,117,91,159,182
2728,5,2006,23,1,3,55,52,1895,317,589,0.538,14,50,0.28,303,539,0.562,0.55,188,306,0.614,123,289,412,96,138,115,99,150
2728,6,2007,24,1,3,72,71,2640,478,952,0.502,39,120,0.325,439,832,0.528,0.523,309,447,0.691,142,376,518,185,144,69,160,209
2728,8,2009,26,1,3,71,71,2669,389,811,0.48,39,131,0.298,350,680,0.515,0.504,365,454,0.804,112,441,553,189,121,67,148,210
2728,9,2010,27,1,3,76,76,3119,456,943,0.484,52,140,0.371,404,803,0.503,0.511,422,544,0.776,150,612,762,161,117,83,178,194
2728,10,2011,28,1,3,48,48,1872,252,582,0.433,35,106,0.33,217,476,0.456,0.463,210,284,0.739,72,322,394,116,59,48,100,120
2728,10,2011,28,1,3,71,63,2693,386,851,0.454,62,186,0.333,324,665,0.487,0.49,279,374,0.746,111,458,569,173,105,63,152,183
2728,11,2012,29,1,3,16,16,573,84,202,0.416,20,52,0.385,64,150,0.427,0.465,55,64,0.859,24,85,109,49,23,11,27,38
2728,11,2012,29,1,3,42,42,1503,203,430,0.472,26,98,0.265,177,332,0.533,0.502,125,161,0.776,63,214,277,115,62,25,84,107
2728,11,2012,29,1,3,58,58,2076,287,632,0.454,46,150,0.307,241,482,0.5,0.491,180,225,0.8,87,299,386,164,85,36,111,145
2728,12,2013,30,1,3,69,68,2076,182,458,0.397,46,163,0.282,136,295,0.461,0.448,121,190,0.637,69,250,319,181,97,46,110,118
2728,13,2014,31,1,3,58,16,1416,116,230,0.504,19,64,0.297,97,166,0.584,0.546,47,101,0.465,36,176,212,143,73,14,97,79
2739,2,2005,24,1,3,61,5,768,74,180,0.411,16,61,0.262,58,119,0.487,0.456,34,48,0.708,55,87,142,93,26,11,58,70
2739,3,2006,25,1,3,69,6,1333,135,328,0.412,18,55,0.327,117,273,0.429,0.439,57,76,0.75,88,159,247,156,41,15,78,119
2739,4,2007,26,1,3,60,60,1982,264,557,0.474,48,124,0.387,216,433,0.499,0.517,108,145,0.745,87,215,302,257,60,21,118,117
2739,5,2008,27,1,3,74,31,1729,215,478,0.45,28,84,0.333,187,394,0.475,0.479,77,109,0.706,85,206,291,218,60,18,100,133
2739,6,2009,28,1,3,65,34,1166,134,307,0.436,17,57,0.298,117,250,0.468,0.464,41,57,0.719,55,125,180,177,32,10,69,105
2739,7,2010,29,1,3,29,0,272,30,84,0.357,7,17,0.412,23,67,0.343,0.399,2,4,0.5,12,26,38,40,10,1,12,19
2739,8,2011,30,1,3,54,0,484,38,116,0.328,8,34,0.235,30,82,0.366,0.362,7,10,0.7,9,58,67,62,9,4,31,38
2771,1,1993,22,1,3,82,82,2654,494,1053,0.469,1,4,0.25,493,1049,0.47,0.47,291,408,0.713,179,410,589,147,85,67,176,188
2771,2,1994,23,1,3,82,82,3147,602,1246,0.483,4,17,0.235,598,1229,0.487,0.485,298,430,0.693,254,578,832,192,100,116,195,152
2771,3,1995,24,1,3,76,76,2991,543,1238,0.439,4,21,0.19,539,1217,0.443,0.44,283,377,0.751,144,382,526,215,115,67,191,195
2771,4,1996,25,1,3,78,75,3096,491,1015,0.484,0,2,0,491,1013,0.485,0.484,318,426,0.746,237,516,753,158,112,108,179,214
2771,5,1997,26,1,3,82,82,2949,398,811,0.491,1,6,0.167,397,805,0.493,0.491,206,279,0.738,219,460,679,140,74,86,137,187
2771,7,1999,28,1,3,49,3,1040,141,264,0.534,0,0,-1,141,264,0.534,0.534,115,143,0.804,72,171,243,34,28,17,61,107
2772,1,1980,29,1,3,57,-1,1124,164,378,0.434,0,0,-1,164,378,0.434,0.434,63,91,0.692,83,125,208,54,34,17,86,136
2779,2,2007,20,1,3,82,27,1759,195,492,0.396,91,250,0.364,104,242,0.43,0.489,93,132,0.705,43,197,240,52,35,19,76,126
2779,3,2008,21,1,3,75,70,2132,277,656,0.422,123,317,0.388,154,339,0.454,0.516,122,166,0.735,54,242,296,90,42,28,83,159
2779,4,2010,23,1,3,82,49,2005,259,639,0.405,124,332,0.373,135,307,0.44,0.502,126,155,0.813,47,221,268,62,45,40,60,153
2779,7,2013,26,1,3,76,62,2200,281,636,0.442,139,329,0.422,142,307,0.463,0.551,168,198,0.848,53,241,294,143,49,17,90,166
2779,8,2014,27,1,3,78,13,2157,254,587,0.433,146,372,0.392,108,215,0.502,0.557,105,125,0.84,38,184,222,97,41,15,58,150
2781,1,1980,27,1,3,68,-1,2347,569,1112,0.512,7,22,0.318,562,1090,0.516,0.515,145,181,0.801,114,272,386,145,84,45,112,230
2781,2,1981,28,1,3,81,-1,2902,685,1437,0.477,25,77,0.325,660,1360,0.485,0.485,140,204,0.686,128,305,433,226,97,46,161,294
2781,3,1982,29,1,3,54,39,1638,260,589,0.441,5,23,0.217,255,566,0.451,0.446,66,90,0.733,128,176,304,133,73,14,73,189
2781,4,1983,30,1,3,40,0,503,94,205,0.459,1,10,0.1,93,195,0.477,0.461,20,30,0.667,29,45,74,31,20,6,32,83
2781,4,1983,30,1,3,35,35,1290,280,583,0.48,9,22,0.409,271,561,0.483,0.488,65,77,0.844,69,139,208,86,23,11,94,145
2781,4,1983,30,1,3,75,35,1793,374,788,0.475,10,32,0.313,364,756,0.481,0.481,85,107,0.794,98,184,282,117,43,17,126,228
2781,5,1984,31,1,3,68,5,916,148,333,0.444,2,13,0.154,146,320,0.456,0.447,29,35,0.829,41,98,139,67,27,7,43,107
2781,6,1985,32,1,3,78,5,1127,220,460,0.478,17,34,0.5,203,426,0.477,0.497,42,55,0.764,57,102,159,94,23,10,47,111
2781,7,1986,33,1,3,79,19,1402,286,605,0.473,17,48,0.354,269,557,0.483,0.487,45,68,0.662,66,126,192,83,38,22,54,127
2782,2,2011,24,1,3,59,28,1413,228,513,0.444,17,61,0.279,211,452,0.467,0.461,72,94,0.766,39,114,153,104,34,2,86,87
2787,1,2000,23,1,3,66,0,1162,236,480,0.492,20,53,0.377,216,427,0.506,0.513,88,129,0.682,78,104,182,97,69,12,97,153
2787,2,2001,24,1,3,75,46,1995,387,726,0.533,17,50,0.34,370,676,0.547,0.545,159,240,0.663,120,247,367,208,94,20,169,203
2787,8,2007,30,1,3,28,1,590,85,207,0.411,1,7,0.143,84,200,0.42,0.413,46,82,0.561,26,94,120,31,24,13,57,62
2792,1,2003,23,1,3,37,0,234,19,75,0.253,1,4,0.25,18,71,0.254,0.26,22,29,0.759,12,16,28,27,8,2,19,32
2792,3,2005,25,1,3,16,0,192,12,51,0.235,2,11,0.182,10,40,0.25,0.255,20,28,0.714,6,22,28,19,5,0,15,16
2792,4,2006,26,1,3,58,2,866,86,222,0.387,14,49,0.286,72,173,0.416,0.419,65,87,0.747,22,89,111,62,34,1,41,65
2798,2,2005,24,1,3,30,8,552,75,172,0.436,2,5,0.4,73,167,0.437,0.442,34,50,0.68,40,89,129,23,12,16,37,62
2813,1,1988,22,1,3,17,4,352,66,124,0.532,1,1,1,65,123,0.528,0.536,45,57,0.789,31,31,62,9,7,3,21,32
2813,2,1989,23,1,3,37,0,434,62,119,0.521,0,0,-1,62,119,0.521,0.521,34,42,0.81,34,36,70,17,10,1,26,39
2813,2,1989,23,1,3,38,0,436,62,120,0.517,0,0,-1,62,120,0.517,0.517,34,42,0.81,34,36,70,17,10,1,26,40
2817,1,1983,23,1,3,65,0,626,127,234,0.543,0,1,0,127,233,0.545,0.543,70,109,0.642,47,58,105,30,16,2,51,54
2817,2,1984,24,1,3,22,2,308,69,144,0.479,0,0,-1,69,144,0.479,0.479,24,42,0.571,30,32,62,14,13,2,18,25
2817,2,1984,24,1,3,36,2,372,80,170,0.471,0,0,-1,80,170,0.471,0.471,26,47,0.553,37,37,74,15,15,3,24,31
2817,4,1986,26,1,3,75,30,1761,355,684,0.519,1,9,0.111,354,675,0.524,0.52,164,222,0.739,82,99,181,74,74,8,95,161
2817,5,1987,27,1,3,68,35,1545,265,552,0.48,0,3,0,265,549,0.483,0.48,94,144,0.653,90,104,194,79,47,19,73,159
2818,1,2002,21,1,3,16,0,129,21,60,0.35,2,9,0.222,19,51,0.373,0.367,12,14,0.857,2,16,18,12,9,2,14,6
2818,3,2004,23,1,3,72,0,985,215,468,0.459,33,87,0.379,182,381,0.478,0.495,78,104,0.75,44,121,165,60,32,20,78,105
2818,4,2005,24,1,3,16,0,146,23,62,0.371,5,16,0.313,18,46,0.391,0.411,6,10,0.6,4,11,15,8,2,1,10,13
2818,4,2005,24,1,3,42,2,531,98,227,0.432,19,44,0.432,79,183,0.432,0.474,21,34,0.618,20,54,74,36,30,10,27,51
2818,4,2005,24,1,3,58,2,677,121,289,0.419,24,60,0.4,97,229,0.424,0.46,27,44,0.614,24,65,89,44,32,11,37,64
2841,1,1980,25,1,3,75,-1,2381,430,1030,0.417,7,34,0.206,423,996,0.425,0.421,166,222,0.748,85,231,316,243,93,27,193,194
2841,3,1982,27,1,3,65,38,1805,284,679,0.418,3,18,0.167,281,661,0.425,0.42,145,185,0.784,60,190,250,237,92,25,138,188
2841,4,1983,28,1,3,77,11,1702,213,511,0.417,0,4,0,213,507,0.42,0.417,93,124,0.75,62,180,242,189,68,16,160,157
2842,1,1980,26,1,3,82,-1,3111,726,1358,0.535,3,17,0.176,723,1341,0.539,0.536,189,234,0.808,176,349,525,250,129,28,157,220
2842,2,1981,27,1,3,81,-1,3028,786,1495,0.526,1,13,0.077,785,1482,0.53,0.526,254,335,0.758,146,289,435,235,121,29,207,223
2842,3,1982,28,1,3,82,82,2906,744,1417,0.525,0,4,0,744,1413,0.527,0.525,246,336,0.732,153,240,393,143,89,24,164,240
2842,4,1983,29,1,3,80,80,2552,684,1290,0.53,0,6,0,684,1284,0.533,0.53,203,268,0.757,146,197,343,182,65,17,150,221
2842,5,1984,30,1,3,75,74,2507,542,1055,0.514,2,8,0.25,540,1047,0.516,0.515,208,280,0.743,130,210,340,214,72,41,137,205
2842,6,1985,31,1,3,42,8,761,148,303,0.488,0,1,0,148,302,0.49,0.488,51,66,0.773,35,59,94,41,19,3,49,65
2842,7,1986,32,1,3,13,1,195,26,65,0.4,1,3,0.333,25,62,0.403,0.408,22,27,0.815,13,16,29,15,7,2,16,19
2843,1,1981,22,1,3,48,-1,540,85,184,0.462,0,1,0,85,183,0.464,0.462,29,42,0.69,36,60,96,30,25,12,34,86
2843,2,1982,23,1,3,57,22,862,128,266,0.481,0,1,0,128,265,0.483,0.481,58,80,0.725,62,97,159,64,30,18,62,112
2843,3,1983,24,1,3,9,0,129,11,34,0.324,0,1,0,11,33,0.333,0.324,12,15,0.8,9,10,19,10,3,1,5,22
2844,1,2005,25,1,3,29,7,520,73,168,0.435,16,59,0.271,57,109,0.523,0.482,21,34,0.618,29,37,66,26,22,10,16,55
2844,2,2006,26,1,3,82,12,1525,193,435,0.444,14,56,0.25,179,379,0.472,0.46,136,162,0.84,79,113,192,107,72,12,85,144
2844,3,2007,27,1,3,82,31,2037,262,602,0.435,50,122,0.41,212,480,0.442,0.477,150,170,0.882,87,142,229,156,92,16,116,157
2844,4,2008,28,1,3,76,31,1843,271,673,0.403,50,155,0.323,221,518,0.427,0.44,106,144,0.736,72,173,245,150,62,19,89,128
2844,6,2010,30,1,3,80,31,1585,165,381,0.433,18,61,0.295,147,320,0.459,0.457,103,129,0.798,72,177,249,135,66,25,76,144
2844,7,2011,31,1,3,52,0,676,69,137,0.504,2,10,0.2,67,127,0.528,0.511,40,56,0.714,23,67,90,41,27,9,21,72
2844,8,2012,32,1,3,60,2,922,76,193,0.394,7,23,0.304,69,170,0.406,0.412,34,54,0.63,22,78,100,44,29,13,30,85
2858,3,2014,22,1,3,67,15,1658,187,428,0.437,24,84,0.286,163,344,0.474,0.465,172,243,0.708,68,229,297,55,44,16,70,105
2858,3,2014,22,1,3,78,15,1820,206,482,0.427,26,99,0.263,180,383,0.47,0.454,186,259,0.718,71,252,323,56,48,20,76,114
2862,1,1996,23,1,3,64,6,1470,241,546,0.441,3,10,0.3,238,536,0.444,0.444,200,298,0.671,92,125,217,70,56,11,88,147
2862,3,1998,25,1,3,4,4,145,24,61,0.393,0,0,-1,24,61,0.393,0.393,31,45,0.689,10,11,21,12,4,0,9,9
2862,4,1999,26,1,3,38,8,780,80,219,0.365,6,26,0.231,74,193,0.383,0.379,111,139,0.799,34,47,81,37,27,8,49,76
2862,5,2000,27,1,3,68,17,1378,165,386,0.427,25,72,0.347,140,314,0.446,0.46,134,169,0.793,55,101,156,93,44,16,66,165
2862,6,2001,28,1,3,81,11,1745,162,448,0.362,46,139,0.331,116,309,0.375,0.413,165,231,0.714,64,143,207,112,64,13,76,179
2862,7,2002,29,1,3,74,30,1747,144,385,0.374,24,86,0.279,120,299,0.401,0.405,160,219,0.731,58,163,221,109,77,8,95,179
2862,8,2003,30,1,3,82,79,2350,254,575,0.442,37,110,0.336,217,465,0.467,0.474,201,268,0.75,143,239,382,140,86,19,97,234
2862,9,2004,31,1,3,21,0,513,77,177,0.435,11,32,0.344,66,145,0.455,0.466,78,109,0.716,21,74,95,25,22,1,31,52
2862,9,2004,31,1,3,50,36,1373,154,421,0.366,24,95,0.253,130,326,0.399,0.394,137,174,0.787,44,147,191,95,48,8,57,128
2862,9,2004,31,1,3,71,36,1886,231,598,0.386,35,127,0.276,196,471,0.416,0.416,215,283,0.76,65,221,286,120,70,9,88,180
2862,11,2006,33,1,3,28,11,352,29,75,0.387,5,18,0.278,24,57,0.421,0.42,28,38,0.737,10,40,50,15,7,2,15,55
2862,12,2007,34,1,3,21,0,121,19,47,0.404,8,19,0.421,11,28,0.393,0.489,8,14,0.571,3,14,17,7,3,0,7,12
2864,1,1985,24,1,3,21,0,119,29,63,0.46,1,4,0.25,28,59,0.475,0.468,2,5,0.4,15,12,27,9,5,2,8,17
2868,2,2011,27,1,3,26,1,391,41,126,0.325,13,45,0.289,28,81,0.346,0.377,9,12,0.75,7,41,48,22,9,3,16,34
2871,9,2005,31,1,3,79,4,1211,122,243,0.502,0,5,0,122,238,0.513,0.502,115,172,0.669,115,168,283,41,55,10,65,155
2874,2,1992,22,1,3,60,6,565,113,218,0.518,0,4,0,113,214,0.528,0.518,26,43,0.605,64,65,129,40,20,41,22,99
2874,3,1993,23,1,3,57,0,844,150,282,0.532,0,3,0,150,279,0.538,0.532,48,68,0.706,102,126,228,38,21,45,28,87
2874,4,1994,24,1,3,68,1,982,191,391,0.488,0,4,0,191,387,0.494,0.488,45,64,0.703,93,112,205,52,24,49,45,99
2881,3,2008,21,1,3,80,80,2765,424,918,0.462,1,10,0.1,423,908,0.466,0.462,336,409,0.822,119,338,457,137,81,33,127,225
2881,4,2009,22,1,3,61,59,2093,285,622,0.458,55,155,0.355,230,467,0.493,0.502,220,273,0.806,110,272,382,81,57,39,70,127
2881,5,2010,23,1,3,81,81,2468,302,664,0.455,40,132,0.303,262,532,0.492,0.485,176,215,0.819,106,310,416,93,66,46,72,160
2881,6,2011,24,1,3,65,52,1865,246,537,0.458,37,110,0.336,209,427,0.489,0.493,147,174,0.845,68,245,313,88,34,23,62,104
2881,7,2012,25,1,3,57,37,1500,203,470,0.432,58,149,0.389,145,321,0.452,0.494,115,146,0.788,76,218,294,71,47,18,39,84
2881,8,2013,26,1,3,73,51,1727,199,470,0.423,54,166,0.325,145,304,0.477,0.481,77,99,0.778,55,208,263,77,37,38,60,98
2883,1,1995,23,1,3,41,23,503,60,133,0.451,0,8,0,60,125,0.48,0.451,17,38,0.447,42,56,98,49,20,4,41,87
2883,2,1996,24,1,3,17,0,122,20,46,0.435,0,1,0,20,45,0.444,0.435,9,12,0.75,11,12,23,4,4,2,13,17
2883,2,1996,24,1,3,31,0,184,27,68,0.397,0,1,0,27,67,0.403,0.397,14,20,0.7,20,20,40,8,6,2,18,26
2883,3,1997,25,1,3,65,26,1345,234,460,0.509,0,1,0,234,459,0.51,0.509,120,186,0.645,98,108,206,91,55,52,116,161
2883,4,1998,26,1,3,72,16,1314,165,368,0.448,1,2,0.5,164,366,0.448,0.45,122,182,0.67,67,112,179,89,34,24,82,133
2883,5,2000,28,1,3,75,23,1501,263,538,0.489,2,5,0.4,261,533,0.49,0.491,123,166,0.741,96,154,250,106,46,17,109,187
2883,6,2001,29,1,3,82,0,1211,162,364,0.445,1,13,0.077,161,351,0.459,0.446,85,133,0.639,86,157,243,79,29,16,85,136
2883,7,2002,30,1,3,68,19,1284,198,362,0.547,0,4,0,198,358,0.553,0.547,88,134,0.657,80,155,235,96,49,17,86,134
2883,8,2003,31,1,3,21,2,276,34,80,0.425,0,2,0,34,78,0.436,0.425,24,32,0.75,12,33,45,26,12,5,17,33
2885,1,1988,23,1,3,35,14,857,152,427,0.356,13,58,0.224,139,369,0.377,0.371,48,66,0.727,55,63,118,58,29,21,63,108
2885,2,1989,24,1,3,63,17,1303,260,594,0.438,30,104,0.288,230,490,0.469,0.463,92,122,0.754,70,109,179,103,81,29,114,181
2885,3,1990,25,1,3,5,5,133,21,57,0.368,0,5,0,21,52,0.404,0.368,18,21,0.857,8,7,15,10,9,1,9,7
2885,3,1990,25,1,3,32,12,542,91,239,0.381,6,27,0.222,85,212,0.401,0.393,30,41,0.732,17,43,60,38,22,10,32,79
2885,3,1990,25,1,3,47,17,743,131,338,0.388,6,37,0.162,125,301,0.415,0.396,52,68,0.765,28,55,83,53,32,14,45,102
2885,4,1991,26,1,3,22,0,354,61,127,0.48,14,26,0.538,47,101,0.465,0.535,35,41,0.854,17,42,59,46,20,11,36,64
2885,4,1991,26,1,3,51,46,1542,323,728,0.444,43,131,0.328,280,597,0.469,0.473,131,156,0.84,116,131,247,87,93,30,76,189
2885,4,1991,26,1,3,73,46,1896,384,855,0.449,57,157,0.363,327,698,0.468,0.482,166,197,0.843,133,173,306,133,113,41,112,253
2885,5,1992,27,1,3,81,80,2623,601,1277,0.471,56,156,0.359,545,1121,0.486,0.493,216,269,0.803,145,260,405,235,148,68,173,270
2885,6,1993,28,1,3,79,79,2722,535,1167,0.458,33,122,0.27,502,1045,0.48,0.473,238,296,0.804,132,296,428,295,126,76,194,284
2885,7,1994,29,1,3,82,68,2654,418,1014,0.412,64,230,0.278,354,784,0.452,0.444,165,225,0.733,98,294,392,300,117,66,163,288
2885,8,1995,30,1,3,74,70,2198,388,846,0.459,85,266,0.32,303,580,0.522,0.509,132,174,0.759,94,235,329,231,114,67,124,264
2885,9,1996,31,1,3,52,5,817,94,254,0.37,20,89,0.225,74,165,0.448,0.409,33,39,0.846,25,97,122,74,34,21,51,137
2885,10,1997,32,1,3,11,0,167,27,67,0.403,9,33,0.273,18,34,0.529,0.47,8,10,0.8,4,20,24,8,8,4,10,28
2885,10,1997,32,1,3,13,0,200,29,76,0.382,9,34,0.265,20,42,0.476,0.441,9,12,0.75,5,26,31,10,8,4,12,33
2886,4,2013,26,1,3,40,0,380,57,132,0.432,22,72,0.306,35,60,0.583,0.515,10,21,0.476,8,43,51,39,12,1,19,19
2896,1,1996,22,1,3,53,3,609,125,268,0.466,0,3,0,125,265,0.472,0.466,47,84,0.56,56,58,114,23,11,9,76,115
2896,2,1997,23,1,3,79,31,1992,371,745,0.498,0,3,0,371,742,0.5,0.498,173,251,0.689,139,187,326,124,60,49,157,263
2896,3,1998,24,1,3,79,75,2819,561,1134,0.495,0,9,0,561,1125,0.499,0.495,279,443,0.63,162,284,446,230,76,48,199,252
2896,4,1999,25,1,3,50,50,1374,269,555,0.485,1,5,0.2,268,550,0.487,0.486,120,188,0.638,85,121,206,66,30,8,75,118
2896,5,2000,26,1,3,76,76,1707,311,622,0.5,0,0,-1,311,622,0.5,0.5,163,212,0.769,122,168,290,82,38,19,110,192
2896,6,2001,27,1,3,27,9,800,172,322,0.534,0,0,-1,172,322,0.534,0.534,67,107,0.626,53,115,168,28,35,8,45,87
2896,6,2001,27,1,3,42,31,886,153,325,0.471,0,2,0,153,323,0.474,0.471,84,130,0.646,57,96,153,33,15,13,65,98
2896,6,2001,27,1,3,69,40,1686,325,647,0.502,0,2,0,325,645,0.504,0.502,151,237,0.637,110,211,321,61,50,21,110,185
2896,7,2002,28,1,3,78,7,1701,411,806,0.51,1,5,0.2,410,801,0.512,0.511,240,298,0.805,117,202,319,94,49,26,137,226
2896,8,2003,29,1,3,82,1,2061,374,826,0.453,2,11,0.182,372,815,0.456,0.454,237,300,0.79,147,211,358,104,44,27,126,238
2896,11,2006,32,1,3,37,0,362,43,103,0.417,2,2,1,41,101,0.406,0.427,38,49,0.776,21,46,67,14,7,4,30,56
2897,1,1980,22,1,3,57,-1,556,104,267,0.39,0,4,0,104,263,0.395,0.39,58,90,0.644,65,56,121,36,19,8,49,73
2897,3,1982,24,1,3,60,27,1521,349,628,0.556,2,9,0.222,347,619,0.561,0.557,131,173,0.757,100,127,227,142,77,16,114,153
2897,5,1984,26,1,3,13,1,258,34,114,0.298,1,9,0.111,33,105,0.314,0.303,36,46,0.783,19,31,50,16,14,1,18,33
2897,6,1985,27,1,3,34,20,867,167,380,0.439,4,15,0.267,163,365,0.447,0.445,79,123,0.642,45,123,168,94,28,8,78,83
2898,1,2010,22,1,3,78,9,1764,261,651,0.401,31,100,0.31,230,551,0.417,0.425,103,144,0.715,46,302,348,223,43,10,124,126
2898,4,2013,25,1,3,24,0,318,48,97,0.495,5,15,0.333,43,82,0.524,0.521,9,21,0.429,4,40,44,38,11,2,22,13
2899,1,1993,22,1,3,59,26,1673,358,823,0.435,61,191,0.319,297,632,0.47,0.472,224,302,0.742,115,150,265,178,66,29,179,209
2899,2,1994,23,1,3,57,4,1356,226,580,0.39,38,132,0.288,188,448,0.42,0.422,148,233,0.635,71,164,235,132,52,23,145,200
2899,3,1995,24,1,3,77,77,2739,445,998,0.446,103,296,0.348,342,702,0.487,0.497,266,364,0.731,100,245,345,316,123,63,243,265
2899,4,1996,25,1,3,28,28,788,124,268,0.463,56,123,0.455,68,145,0.469,0.567,33,60,0.55,37,75,112,65,32,16,48,87
2899,4,1996,25,1,3,45,45,1381,235,540,0.435,58,170,0.341,177,370,0.478,0.489,130,172,0.756,62,145,207,165,53,42,103,151
2899,4,1996,25,1,3,73,73,2169,359,808,0.444,114,293,0.389,245,515,0.476,0.515,163,232,0.703,99,220,319,230,85,58,151,238
2899,5,1997,26,1,3,73,73,2647,419,982,0.427,175,437,0.4,244,545,0.448,0.516,186,243,0.765,103,264,367,197,97,62,174,282
2899,6,1998,27,1,3,31,1,594,85,225,0.378,31,90,0.344,54,135,0.4,0.447,59,65,0.908,23,59,82,53,19,12,40,61
2899,6,1998,27,1,3,28,16,876,125,319,0.392,49,129,0.38,76,190,0.4,0.469,49,60,0.817,27,91,118,69,40,23,52,100
2899,6,1998,27,1,3,59,17,1470,210,544,0.386,80,219,0.365,130,325,0.4,0.46,108,125,0.864,50,150,200,122,59,35,92,161
2899,7,1999,28,1,3,48,16,1044,147,347,0.424,63,144,0.438,84,203,0.414,0.514,89,107,0.832,36,107,143,80,37,28,63,101
2899,8,2000,29,1,3,76,66,1859,312,681,0.458,102,261,0.391,210,420,0.5,0.533,101,123,0.821,69,237,306,157,49,44,113,190
2899,9,2001,30,1,3,72,31,1583,202,513,0.394,98,248,0.395,104,265,0.392,0.489,97,126,0.77,31,214,245,97,30,28,73,153
2899,10,2002,31,1,3,48,25,1117,166,396,0.419,78,183,0.426,88,213,0.413,0.518,40,51,0.784,37,125,162,69,18,10,53,106
2899,11,2003,32,1,3,66,1,1161,134,341,0.393,64,171,0.374,70,170,0.412,0.487,31,50,0.62,53,154,207,59,42,26,35,141
2900,1,1998,28,1,3,39,0,365,56,119,0.471,0,1,0,56,118,0.475,0.471,24,46,0.522,53,39,92,20,18,5,30,55
2917,1,1991,24,1,3,64,1,607,98,245,0.4,8,20,0.4,90,225,0.4,0.416,35,45,0.778,34,33,67,25,16,13,30,70
2919,7,1993,29,1,3,72,55,1471,180,336,0.536,1,6,0.167,179,330,0.542,0.537,79,107,0.738,49,125,174,183,66,9,89,135
2920,1,1996,21,1,3,44,2,487,60,157,0.382,19,63,0.302,41,94,0.436,0.443,26,34,0.765,45,59,104,28,20,6,31,73
2920,2,1997,22,1,3,47,0,569,79,193,0.409,26,77,0.338,53,116,0.457,0.477,27,40,0.675,63,74,137,45,14,6,49,101
2934,1,1982,22,1,3,46,0,493,49,84,0.583,1,2,0.5,48,82,0.585,0.589,33,40,0.825,29,33,62,38,17,4,35,74
2936,6,1989,29,1,3,31,2,416,50,117,0.427,2,4,0.5,48,113,0.425,0.436,16,22,0.727,6,20,26,32,10,0,12,12
2936,6,1989,29,1,3,33,11,704,80,169,0.473,1,2,0.5,79,167,0.473,0.476,12,19,0.632,20,34,54,79,13,2,20,31
2936,6,1989,29,1,3,64,13,1120,130,286,0.455,3,6,0.5,127,280,0.454,0.46,28,41,0.683,26,54,80,111,23,2,32,43
2936,7,1990,30,1,3,61,0,544,62,122,0.508,1,2,0.5,61,120,0.508,0.512,5,6,0.833,4,26,30,39,7,4,23,21
2936,8,1991,31,1,3,41,0,355,35,79,0.443,0,5,0,35,74,0.473,0.443,4,6,0.667,6,27,33,25,10,4,10,9
2937,2,1983,24,1,3,76,47,1822,343,740,0.464,15,50,0.3,328,690,0.475,0.474,124,161,0.77,96,140,236,134,55,36,111,188
2939,1,1982,22,1,3,42,3,342,55,120,0.458,0,1,0,55,119,0.462,0.458,34,52,0.654,22,43,65,9,8,6,15,37
2940,2,2004,22,1,3,62,8,673,88,237,0.371,10,29,0.345,78,208,0.375,0.392,38,60,0.633,46,90,136,46,20,14,52,88
2940,3,2006,24,1,3,49,16,1013,129,254,0.508,22,60,0.367,107,194,0.552,0.551,49,76,0.645,44,146,190,47,32,13,61,96
2945,1,1982,22,1,3,75,12,1188,202,394,0.513,0,3,0,202,391,0.517,0.513,144,206,0.699,82,145,227,81,23,24,107,152
2945,2,1983,23,1,3,57,38,1627,361,622,0.58,0,3,0,361,619,0.583,0.58,217,340,0.638,122,176,298,97,38,44,157,177
2945,3,1984,24,1,3,75,74,2544,570,1086,0.525,1,2,0.5,569,1084,0.525,0.525,303,424,0.715,130,239,369,136,71,60,188,253
2945,4,1985,25,1,3,77,76,2816,679,1225,0.554,0,5,0,679,1220,0.557,0.554,409,521,0.785,158,277,435,135,58,38,178,185
2945,5,1986,26,1,3,70,59,2248,540,1090,0.495,4,23,0.174,536,1067,0.502,0.497,364,462,0.788,150,200,350,213,49,47,174,186
2945,6,1987,27,1,3,75,53,2638,556,1067,0.521,1,8,0.125,555,1059,0.524,0.522,438,564,0.777,118,249,367,261,54,86,213,243
2945,7,1988,28,1,3,19,12,622,110,247,0.445,0,2,0,110,245,0.449,0.445,92,130,0.708,31,60,91,71,13,20,48,73
2945,8,1989,29,1,3,74,0,1491,231,494,0.468,0,1,0,231,493,0.469,0.468,253,343,0.738,81,189,270,58,30,65,103,130
2945,9,1990,30,1,3,62,2,1421,306,550,0.556,0,5,0,306,545,0.561,0.556,176,240,0.733,49,136,185,96,39,46,73,160
2945,10,1991,31,1,3,53,50,1823,490,983,0.498,0,4,0,490,979,0.501,0.498,350,439,0.797,141,220,361,119,69,23,152,145
2945,11,1992,32,1,3,82,61,2113,452,907,0.498,1,9,0.111,451,898,0.502,0.499,241,353,0.683,109,151,260,88,41,33,133,154
2945,12,1993,33,1,3,50,47,1477,271,566,0.479,0,9,0,271,557,0.487,0.479,113,168,0.673,84,92,176,112,26,25,73,114
2945,12,1993,33,1,3,58,47,1555,289,599,0.482,0,9,0,289,590,0.49,0.482,120,177,0.678,87,98,185,115,27,27,79,122
2945,13,1994,34,1,3,74,1,1955,364,773,0.471,1,14,0.071,363,759,0.478,0.472,208,302,0.689,103,195,298,139,41,56,142,186
2952,4,2009,24,1,3,65,53,1552,179,431,0.415,45,149,0.302,134,282,0.475,0.468,71,95,0.747,31,105,136,77,46,27,54,172
2952,5,2010,25,1,3,67,10,1392,162,399,0.406,58,173,0.335,104,226,0.46,0.479,53,77,0.688,38,152,190,71,30,11,58,134
2953,1,1983,21,1,3,77,1,1970,447,772,0.579,1,4,0.25,446,768,0.581,0.58,138,221,0.624,157,242,399,132,91,64,178,221
2953,3,1985,23,1,3,80,76,2696,610,1066,0.572,0,7,0,610,1059,0.576,0.572,190,245,0.776,169,342,511,201,87,67,198,196
2953,4,1986,24,1,3,75,73,2454,629,1086,0.579,0,13,0,629,1073,0.586,0.579,242,314,0.771,136,251,387,201,82,77,149,195
2953,5,1987,25,1,3,82,82,2819,651,1207,0.539,0,13,0,651,1194,0.545,0.539,292,389,0.751,158,308,466,226,108,83,168,206
2953,6,1988,26,1,3,75,72,2655,617,1161,0.531,2,16,0.125,615,1145,0.537,0.532,242,304,0.796,129,245,374,289,72,55,155,175
2953,7,1989,27,1,3,81,81,2960,702,1282,0.548,2,23,0.087,700,1259,0.556,0.548,251,321,0.782,169,320,489,288,108,56,182,175
2953,8,1990,28,1,3,80,80,2960,711,1298,0.548,15,49,0.306,696,1249,0.557,0.554,248,317,0.782,160,318,478,288,99,49,160,190
2953,9,1991,29,1,3,78,74,3008,716,1455,0.492,26,90,0.289,690,1365,0.505,0.501,212,266,0.797,107,249,356,275,104,35,127,117
2953,10,1992,30,1,3,54,54,2108,450,1007,0.447,9,43,0.209,441,964,0.457,0.451,166,204,0.814,98,207,305,252,76,23,127,89
2953,11,1993,31,1,3,82,69,2359,510,1142,0.447,30,111,0.27,480,1031,0.466,0.46,171,211,0.81,73,174,247,278,92,27,137,87
2953,12,1994,32,1,3,80,2,1597,340,838,0.406,32,111,0.288,308,727,0.424,0.425,100,135,0.741,48,133,181,154,45,18,97,80
2954,1,2000,20,1,3,72,63,2238,309,759,0.407,60,191,0.314,249,568,0.438,0.447,188,279,0.674,62,246,308,202,119,39,166,159
2954,2,2001,21,1,3,76,74,2363,327,815,0.401,43,148,0.291,284,667,0.426,0.428,210,280,0.75,59,235,294,228,152,45,159,254
2954,3,2002,22,1,3,28,24,819,117,285,0.411,17,79,0.215,100,206,0.485,0.44,55,75,0.733,33,107,140,50,66,16,49,109
2954,3,2002,22,1,3,27,26,823,152,351,0.433,36,91,0.396,116,260,0.446,0.484,81,129,0.628,40,91,131,77,75,23,69,108
2954,3,2002,22,1,3,55,50,1642,269,636,0.423,53,170,0.312,216,466,0.464,0.465,136,204,0.667,73,198,271,127,141,39,118,217
2954,4,2003,23,1,3,69,67,2317,362,846,0.428,71,211,0.336,291,635,0.458,0.47,273,371,0.736,101,261,362,198,159,50,145,242
2954,5,2004,24,1,3,73,71,2714,468,1112,0.421,75,242,0.31,393,870,0.452,0.455,322,439,0.733,100,285,385,272,152,50,202,194
2954,6,2005,25,1,3,7,7,291,59,119,0.496,7,17,0.412,52,102,0.51,0.525,47,51,0.922,8,37,45,22,12,6,17,27
2954,7,2006,26,1,3,16,16,603,109,237,0.46,18,54,0.333,91,183,0.497,0.498,74,121,0.612,26,52,78,35,42,11,43,45
2954,7,2006,26,1,3,40,40,1604,241,630,0.383,60,199,0.302,181,431,0.42,0.43,132,184,0.717,49,159,208,168,80,30,88,119
2954,7,2006,26,1,3,56,56,2207,350,867,0.404,78,253,0.308,272,614,0.443,0.449,206,305,0.675,75,211,286,203,122,41,131,164
2954,8,2007,27,1,3,70,65,2641,458,1040,0.44,93,260,0.358,365,780,0.468,0.485,307,415,0.74,102,352,454,235,149,43,146,205
2954,9,2008,28,1,3,57,54,2172,436,962,0.453,84,221,0.38,352,741,0.475,0.497,212,295,0.719,101,227,328,199,133,38,148,159
2954,10,2009,29,1,3,69,55,2452,416,1037,0.401,153,383,0.399,263,654,0.402,0.475,196,262,0.748,65,294,359,229,105,24,140,155
2954,11,2010,30,1,3,77,77,2605,306,740,0.414,105,296,0.355,201,444,0.453,0.484,128,186,0.688,99,232,331,234,106,21,121,165
2954,12,2011,31,1,3,82,82,2410,261,658,0.397,83,233,0.356,178,425,0.419,0.46,92,136,0.676,100,167,267,175,124,36,90,181
2954,13,2012,32,1,3,64,45,1720,183,465,0.394,56,189,0.296,127,276,0.46,0.454,71,115,0.617,71,147,218,140,69,27,69,137
2954,14,2013,33,1,3,75,66,2530,332,824,0.403,141,412,0.342,191,412,0.464,0.488,124,169,0.734,101,271,372,112,122,42,98,198
2954,15,2014,34,1,3,29,1,388,56,141,0.397,17,54,0.315,39,87,0.448,0.457,10,16,0.625,18,41,59,17,24,8,19,44
2956,1,2006,20,1,3,20,2,132,20,43,0.465,3,6,0.5,17,37,0.459,0.5,15,17,0.882,2,30,32,8,3,1,14,12
2956,2,2007,21,1,3,66,19,1292,162,364,0.445,5,34,0.147,157,330,0.476,0.452,64,86,0.744,40,232,272,95,41,46,65,112
2956,3,2008,22,1,3,44,34,1104,143,293,0.488,4,11,0.364,139,282,0.493,0.495,57,69,0.826,48,172,220,60,29,41,29,79
2956,4,2010,24,1,3,72,1,1496,194,419,0.463,61,157,0.389,133,262,0.508,0.536,61,69,0.884,50,185,235,91,52,32,53,94
2956,5,2011,25,1,3,82,82,3147,485,1146,0.423,194,516,0.376,291,630,0.462,0.508,180,228,0.789,88,343,431,242,124,63,133,171
2956,6,2012,26,1,3,61,61,1650,222,526,0.422,105,292,0.36,117,234,0.5,0.522,80,98,0.816,60,218,278,94,58,26,51,97
2956,7,2013,27,1,3,79,8,1783,237,599,0.396,135,361,0.374,102,238,0.429,0.508,120,141,0.851,42,260,302,150,62,35,64,98
2956,8,2014,28,1,3,68,13,984,111,297,0.374,69,202,0.342,42,95,0.442,0.49,52,69,0.754,29,162,191,64,23,16,39,62
2958,1,2008,20,1,3,57,1,640,90,169,0.533,10,24,0.417,80,145,0.552,0.562,33,52,0.635,33,84,117,40,29,12,34,43
2958,2,2009,21,1,3,54,19,772,109,234,0.466,2,21,0.095,107,213,0.502,0.47,17,30,0.567,46,106,152,43,35,19,43,49
2958,3,2010,22,1,3,68,14,871,116,232,0.5,2,6,0.333,114,226,0.504,0.504,25,41,0.61,58,86,144,41,29,18,44,45
2958,4,2011,23,1,3,52,6,766,82,160,0.513,2,10,0.2,80,150,0.533,0.519,22,43,0.512,47,71,118,58,39,20,43,45
2970,1,1981,23,1,3,24,-1,123,37,98,0.378,1,2,0.5,36,96,0.375,0.383,9,19,0.474,10,20,30,7,7,4,16,23
2975,1,1980,28,1,3,82,-1,2399,212,458,0.463,7,20,0.35,205,438,0.468,0.471,130,155,0.839,103,326,429,247,100,76,158,307
2975,2,1981,29,1,3,78,-1,1426,100,245,0.408,2,8,0.25,98,237,0.414,0.412,98,117,0.838,48,154,202,129,38,50,108,214
2975,3,1982,30,1,3,41,0,452,41,82,0.5,0,2,0,41,80,0.513,0.5,62,76,0.816,17,31,48,32,12,13,29,63
2976,4,2001,25,1,3,49,47,1733,308,708,0.435,65,170,0.382,243,538,0.452,0.481,150,186,0.806,78,269,347,82,40,20,103,150
2976,5,2002,26,1,3,81,81,2465,471,1089,0.433,101,293,0.345,370,796,0.465,0.479,156,195,0.8,137,472,609,164,63,42,146,221
2976,7,2004,28,1,3,25,15,766,137,290,0.472,33,72,0.458,104,218,0.477,0.529,86,91,0.945,51,107,158,37,16,15,50,64
2976,7,2004,28,1,3,47,47,1574,273,613,0.445,60,161,0.373,213,452,0.471,0.494,163,199,0.819,98,245,343,83,52,18,119,151
2976,7,2004,28,1,3,72,62,2340,410,903,0.454,93,233,0.399,317,670,0.473,0.506,249,290,0.859,149,352,501,120,68,33,169,215
2976,8,2005,29,1,3,33,13,818,128,285,0.449,30,78,0.385,98,207,0.473,0.502,56,65,0.862,55,110,165,41,21,11,47,82
2976,8,2005,29,1,3,62,16,1502,257,564,0.456,54,142,0.38,203,422,0.481,0.504,128,157,0.815,89,205,294,75,36,21,81,170
2976,9,2006,30,1,3,53,0,1090,164,387,0.424,50,136,0.368,114,251,0.454,0.488,94,113,0.832,54,138,192,37,31,11,71,121
2987,1,1981,22,1,3,51,-1,1376,229,537,0.426,0,7,0,229,530,0.432,0.426,130,159,0.818,86,184,270,94,29,24,86,116
2987,5,1985,26,1,3,72,69,2502,618,1158,0.534,11,33,0.333,607,1125,0.54,0.538,369,412,0.896,74,154,228,106,37,22,116,116
2987,6,1986,27,1,3,79,76,2791,719,1332,0.54,1,8,0.125,718,1324,0.542,0.54,523,602,0.869,92,124,216,187,54,17,177,161
2987,7,1987,28,1,3,79,79,3029,808,1545,0.523,39,81,0.481,769,1464,0.525,0.536,467,527,0.886,86,165,251,220,52,17,139,137
2987,8,1988,29,1,3,37,7,1038,283,557,0.508,22,58,0.379,261,499,0.523,0.528,159,181,0.878,36,73,109,71,21,7,48,68
2987,10,1990,31,1,3,22,13,563,102,231,0.442,10,19,0.526,92,212,0.434,0.463,44,48,0.917,15,38,53,41,15,3,26,28
2987,11,1991,32,1,3,75,72,2420,458,927,0.494,51,141,0.362,407,786,0.518,0.522,259,288,0.899,78,102,180,110,42,10,108,122
2987,12,1992,33,1,3,67,0,956,188,383,0.491,26,66,0.394,162,317,0.511,0.525,65,81,0.802,31,57,88,57,15,8,27,87
2987,13,1993,34,1,3,41,3,494,92,203,0.453,12,37,0.324,80,166,0.482,0.483,58,66,0.879,12,36,48,25,13,7,20,45
3000,3,1984,24,1,3,61,5,1421,252,579,0.435,0,1,0,252,578,0.436,0.435,168,215,0.781,81,166,247,114,30,10,113,159
3000,6,1987,27,1,3,51,17,1386,274,613,0.447,0,3,0,274,610,0.449,0.447,130,169,0.769,69,141,210,85,40,17,77,127
3000,7,1988,28,1,3,73,8,1755,446,958,0.466,1,4,0.25,445,954,0.466,0.466,231,287,0.805,80,229,309,143,46,26,137,198
3000,8,1989,29,1,3,24,3,551,91,219,0.416,0,1,0,91,218,0.417,0.416,35,51,0.686,36,56,92,22,5,3,37,52
3000,8,1989,29,1,3,29,4,646,104,257,0.405,1,3,0.333,103,254,0.406,0.407,40,60,0.667,38,72,110,27,6,4,42,63
3000,9,1990,30,1,3,24,1,200,41,78,0.526,0,1,0,41,77,0.532,0.526,8,12,0.667,7,19,26,10,8,3,19,29
3000,9,1990,30,1,3,17,5,259,45,105,0.429,1,1,1,44,104,0.423,0.433,33,37,0.892,13,23,36,8,10,2,14,23
3000,9,1990,30,1,3,41,6,459,86,183,0.47,1,2,0.5,85,181,0.47,0.473,41,49,0.837,20,42,62,18,18,5,33,52
3002,1,2007,22,1,3,13,0,103,7,15,0.467,3,7,0.429,4,8,0.5,0.567,5,7,0.714,2,9,11,5,2,1,6,10
3008,1,1982,23,1,3,77,1,1075,143,262,0.546,0,1,0,143,261,0.548,0.546,89,148,0.601,71,127,198,56,28,21,68,150
3008,2,1983,24,1,3,82,73,2054,226,429,0.527,0,1,0,226,428,0.528,0.527,115,209,0.55,177,248,425,120,53,49,102,254
3008,3,1984,25,1,3,80,72,2174,258,495,0.521,0,1,0,258,494,0.522,0.521,153,236,0.648,150,245,395,132,51,54,121,263
3008,4,1985,26,1,3,76,70,2163,186,402,0.463,1,4,0.25,185,398,0.465,0.464,67,127,0.528,154,282,436,152,76,57,119,256
3008,5,1986,27,1,3,80,19,1569,131,284,0.461,0,4,0,131,280,0.468,0.461,39,75,0.52,115,166,281,68,63,31,58,218
3008,6,1987,28,1,3,58,6,817,59,138,0.428,1,5,0.2,58,133,0.436,0.431,21,45,0.467,51,95,146,30,35,25,26,127
3008,7,1988,29,1,3,57,5,772,53,121,0.438,0,3,0,53,118,0.449,0.438,15,35,0.429,45,72,117,36,27,33,25,100
3019,7,2009,29,1,3,26,21,979,165,349,0.473,49,118,0.415,116,231,0.502,0.543,97,115,0.843,16,96,112,53,25,15,43,60
3019,7,2009,29,1,3,53,53,1980,351,744,0.472,77,184,0.418,274,560,0.489,0.524,191,232,0.823,43,178,221,196,58,9,122,122
3019,7,2009,29,1,3,79,74,2959,516,1093,0.472,126,302,0.417,390,791,0.493,0.53,288,347,0.83,59,274,333,249,83,24,165,182
3019,10,2012,32,1,3,46,32,1250,141,345,0.409,33,112,0.295,108,233,0.464,0.457,29,45,0.644,20,114,134,93,37,7,45,77
3019,11,2013,33,1,3,76,72,2278,244,612,0.399,99,267,0.371,145,345,0.42,0.48,85,110,0.773,33,174,207,226,51,25,85,143
3019,12,2014,34,1,3,18,8,445,41,117,0.35,16,42,0.381,25,75,0.333,0.419,7,7,1,8,38,46,44,12,8,14,32
3024,2,1992,26,1,3,12,0,117,20,45,0.444,0,0,-1,20,45,0.444,0.444,7,9,0.778,9,17,26,9,5,3,5,15
3027,1,1983,22,1,3,26,0,393,76,157,0.484,0,2,0,76,155,0.49,0.484,31,43,0.721,31,63,94,19,18,6,28,57
3027,2,1984,23,1,3,50,0,586,97,203,0.478,0,0,-1,97,203,0.478,0.478,29,42,0.69,40,63,103,44,23,12,44,101
3027,3,1985,24,1,3,21,11,418,85,175,0.486,0,0,-1,85,175,0.486,0.486,45,59,0.763,38,51,89,29,23,4,34,59
3027,4,1986,25,1,3,82,5,1644,347,676,0.513,3,15,0.2,344,661,0.52,0.516,208,257,0.809,104,169,273,150,76,31,143,236
3027,5,1987,26,1,3,82,4,1655,357,722,0.494,2,17,0.118,355,705,0.504,0.496,143,183,0.781,101,170,271,126,61,23,105,210
3027,6,1988,27,1,3,24,11,417,71,132,0.538,0,0,-1,71,132,0.538,0.538,20,23,0.87,10,37,47,26,13,5,23,58
3027,6,1988,27,1,3,35,5,466,82,171,0.48,0,1,0,82,170,0.482,0.48,39,53,0.736,28,34,62,30,18,4,27,73
3027,6,1988,27,1,3,59,16,883,153,303,0.505,0,1,0,153,302,0.507,0.505,59,76,0.776,38,71,109,56,31,9,50,131
3027,7,1989,28,1,3,82,82,2102,332,733,0.453,3,10,0.3,329,723,0.455,0.455,97,135,0.719,98,209,307,133,89,32,104,230
3027,8,1990,29,1,3,82,13,1531,225,479,0.47,5,14,0.357,220,465,0.473,0.475,55,75,0.733,78,152,230,89,43,23,79,220
3027,9,1991,30,1,3,80,7,1357,206,494,0.417,4,20,0.2,202,474,0.426,0.421,47,57,0.825,73,112,185,106,37,26,65,198
3027,10,1992,31,1,3,21,20,552,81,139,0.583,1,3,0.333,80,136,0.588,0.586,31,41,0.756,27,61,88,42,22,9,16,75
3027,10,1992,31,1,3,31,20,633,92,161,0.571,1,3,0.333,91,158,0.576,0.575,36,47,0.766,27,69,96,53,24,10,22,83
3027,11,1993,32,1,3,53,51,1189,197,396,0.497,1,4,0.25,196,392,0.5,0.499,59,78,0.756,52,118,170,75,39,30,57,150
3060,1,1986,23,1,3,64,12,969,142,315,0.451,3,7,0.429,139,308,0.451,0.456,110,152,0.724,70,128,198,88,23,10,84,166
3060,2,1987,24,1,3,81,5,1711,265,561,0.472,33,69,0.478,232,492,0.472,0.502,193,260,0.742,87,216,303,161,50,16,110,224
3060,3,1988,25,1,3,82,4,1587,246,539,0.456,5,32,0.156,241,507,0.475,0.461,201,266,0.756,102,177,279,159,42,32,108,189
3060,9,1994,31,1,3,81,80,2728,445,903,0.493,22,68,0.324,423,835,0.507,0.505,300,390,0.769,144,310,454,275,73,9,173,273
3060,10,1995,32,1,3,82,82,2886,521,997,0.523,93,181,0.514,428,816,0.525,0.569,437,521,0.839,135,373,508,310,93,35,176,252
3060,11,1996,33,1,3,63,60,2200,360,740,0.486,73,179,0.408,287,561,0.512,0.536,287,370,0.776,73,255,328,276,56,8,146,179
3060,12,1997,34,1,3,61,60,2192,356,724,0.492,57,161,0.354,299,563,0.531,0.531,253,316,0.801,87,307,394,266,63,16,150,151
3060,13,1998,35,1,3,78,78,2742,437,898,0.487,61,147,0.415,376,751,0.501,0.521,297,352,0.844,135,419,554,341,60,19,168,205
3060,14,1999,36,1,3,50,39,1765,259,549,0.472,34,86,0.395,225,463,0.486,0.503,200,243,0.823,77,293,370,184,41,26,103,152
3060,15,2000,37,1,3,77,6,1662,187,433,0.432,21,52,0.404,166,381,0.436,0.456,179,215,0.833,79,253,332,197,37,17,100,182
3060,16,2001,38,1,3,26,0,397,39,95,0.411,3,8,0.375,36,87,0.414,0.426,23,27,0.852,17,61,78,44,7,3,28,43
3067,1,1980,24,1,3,79,-1,1303,127,301,0.422,1,3,0.333,126,298,0.423,0.424,95,122,0.779,89,139,228,98,47,53,92,101
3067,2,1981,25,1,3,82,-1,1423,173,348,0.497,1,6,0.167,172,342,0.503,0.499,97,127,0.764,101,167,268,114,60,70,77,124
3067,3,1982,26,1,3,81,38,1740,189,380,0.497,0,2,0,189,378,0.5,0.497,108,148,0.73,97,197,294,149,59,70,98,169
3067,4,1983,27,1,3,81,9,1139,124,259,0.479,0,2,0,124,257,0.482,0.479,81,110,0.736,60,164,224,97,48,31,64,133
3067,5,1984,28,1,3,65,5,735,55,124,0.444,1,2,0.5,54,122,0.443,0.448,56,72,0.778,29,71,100,48,19,20,42,85
3067,6,1985,29,1,3,77,18,1238,111,259,0.429,1,5,0.2,110,254,0.433,0.431,53,74,0.716,46,115,161,127,39,25,60,125
3068,2,1992,23,1,3,18,15,608,133,331,0.402,29,89,0.326,104,242,0.43,0.446,64,71,0.901,14,52,66,35,20,9,31,49
3068,3,1993,24,1,3,54,43,1759,329,763,0.431,108,268,0.403,221,495,0.446,0.502,92,117,0.786,38,148,186,136,57,18,104,131
3068,4,1994,25,1,3,82,37,2283,384,949,0.405,155,388,0.399,229,561,0.408,0.486,123,159,0.774,54,164,218,216,81,32,93,161
3068,5,1995,26,1,3,62,10,1499,283,645,0.439,150,352,0.426,133,293,0.454,0.555,86,114,0.754,25,121,146,131,45,14,57,119
3068,6,1996,27,1,3,82,82,3041,491,1117,0.44,267,628,0.425,224,489,0.458,0.559,182,222,0.82,63,246,309,243,90,29,122,169
3068,7,1997,28,1,3,66,62,2166,298,749,0.398,147,373,0.394,151,376,0.402,0.496,80,101,0.792,40,163,203,139,74,19,81,138
3068,8,1998,29,1,3,29,3,493,71,162,0.438,31,69,0.449,40,93,0.43,0.534,8,12,0.667,8,42,50,24,10,7,12,31
3068,8,1998,29,1,3,52,42,1797,258,666,0.387,94,273,0.344,164,393,0.417,0.458,97,118,0.822,39,158,197,129,43,32,92,121
3068,8,1998,29,1,3,81,45,2290,329,828,0.397,125,342,0.365,204,486,0.42,0.473,105,130,0.808,47,200,247,153,53,39,104,152
3068,9,1999,30,1,3,15,0,206,17,56,0.304,8,29,0.276,9,27,0.333,0.375,1,4,0.25,3,17,20,8,3,1,5,17
3068,9,1999,30,1,3,21,9,532,70,157,0.446,29,68,0.426,41,89,0.461,0.538,22,27,0.815,5,33,38,32,12,2,14,32
3068,9,1999,30,1,3,36,9,738,87,213,0.408,37,97,0.381,50,116,0.431,0.495,23,31,0.742,8,50,58,40,15,3,19,49
3068,10,2000,31,1,3,66,0,1263,125,333,0.375,71,189,0.376,54,144,0.375,0.482,48,57,0.842,16,90,106,69,28,9,30,104
3074,1,1986,23,1,3,78,0,1168,142,301,0.472,1,11,0.091,141,290,0.486,0.473,78,126,0.619,97,145,242,85,78,66,96,171
3074,2,1987,24,1,3,69,5,753,123,247,0.498,4,13,0.308,119,234,0.509,0.506,94,134,0.701,97,101,198,57,55,54,56,124
3074,3,1988,25,1,3,29,0,447,54,116,0.466,3,8,0.375,51,108,0.472,0.478,27,39,0.692,29,52,81,49,47,22,41,78
3074,3,1988,25,1,3,33,0,455,55,118,0.466,3,8,0.375,52,110,0.473,0.479,27,39,0.692,30,54,84,50,49,23,43,81
3077,1,1993,22,1,3,58,2,672,136,319,0.426,7,31,0.226,129,288,0.448,0.437,51,74,0.689,60,52,112,47,36,7,58,74
3077,2,1994,23,1,3,43,5,623,111,274,0.405,4,16,0.25,107,258,0.415,0.412,59,87,0.678,43,75,118,48,31,8,51,84
3077,4,1996,25,1,3,62,48,1601,272,655,0.415,21,100,0.21,251,555,0.452,0.431,147,184,0.799,76,164,240,116,84,28,113,150
3077,6,1998,27,1,3,77,10,1641,216,505,0.428,9,41,0.22,207,464,0.446,0.437,150,182,0.824,48,171,219,100,65,20,79,156
3077,7,1999,28,1,3,31,7,731,95,231,0.411,6,23,0.261,89,208,0.428,0.424,55,61,0.902,23,69,92,36,30,5,33,68
3077,8,2000,29,1,3,82,61,2392,371,780,0.476,10,35,0.286,361,745,0.485,0.482,177,218,0.812,119,233,352,197,76,19,110,197
3087,3,2009,24,1,3,43,14,735,79,182,0.434,15,50,0.3,64,132,0.485,0.475,21,25,0.84,26,97,123,65,35,19,37,50
3087,3,2009,24,1,3,66,36,1453,152,357,0.426,24,87,0.276,128,270,0.474,0.459,61,73,0.836,54,188,242,111,75,45,64,104
3087,9,2015,30,1,3,9,3,202,20,53,0.377,1,13,0.077,19,40,0.475,0.387,13,17,0.765,9,33,42,15,9,8,8,19
3090,1,2002,25,1,3,9,0,142,22,44,0.5,0,0,-1,22,44,0.5,0.5,14,20,0.7,7,13,20,8,3,2,2,18
3090,2,2003,26,1,3,45,4,448,41,107,0.383,0,0,-1,41,107,0.383,0.383,12,21,0.571,34,39,73,23,14,5,25,62
3090,3,2004,27,1,3,57,2,583,81,178,0.455,6,21,0.286,75,157,0.478,0.472,32,46,0.696,43,49,92,19,19,20,23,66
3090,4,2005,28,1,3,16,0,128,17,42,0.405,2,8,0.25,15,34,0.441,0.429,13,24,0.542,18,20,38,12,2,3,8,16
3109,1,1981,23,1,3,55,-1,586,100,219,0.457,0,1,0,100,218,0.459,0.457,35,58,0.603,59,79,138,27,18,5,61,128
3111,1,2014,22,1,3,17,0,137,11,24,0.458,0,6,0,11,18,0.611,0.458,3,8,0.375,4,10,14,12,2,1,11,16
3111,1,2014,22,1,3,26,0,154,13,28,0.464,0,6,0,13,22,0.591,0.464,3,8,0.375,4,12,16,14,3,1,12,18
3118,1,1980,22,1,3,62,-1,1636,461,916,0.503,0,6,0,461,910,0.507,0.503,134,165,0.812,119,197,316,123,63,9,122,186
3118,2,1981,23,1,3,79,-1,2309,549,1157,0.475,3,17,0.176,546,1140,0.479,0.476,168,205,0.82,151,240,391,249,78,19,143,244
3118,3,1982,24,1,3,76,8,1782,456,935,0.488,6,28,0.214,450,907,0.496,0.491,177,221,0.801,123,143,266,209,65,10,122,220
3118,4,1983,25,1,3,67,57,2397,589,1209,0.487,4,15,0.267,585,1194,0.49,0.489,255,308,0.828,145,209,354,228,94,14,194,242
3118,5,1984,26,1,3,79,76,2945,714,1509,0.473,22,72,0.306,692,1437,0.482,0.48,353,445,0.793,184,254,438,246,103,11,228,252
3118,6,1985,27,1,3,78,77,3081,819,1780,0.46,47,150,0.313,772,1630,0.474,0.473,501,613,0.817,157,241,398,234,116,27,241,255
3118,7,1986,28,1,3,64,63,2427,633,1313,0.482,15,49,0.306,618,1264,0.489,0.488,351,406,0.865,126,203,329,237,92,22,184,229
3118,8,1987,29,1,3,34,15,950,240,501,0.479,4,17,0.235,236,484,0.488,0.483,137,160,0.856,55,82,137,86,45,7,68,103
3118,10,1989,31,1,3,65,16,1157,198,480,0.413,9,33,0.273,189,447,0.423,0.422,77,89,0.865,65,114,179,107,44,13,70,116
3118,11,1990,32,1,3,82,24,2213,432,950,0.455,10,35,0.286,422,915,0.461,0.46,198,237,0.835,101,147,248,145,66,20,119,202
3143,1,1991,22,1,3,79,79,2978,549,1301,0.422,3,11,0.273,546,1290,0.423,0.423,320,435,0.736,193,504,697,315,113,85,230,249
3143,2,1992,23,1,3,78,78,2895,527,1162,0.454,1,5,0.2,526,1157,0.455,0.454,281,365,0.77,149,485,634,337,135,132,218,205
3143,3,1993,24,1,3,69,68,2502,468,1055,0.444,1,11,0.091,467,1044,0.447,0.444,298,364,0.819,156,339,495,312,95,38,196,197
3143,4,1994,25,1,3,75,74,2702,436,996,0.438,6,17,0.353,430,979,0.439,0.441,251,323,0.777,168,394,562,305,104,50,183,189
3143,5,1995,26,1,3,58,3,1064,131,312,0.42,6,16,0.375,125,296,0.422,0.429,59,84,0.702,61,135,196,89,28,23,70,118
3143,6,1996,27,1,3,54,5,810,86,217,0.396,19,51,0.373,67,166,0.404,0.44,55,75,0.733,41,104,145,83,31,20,51,85
3143,7,1997,28,1,3,41,0,521,45,136,0.331,7,30,0.233,38,106,0.358,0.357,42,48,0.875,30,74,104,57,8,13,34,63
3151,1,2013,24,1,3,82,74,2293,275,642,0.428,70,200,0.35,205,442,0.464,0.483,100,124,0.806,109,221,330,77,57,37,98,217
3151,2,2014,25,1,3,82,36,2337,269,602,0.447,94,246,0.382,175,356,0.492,0.525,152,184,0.826,116,187,303,75,61,38,79,211
3151,3,2015,26,1,3,10,3,239,21,53,0.396,12,30,0.4,9,23,0.391,0.509,7,8,0.875,6,18,24,6,4,4,8,24
3155,1,1985,22,1,3,43,0,304,39,94,0.415,0,2,0,39,92,0.424,0.415,13,25,0.52,24,36,60,26,7,6,19,50
3156,1,2012,22,1,3,66,51,1431,116,312,0.372,44,127,0.346,72,185,0.389,0.442,30,44,0.682,43,190,233,49,70,30,38,176
3156,3,2014,24,1,3,25,0,250,25,67,0.373,7,19,0.368,18,48,0.375,0.425,18,25,0.72,18,37,55,6,9,3,17,25
3174,1,1980,33,1,3,70,-1,1988,352,819,0.43,22,76,0.289,330,743,0.444,0.443,93,107,0.869,92,153,245,93,59,15,72,188
3174,1,1980,33,1,3,78,-1,2123,385,891,0.432,23,81,0.284,362,810,0.447,0.445,100,115,0.87,94,165,259,100,62,17,81,209
3177,3,1991,25,1,3,74,74,2703,548,1168,0.469,0,7,0,548,1161,0.472,0.469,384,484,0.793,216,392,608,134,81,145,165,267
3177,4,1992,26,1,3,49,25,1310,251,539,0.466,0,6,0,251,533,0.471,0.466,212,270,0.785,95,206,301,56,41,98,69,159
3177,5,1993,27,1,3,81,68,2172,358,764,0.469,0,2,0,358,762,0.47,0.469,287,367,0.782,170,262,432,142,48,96,155,254
3177,6,1994,28,1,3,43,21,1105,176,397,0.443,8,16,0.5,168,381,0.441,0.453,87,121,0.719,66,99,165,50,26,45,64,144
3177,7,1995,29,1,3,76,58,2150,352,747,0.471,7,31,0.226,345,716,0.482,0.476,255,322,0.792,144,180,324,120,49,95,147,286
3182,1,1983,21,1,3,27,0,154,21,51,0.412,0,2,0,21,49,0.429,0.412,17,25,0.68,10,28,38,2,0,4,11,40
3182,8,1990,28,1,3,75,7,1405,261,514,0.508,16,36,0.444,245,478,0.513,0.523,130,186,0.699,62,110,172,109,35,20,85,198
3190,7,2011,25,1,3,79,6,1968,341,784,0.435,124,318,0.39,217,466,0.466,0.514,163,221,0.738,45,277,322,175,92,16,100,173
3190,10,2014,28,1,3,74,37,2421,396,955,0.415,189,480,0.394,207,475,0.436,0.514,90,138,0.652,35,261,296,219,65,20,108,196
3199,1,2005,19,1,3,74,59,2050,274,602,0.455,4,23,0.174,270,579,0.466,0.458,163,237,0.688,147,310,457,127,59,144,135,157
3199,2,2006,20,1,3,80,73,2559,329,774,0.425,34,110,0.309,295,664,0.444,0.447,210,292,0.719,176,355,531,191,64,208,162,260
3199,3,2007,21,1,3,72,72,2647,436,993,0.439,38,152,0.25,398,841,0.473,0.458,268,387,0.693,165,456,621,236,101,207,227,241
3199,10,2014,28,1,3,77,76,2730,517,1233,0.419,70,265,0.264,447,968,0.462,0.448,160,301,0.532,102,418,520,252,105,110,199,197
3203,8,2003,27,1,3,54,21,1117,151,328,0.46,0,2,0,151,326,0.463,0.46,102,131,0.779,111,159,270,38,14,55,43,171
3204,6,2000,27,1,3,46,46,1145,108,192,0.563,0,1,0,108,191,0.565,0.563,73,101,0.723,121,210,331,56,27,23,45,127
3205,1,2001,24,1,3,17,0,180,19,59,0.322,3,18,0.167,16,41,0.39,0.347,10,16,0.625,10,12,22,10,5,3,7,8
3207,4,1990,26,1,3,65,35,1644,348,708,0.492,10,40,0.25,338,668,0.506,0.499,169,222,0.761,117,183,300,147,76,57,102,174
3207,5,1991,27,1,3,75,39,1885,407,902,0.451,9,46,0.196,398,856,0.465,0.456,221,301,0.734,176,213,389,169,85,35,140,190
3213,1,1980,25,1,3,30,-1,496,97,230,0.422,8,35,0.229,89,195,0.456,0.439,57,63,0.905,22,32,54,42,25,7,33,54
3217,1,2004,23,1,3,20,0,178,16,43,0.372,6,12,0.5,10,31,0.323,0.442,6,8,0.75,13,28,41,7,5,5,14,18
3217,2,2005,24,1,3,33,5,510,44,136,0.324,3,12,0.25,41,124,0.331,0.335,14,16,0.875,39,77,116,28,6,4,27,58
3226,3,2007,23,1,3,39,1,563,66,146,0.452,11,44,0.25,55,102,0.539,0.49,49,75,0.653,17,66,83,39,11,12,26,51
3226,4,2008,24,1,3,27,18,680,83,161,0.516,3,14,0.214,80,147,0.544,0.525,58,77,0.753,25,89,114,56,19,14,48,49
3226,4,2008,24,1,3,36,18,761,96,189,0.508,5,23,0.217,91,166,0.548,0.521,64,88,0.727,30,96,126,64,20,15,52,55
3236,2,1981,23,1,3,82,-1,2317,404,866,0.467,1,10,0.1,403,856,0.471,0.467,375,423,0.887,142,155,297,232,117,20,172,230
3245,1,1993,28,1,3,17,1,407,73,160,0.456,0,2,0,73,158,0.462,0.456,41,54,0.759,38,42,80,24,15,7,24,61
3245,1,1993,28,1,3,20,1,422,73,163,0.448,0,2,0,73,161,0.453,0.448,41,54,0.759,38,43,81,24,17,7,26,64
3245,2,1994,29,1,3,23,0,286,43,100,0.43,0,0,-1,43,100,0.43,0.43,52,73,0.712,26,35,61,19,18,5,19,37
3245,2,1994,29,1,3,28,1,349,52,118,0.441,0,0,-1,52,118,0.441,0.441,55,77,0.714,30,43,73,22,19,7,21,43
3256,7,1999,28,1,3,37,4,1233,215,518,0.415,21,77,0.273,194,441,0.44,0.435,155,191,0.812,41,115,156,91,46,2,79,65
3256,8,2000,29,1,3,82,82,3276,568,1305,0.435,44,127,0.346,524,1178,0.445,0.452,344,397,0.866,49,300,349,332,109,22,226,184
3256,9,2001,30,1,3,77,77,3017,524,1219,0.43,41,135,0.304,483,1084,0.446,0.447,275,351,0.783,49,298,347,269,106,28,218,159
3256,10,2002,31,1,3,81,81,3326,573,1419,0.404,145,403,0.36,428,1016,0.421,0.455,284,346,0.821,59,239,298,313,94,14,223,161
3256,11,2003,32,1,3,74,73,2859,454,1127,0.403,134,360,0.372,320,767,0.417,0.462,173,218,0.794,45,240,285,332,102,22,172,134
3256,12,2004,33,1,3,82,82,3100,518,1266,0.409,99,299,0.331,419,967,0.433,0.448,240,295,0.814,56,254,310,286,88,21,158,101
3256,13,2005,34,1,3,80,79,2450,398,961,0.414,69,211,0.327,329,750,0.439,0.45,156,188,0.83,65,189,254,179,53,21,127,124
3257,1,1984,24,1,3,38,0,363,44,82,0.537,0,2,0,44,80,0.55,0.537,36,50,0.72,16,45,61,30,12,4,34,55
3257,3,1986,26,1,3,43,7,471,88,192,0.458,0,1,0,88,191,0.461,0.458,38,49,0.776,28,53,81,49,18,9,54,78
3258,7,2002,27,1,3,76,76,2685,524,1319,0.397,86,300,0.287,438,1019,0.43,0.43,495,577,0.858,77,238,315,403,77,37,266,163
3258,9,2004,29,1,3,26,17,774,128,321,0.399,23,65,0.354,105,256,0.41,0.435,83,103,0.806,16,78,94,103,24,3,88,49
3258,12,2007,32,1,3,67,8,1615,280,654,0.428,62,162,0.383,218,492,0.443,0.476,182,215,0.847,39,106,145,187,51,10,117,78
3258,16,2012,37,1,3,30,0,273,37,100,0.37,13,38,0.342,24,62,0.387,0.435,21,23,0.913,6,17,23,14,10,3,13,12
3258,17,2013,38,1,3,37,0,544,66,172,0.384,30,89,0.337,36,83,0.434,0.471,20,23,0.87,5,28,33,35,7,4,24,31
3263,1,1980,30,1,3,16,-1,446,62,146,0.425,0,4,0,62,142,0.437,0.425,22,27,0.815,13,32,45,67,25,1,33,53
3271,4,2004,22,1,3,26,24,933,115,285,0.404,12,41,0.293,103,244,0.422,0.425,49,71,0.69,36,84,120,66,24,1,40,54
3271,12,2012,30,1,3,51,30,960,49,172,0.285,41,145,0.283,8,27,0.296,0.404,9,16,0.563,7,94,101,41,19,4,19,59
3289,1,1999,21,1,3,48,1,1025,141,373,0.378,57,178,0.32,84,195,0.431,0.454,63,74,0.851,43,100,143,72,41,7,53,43
3289,2,2000,22,1,3,74,11,1749,321,717,0.448,100,267,0.375,221,450,0.491,0.517,135,153,0.882,74,202,276,106,52,7,88,97
3289,3,2001,23,1,3,75,75,2905,559,1189,0.47,144,360,0.4,415,829,0.501,0.531,267,312,0.856,93,341,434,164,91,13,146,144
3289,4,2002,24,1,3,71,71,2649,547,1130,0.484,129,310,0.416,418,820,0.51,0.541,283,323,0.876,72,301,373,175,81,14,140,120
3289,5,2003,25,1,3,72,72,2450,497,1034,0.481,155,406,0.382,342,628,0.545,0.556,231,264,0.875,61,336,397,141,72,5,101,143
3289,6,2004,26,1,3,81,81,3264,665,1386,0.48,240,554,0.433,425,832,0.511,0.566,394,425,0.927,91,417,508,173,108,14,153,159
3289,7,2005,27,1,3,66,66,2534,451,1016,0.444,174,433,0.402,277,583,0.475,0.53,253,275,0.92,62,223,285,138,79,12,102,157
3289,8,2006,28,1,3,31,31,1147,171,424,0.403,71,179,0.397,100,245,0.408,0.487,98,105,0.933,34,131,165,68,19,2,51,82
3289,8,2006,28,1,3,40,40,1454,274,594,0.461,91,225,0.404,183,369,0.496,0.538,140,155,0.903,45,205,250,68,26,8,52,89
3289,8,2006,28,1,3,71,71,2601,445,1018,0.437,162,404,0.401,283,614,0.461,0.517,238,260,0.915,79,336,415,136,45,10,103,171
3289,9,2007,29,1,3,13,13,425,83,196,0.423,34,84,0.405,49,112,0.438,0.51,31,38,0.816,11,43,54,11,8,4,19,29
3289,10,2008,30,1,3,77,77,2711,451,1026,0.44,231,524,0.441,220,502,0.438,0.552,130,140,0.929,64,267,331,96,57,10,61,127
3289,11,2009,31,1,3,61,59,2089,287,719,0.399,145,384,0.378,142,335,0.424,0.5,93,104,0.894,44,220,264,75,52,3,51,101
3289,12,2010,32,1,3,62,55,1947,278,688,0.404,132,352,0.375,146,336,0.435,0.5,96,107,0.897,39,188,227,92,48,5,56,83
3289,13,2011,33,1,3,25,13,506,79,184,0.429,42,105,0.4,37,79,0.468,0.543,15,16,0.938,14,52,66,22,11,2,11,22
3289,13,2011,33,1,3,33,13,617,100,227,0.441,57,136,0.419,43,91,0.473,0.566,23,25,0.92,14,61,75,29,13,2,17,24
3311,1,2010,22,1,3,44,0,405,46,130,0.354,15,42,0.357,31,88,0.352,0.412,27,38,0.711,14,31,45,16,8,7,16,52
3311,2,2011,23,1,3,22,1,199,28,69,0.406,9,21,0.429,19,48,0.396,0.471,9,20,0.45,2,10,12,2,3,1,13,21
3311,3,2012,24,1,3,15,6,209,28,65,0.431,5,16,0.313,23,49,0.469,0.469,7,9,0.778,8,15,23,10,7,0,8,31
3331,1,2000,22,1,3,73,53,2171,342,669,0.511,28,78,0.359,314,591,0.531,0.532,133,161,0.826,89,183,272,201,58,23,83,175
3331,2,2001,23,1,3,82,82,2856,469,920,0.51,26,77,0.338,443,843,0.526,0.524,181,208,0.87,133,314,447,260,59,33,138,226
3331,3,2002,24,1,3,82,82,3117,609,1200,0.508,87,191,0.455,522,1009,0.517,0.544,226,272,0.831,120,271,391,257,66,21,181,188
3331,4,2003,25,1,3,52,42,1836,351,729,0.481,61,145,0.421,290,584,0.497,0.523,150,173,0.867,53,188,241,136,44,22,87,123
3331,5,2004,26,1,3,28,0,622,106,236,0.449,20,46,0.435,86,190,0.453,0.492,53,64,0.828,24,64,88,33,12,1,28,42
3331,6,2005,27,1,3,81,37,2558,465,919,0.506,63,169,0.373,402,750,0.536,0.54,260,304,0.855,82,221,303,191,40,16,132,178
3331,7,2006,28,1,3,32,31,1174,201,422,0.476,44,112,0.393,157,310,0.506,0.528,115,128,0.898,41,82,123,101,19,4,50,60
3331,7,2006,28,1,3,40,40,1555,292,590,0.495,58,143,0.406,234,447,0.523,0.544,163,182,0.896,36,154,190,112,21,15,86,90
3331,7,2006,28,1,3,72,71,2729,493,1012,0.487,102,255,0.4,391,757,0.517,0.538,278,310,0.897,77,236,313,213,40,19,136,150
3331,8,2007,29,1,3,32,19,900,161,388,0.415,44,106,0.415,117,282,0.415,0.472,113,126,0.897,16,82,98,55,18,3,54,65
3331,9,2008,30,1,3,25,1,556,75,209,0.359,19,52,0.365,56,157,0.357,0.404,36,41,0.878,18,63,81,35,9,7,20,36
3331,9,2008,30,1,3,50,1,1180,236,513,0.46,71,166,0.428,165,347,0.476,0.529,113,134,0.843,16,120,136,69,14,5,56,67
3331,9,2008,30,1,3,75,2,1736,311,722,0.431,90,218,0.413,221,504,0.438,0.493,149,175,0.851,34,183,217,104,23,12,76,103
3331,10,2009,31,1,3,74,5,1527,179,398,0.45,69,168,0.411,110,230,0.478,0.536,90,106,0.849,43,189,232,82,28,10,55,130
3338,7,2008,27,1,3,65,41,1483,198,437,0.453,95,234,0.406,103,203,0.507,0.562,52,65,0.8,56,159,215,123,46,12,73,147
3338,8,2009,28,1,3,32,3,674,101,252,0.401,45,126,0.357,56,126,0.444,0.49,20,31,0.645,27,78,105,43,18,8,51,60
3338,8,2009,28,1,3,46,28,771,95,214,0.444,60,136,0.441,35,78,0.449,0.584,23,27,0.852,18,99,117,38,28,7,47,51
3338,8,2009,28,1,3,78,31,1445,196,466,0.421,105,262,0.401,91,204,0.446,0.533,43,58,0.741,45,177,222,81,46,15,98,111
3338,11,2012,31,1,3,49,3,755,74,197,0.376,50,135,0.37,24,62,0.387,0.503,22,29,0.759,34,109,143,54,21,15,35,62
3346,1,1982,25,1,3,49,15,637,77,177,0.435,0,2,0,77,175,0.44,0.435,38,64,0.594,37,43,80,40,18,2,25,74
3346,2,1983,26,1,3,34,1,292,33,83,0.398,0,1,0,33,82,0.402,0.398,29,43,0.674,25,19,44,22,10,1,25,35
3354,1,1981,22,1,3,25,-1,153,21,57,0.368,0,0,-1,21,57,0.368,0.368,13,28,0.464,17,13,30,17,7,1,26,33
3364,1,1984,23,1,3,28,3,196,21,58,0.362,0,0,-1,21,58,0.362,0.362,6,10,0.6,9,24,33,29,9,2,19,31
3375,6,2007,27,1,3,53,53,2036,477,1025,0.465,117,306,0.382,360,719,0.501,0.522,345,416,0.829,42,154,196,124,63,9,122,78
3380,1,2005,23,1,3,23,0,121,15,29,0.517,0,3,0,15,26,0.577,0.517,11,15,0.733,8,8,16,10,3,1,5,12
3380,2,2006,24,1,3,32,0,291,25,74,0.338,0,0,-1,25,74,0.338,0.338,25,40,0.625,13,16,29,7,5,4,15,45
3380,2,2006,24,1,3,40,6,706,94,221,0.425,0,1,0,94,220,0.427,0.425,62,80,0.775,40,55,95,34,18,11,37,118
3380,2,2006,24,1,3,72,6,997,119,295,0.403,0,1,0,119,294,0.405,0.403,87,120,0.725,53,71,124,41,23,15,52,163
3396,1,1980,28,1,3,82,-1,1966,369,727,0.508,5,29,0.172,364,698,0.521,0.511,131,161,0.814,142,244,386,189,54,12,129,186
3396,2,1981,29,1,3,64,-1,999,192,369,0.52,3,8,0.375,189,361,0.524,0.524,62,88,0.705,71,103,174,81,16,14,68,103
3402,1,1998,24,1,3,58,13,1070,112,305,0.367,2,8,0.25,110,297,0.37,0.37,111,180,0.617,28,42,70,110,62,10,97,125
3404,1,1990,22,1,3,77,60,2311,470,1071,0.439,17,69,0.246,453,1002,0.452,0.447,91,124,0.734,100,252,352,138,67,27,113,198
3404,2,1991,23,1,3,77,77,2646,550,1193,0.461,71,184,0.386,479,1009,0.475,0.491,171,209,0.818,85,296,381,189,101,26,166,216
3404,3,1992,24,1,3,79,79,3007,672,1432,0.469,155,396,0.391,517,1036,0.499,0.523,266,318,0.836,84,310,394,184,90,35,145,170
3404,4,1993,25,1,3,82,82,3082,582,1324,0.44,148,386,0.383,434,938,0.463,0.495,242,295,0.82,92,332,424,180,92,25,157,201
3404,5,1994,26,1,3,81,81,2999,663,1421,0.467,132,346,0.382,531,1075,0.494,0.513,250,284,0.88,76,358,434,184,110,32,130,186
3404,6,1995,27,1,3,82,82,3014,667,1403,0.475,185,451,0.41,482,952,0.506,0.541,312,365,0.855,99,279,378,192,112,14,153,203
3404,7,1996,28,1,3,79,79,3142,610,1296,0.471,171,403,0.424,439,893,0.492,0.537,319,381,0.837,86,292,378,232,91,19,163,217
3404,8,1997,29,1,3,79,78,3362,722,1513,0.477,207,440,0.47,515,1073,0.48,0.546,464,535,0.867,67,251,318,160,72,26,177,190
3404,9,1998,30,1,3,82,82,3295,634,1386,0.457,130,300,0.433,504,1086,0.464,0.504,428,504,0.849,89,264,353,182,77,22,182,200
3404,10,1999,31,1,3,27,25,985,171,396,0.432,53,135,0.393,118,261,0.452,0.499,77,90,0.856,9,90,99,71,17,6,45,67
3404,11,2000,32,1,3,80,80,2530,421,980,0.43,84,229,0.367,337,751,0.449,0.472,346,396,0.874,56,271,327,176,47,12,114,179
3404,12,2001,33,1,3,75,25,2212,331,752,0.44,82,211,0.389,249,541,0.46,0.495,155,182,0.852,61,246,307,89,41,13,96,179
3404,13,2002,34,1,3,20,20,606,65,167,0.389,18,64,0.281,47,103,0.456,0.443,24,30,0.8,5,42,47,31,12,3,24,34
3404,14,2003,35,1,3,62,26,1532,196,457,0.429,101,254,0.398,95,203,0.468,0.539,63,83,0.759,28,126,154,65,23,5,55,99
3404,15,2004,36,1,3,18,0,262,22,76,0.289,5,28,0.179,17,48,0.354,0.322,17,17,1,9,32,41,24,6,0,13,22
3406,7,2008,27,1,3,82,82,3149,648,1468,0.441,243,599,0.406,405,869,0.466,0.524,249,331,0.752,80,361,441,258,116,57,166,241
3418,6,2006,25,1,3,55,43,1442,163,459,0.355,64,188,0.34,99,271,0.365,0.425,61,91,0.67,65,165,230,88,39,6,56,134
3418,7,2007,26,1,3,49,47,1621,228,545,0.418,97,258,0.376,131,287,0.456,0.507,83,120,0.692,65,287,352,108,36,7,70,133
3418,8,2008,27,1,3,65,65,1841,199,555,0.359,69,214,0.322,130,341,0.381,0.421,60,88,0.682,56,259,315,116,44,15,69,153
3418,10,2010,29,1,3,76,75,2082,242,561,0.431,142,358,0.397,100,203,0.493,0.558,52,71,0.732,64,310,374,93,70,18,62,169
3418,11,2011,30,1,3,57,19,955,87,255,0.341,42,146,0.288,45,109,0.413,0.424,33,44,0.75,39,139,178,38,25,5,33,74
3418,12,2012,31,1,3,48,3,866,74,197,0.376,42,121,0.347,32,76,0.421,0.482,25,30,0.833,15,108,123,38,28,6,29,74
3445,2,2006,25,1,3,66,18,1303,157,365,0.43,2,21,0.095,155,344,0.451,0.433,106,134,0.791,62,157,219,77,81,10,74,141
3448,1,2000,23,1,3,67,8,1112,212,386,0.549,0,4,0,212,382,0.555,0.549,47,64,0.734,54,130,184,32,48,25,39,67
3448,2,2001,24,1,3,67,6,1201,216,407,0.531,2,4,0.5,214,403,0.531,0.533,64,88,0.727,60,138,198,59,50,32,43,66
3448,3,2002,25,1,3,29,12,653,112,247,0.453,2,5,0.4,110,242,0.455,0.457,36,48,0.75,24,54,78,37,23,11,36,35
3448,4,2003,26,1,3,64,18,1355,155,315,0.492,3,14,0.214,152,301,0.505,0.497,51,63,0.81,76,124,200,66,62,13,52,120
3448,5,2004,27,1,3,51,4,1024,157,326,0.482,1,5,0.2,156,321,0.486,0.483,28,43,0.651,27,77,104,58,33,10,45,57
3451,1,1995,22,1,3,80,76,2958,636,1410,0.451,86,268,0.321,550,1142,0.482,0.482,397,499,0.796,169,344,513,197,115,22,313,234
3451,2,1996,23,1,3,82,82,3249,627,1382,0.454,90,263,0.342,537,1119,0.48,0.486,316,389,0.812,136,368,504,293,95,42,282,236
3451,3,1997,24,1,3,80,79,3114,669,1438,0.465,63,180,0.35,606,1258,0.482,0.487,288,364,0.791,130,372,502,248,103,68,269,225
3451,4,1998,25,1,3,56,56,2294,534,1136,0.47,25,65,0.385,509,1071,0.475,0.481,215,266,0.808,82,225,307,158,69,34,200,164
3451,5,1999,26,1,3,47,47,1579,347,756,0.459,31,79,0.392,316,677,0.467,0.479,140,161,0.87,73,203,276,100,46,41,106,114
3451,6,2000,27,1,3,81,81,2909,690,1461,0.472,86,237,0.363,604,1224,0.493,0.502,227,283,0.802,107,378,485,193,78,41,223,212
3451,7,2001,28,1,3,76,74,2813,684,1460,0.468,55,184,0.299,629,1276,0.493,0.487,251,306,0.82,124,402,526,252,86,62,219,191
3451,8,2002,29,1,3,66,63,2346,536,1147,0.467,58,178,0.326,478,969,0.493,0.493,236,282,0.837,70,336,406,168,97,41,174,173
3451,9,2003,30,1,3,69,68,2591,539,1248,0.432,90,263,0.342,449,985,0.456,0.468,268,306,0.876,86,371,457,205,91,26,248,183
3451,10,2004,31,1,3,42,42,1336,275,614,0.448,34,100,0.34,241,514,0.469,0.476,114,137,0.832,46,143,189,57,42,9,106,96
3451,11,2005,32,1,3,9,0,157,34,77,0.442,2,6,0.333,32,71,0.451,0.455,20,23,0.87,4,20,24,8,4,3,7,19
3452,3,1992,25,1,3,82,7,2124,398,854,0.466,1,11,0.091,397,843,0.471,0.467,219,330,0.664,140,276,416,137,85,107,154,274
3452,6,1995,28,1,3,75,73,2725,597,1320,0.452,142,383,0.371,455,937,0.486,0.506,265,382,0.694,152,271,423,198,79,82,158,240
3452,7,1996,29,1,3,78,76,2980,553,1306,0.423,178,471,0.378,375,835,0.449,0.492,360,542,0.664,123,320,443,190,86,68,194,248
3452,8,1997,30,1,3,81,79,3077,444,1043,0.426,121,350,0.346,323,693,0.466,0.484,215,309,0.696,90,231,321,261,99,66,172,251
3452,9,1998,31,1,3,80,64,2359,429,895,0.479,27,84,0.321,402,811,0.496,0.494,248,360,0.689,152,258,410,170,92,90,140,249
3452,10,1999,32,1,3,50,35,1740,299,629,0.475,58,139,0.417,241,490,0.492,0.521,163,234,0.697,69,158,227,128,75,59,88,153
3452,11,2000,33,1,3,80,67,2839,530,1142,0.464,120,324,0.37,410,818,0.501,0.517,298,381,0.782,105,254,359,224,90,61,166,239
3470,1,1996,23,1,3,49,2,372,32,90,0.356,2,9,0.222,30,81,0.37,0.367,24,32,0.75,30,48,78,15,10,8,17,42
3470,2,1997,24,1,3,17,0,107,14,48,0.292,3,11,0.273,11,37,0.297,0.323,9,19,0.474,7,7,14,6,3,1,11,10
3478,1,1994,22,1,3,79,14,1406,239,545,0.439,35,92,0.38,204,453,0.45,0.471,127,189,0.672,90,136,226,101,63,48,131,195
3478,3,1996,24,1,3,67,51,1950,306,641,0.477,49,153,0.32,257,488,0.527,0.516,113,180,0.628,113,173,286,167,75,35,144,216
3478,4,1997,25,1,3,81,62,2480,408,884,0.462,65,180,0.361,343,704,0.487,0.498,191,288,0.663,137,274,411,222,88,61,221,272
3478,5,1998,26,1,3,76,70,2499,426,935,0.456,72,212,0.34,354,723,0.49,0.494,225,328,0.686,155,269,424,202,93,38,193,242
3478,6,1999,27,1,3,47,7,968,131,297,0.441,18,63,0.286,113,234,0.483,0.471,68,101,0.673,65,114,179,77,47,22,66,140
3478,8,2001,29,1,3,82,3,2183,377,876,0.43,56,189,0.296,321,687,0.467,0.462,188,247,0.761,94,265,359,180,97,47,157,269
3478,9,2002,30,1,3,27,1,626,107,222,0.482,39,95,0.411,68,127,0.535,0.57,35,50,0.7,34,73,107,40,16,12,42,78
3478,9,2002,30,1,3,50,7,1254,249,534,0.466,49,140,0.35,200,394,0.508,0.512,82,99,0.828,95,146,241,72,50,17,66,148
3478,9,2002,30,1,3,77,8,1880,356,756,0.471,88,235,0.374,268,521,0.514,0.529,117,149,0.785,129,219,348,112,66,29,108,226
3478,12,2005,33,1,3,30,26,882,109,289,0.377,25,92,0.272,84,197,0.426,0.42,32,42,0.762,28,114,142,60,19,12,66,103
3478,12,2005,33,1,3,58,33,1367,172,450,0.382,48,168,0.286,124,282,0.44,0.436,52,70,0.743,61,185,246,86,41,20,86,172
3484,1,1995,22,1,3,81,37,1798,227,500,0.454,36,114,0.316,191,386,0.495,0.49,173,234,0.739,57,160,217,389,65,22,160,206
3484,3,1997,24,1,3,66,6,1188,172,377,0.456,21,72,0.292,151,305,0.495,0.484,117,156,0.75,27,94,121,155,57,18,107,136
3484,4,1998,25,1,3,82,0,1706,290,607,0.478,25,73,0.342,265,534,0.496,0.498,166,228,0.728,28,167,195,155,56,14,132,171
3484,5,1999,26,1,3,49,1,1238,200,496,0.403,17,65,0.262,183,431,0.425,0.42,125,158,0.791,34,120,154,93,50,15,72,128
3484,6,2000,27,1,3,80,80,2978,563,1196,0.471,77,196,0.393,486,1000,0.486,0.503,254,307,0.827,42,345,387,320,84,49,188,234
3484,7,2001,28,1,3,72,72,2943,567,1242,0.457,59,174,0.339,508,1068,0.476,0.48,285,344,0.828,37,322,359,435,65,43,211,230
3484,8,2002,29,1,3,30,30,1216,276,587,0.47,37,100,0.37,239,487,0.491,0.502,125,149,0.839,14,110,124,158,33,16,96,103
3484,8,2002,29,1,3,53,53,1937,387,871,0.444,52,146,0.356,335,725,0.462,0.474,156,186,0.839,29,220,249,197,45,29,105,148
3484,8,2002,29,1,3,83,83,3153,663,1458,0.455,89,246,0.362,574,1212,0.474,0.485,281,335,0.839,43,330,373,355,78,45,201,251
3484,9,2003,30,1,3,82,82,3351,642,1583,0.406,133,359,0.37,509,1224,0.416,0.448,399,467,0.854,68,283,351,395,72,23,285,271
3484,10,2004,31,1,3,16,14,529,75,200,0.375,23,54,0.426,52,146,0.356,0.433,39,51,0.765,7,57,64,56,12,4,37,45
3484,11,2005,32,1,3,81,65,2710,527,1159,0.455,108,274,0.394,419,885,0.473,0.501,333,390,0.854,44,232,276,209,63,10,180,190
3484,12,2006,33,1,3,46,22,1236,180,446,0.404,31,115,0.27,149,331,0.45,0.438,166,217,0.765,15,114,129,113,20,10,65,101
3484,12,2006,33,1,3,72,45,1983,290,685,0.423,59,172,0.343,231,513,0.45,0.466,248,318,0.78,28,183,211,181,30,13,115,156
3484,13,2007,34,1,3,29,0,246,38,86,0.442,21,47,0.447,17,39,0.436,0.564,11,12,0.917,3,20,23,16,5,2,9,22
3485,13,2009,34,1,3,20,0,310,34,90,0.378,0,3,0,34,87,0.391,0.378,32,40,0.8,13,52,65,26,9,2,19,48
3485,13,2009,34,1,3,38,0,470,45,131,0.344,0,7,0,45,124,0.363,0.344,40,51,0.784,17,79,96,36,10,3,36,72
3493,5,2009,27,1,3,68,7,1164,99,259,0.382,33,88,0.375,66,171,0.386,0.446,34,42,0.81,29,97,126,47,32,14,36,114
3493,6,2010,28,1,3,27,7,301,23,56,0.411,3,13,0.231,20,43,0.465,0.438,5,8,0.625,11,16,27,7,7,4,3,34
3493,6,2010,28,1,3,52,7,562,40,111,0.36,4,21,0.19,36,90,0.4,0.378,8,14,0.571,17,32,49,12,13,6,11,69
3493,7,2011,29,1,3,36,4,353,26,59,0.441,0,3,0,26,56,0.464,0.441,5,14,0.357,10,20,30,10,3,6,7,40
3494,1,1988,24,1,3,26,0,201,30,74,0.405,2,11,0.182,28,63,0.444,0.419,22,30,0.733,7,21,28,16,12,0,11,37
3494,2,1989,25,1,3,47,3,464,52,143,0.364,2,10,0.2,50,133,0.376,0.371,52,76,0.684,20,36,56,48,19,4,33,55
3494,2,1989,25,1,3,63,3,536,59,167,0.353,3,16,0.188,56,151,0.371,0.362,60,87,0.69,20,44,64,55,24,5,40,69
3494,3,1990,26,1,3,71,3,1061,159,420,0.379,18,52,0.346,141,368,0.383,0.4,150,201,0.746,34,78,112,115,51,6,85,144
3495,3,2015,23,1,3,10,10,265,39,89,0.438,20,48,0.417,19,41,0.463,0.551,10,11,0.909,4,26,30,12,7,6,10,20
3516,1,1994,23,1,3,67,48,1121,135,279,0.484,2,22,0.091,133,257,0.518,0.487,62,101,0.614,61,120,181,54,68,19,55,138
3516,2,1995,24,1,3,63,15,860,104,238,0.437,13,44,0.295,91,194,0.469,0.464,62,93,0.667,44,97,141,34,48,11,42,101
3516,3,1996,25,1,3,59,9,577,56,142,0.394,14,40,0.35,42,102,0.412,0.444,48,67,0.716,28,62,90,29,29,8,36,66
3516,4,1997,26,1,3,81,81,2525,297,620,0.479,108,264,0.409,189,356,0.531,0.566,171,244,0.701,79,252,331,123,129,27,94,237
3516,5,1998,27,1,3,82,7,2219,226,525,0.43,73,214,0.341,153,311,0.492,0.5,213,278,0.766,78,248,326,101,90,31,81,229
3516,6,1999,28,1,3,50,50,1770,217,468,0.464,52,147,0.354,165,321,0.514,0.519,136,171,0.795,65,201,266,74,76,15,76,154
3516,7,2000,29,1,3,82,70,2900,408,914,0.446,106,268,0.396,302,646,0.467,0.504,237,316,0.75,99,328,427,158,128,23,101,255
3516,8,2001,30,1,3,78,46,2473,308,700,0.44,95,230,0.413,213,470,0.453,0.508,222,285,0.779,94,236,330,160,96,20,113,229
3516,10,2003,32,1,3,70,23,1388,108,306,0.353,46,140,0.329,62,166,0.373,0.428,53,69,0.768,43,165,208,72,70,7,55,130
3516,11,2004,33,1,3,72,1,945,98,244,0.402,43,112,0.384,55,132,0.417,0.49,50,65,0.769,32,114,146,71,32,12,37,110
3516,12,2005,34,1,3,70,2,1026,95,252,0.377,56,149,0.376,39,103,0.379,0.488,61,77,0.792,50,122,172,72,44,11,35,130
3518,4,2012,26,1,3,65,1,1717,235,469,0.501,99,219,0.452,136,250,0.544,0.607,65,82,0.793,33,218,251,88,35,58,68,64
3558,1,2010,24,1,3,80,1,1321,224,497,0.451,11,56,0.196,213,441,0.483,0.462,136,175,0.777,77,124,201,52,34,20,94,106
3558,2,2011,25,1,3,78,46,1577,233,494,0.472,17,50,0.34,216,444,0.486,0.489,89,116,0.767,40,147,187,71,68,23,61,120
3558,3,2012,26,1,3,14,0,135,13,44,0.295,5,8,0.625,8,36,0.222,0.352,9,14,0.643,6,15,21,6,6,4,7,11
3558,3,2012,26,1,3,21,2,240,32,83,0.386,0,9,0,32,74,0.432,0.386,10,12,0.833,14,27,41,9,11,2,9,12
3558,3,2012,26,1,3,35,2,375,45,127,0.354,5,17,0.294,40,110,0.364,0.374,19,26,0.731,20,42,62,15,17,6,16,23
