2,1,1996,22,1,4,57,0,545,71,162,0.438,0,1,0,71,161,0.441,40,68,0.588,51,60,111,24,12,7,48,91,182
2,2,1997,23,1,4,75,19,1405,205,385,0.532,0,1,0,205,384,0.534,139,211,0.659,135,166,301,89,25,9,97,149,549
2,3,1998,24,1,4,51,8,710,100,199,0.503,0,1,0,100,198,0.505,68,103,0.66,76,97,173,36,13,17,48,92,268
2,3,1998,24,1,4,29,6,713,126,267,0.472,0,1,0,126,266,0.474,63,97,0.649,84,87,171,31,12,3,57,89,315
2,3,1998,24,1,4,80,14,1423,226,466,0.485,0,2,0,226,464,0.487,131,200,0.655,160,184,344,67,25,20,105,181,583
2,4,1999,25,1,4,35,32,876,123,277,0.444,0,1,0,123,276,0.446,62,98,0.633,79,126,205,18,24,9,75,113,308
2,5,2000,26,1,4,71,56,2159,323,675,0.479,0,2,0,323,673,0.48,206,345,0.597,189,293,482,119,62,20,170,269,852
2,6,2001,27,1,4,70,33,1460,179,367,0.488,0,0,-1,179,367,0.488,142,211,0.673,135,218,353,53,38,25,77,184,500
2,7,2002,28,1,4,23,0,283,36,72,0.5,0,1,0,36,71,0.507,27,43,0.628,24,26,50,12,4,5,19,39,99
2,8,2003,29,1,4,51,16,894,113,248,0.456,0,0,-1,113,248,0.456,69,106,0.651,68,108,176,38,19,15,56,122,295
9,1,1991,24,1,2,64,0,678,75,192,0.391,0,2,0,75,190,0.395,55,79,0.696,25,53,78,61,22,7,51,98,205
11,1,1993,23,1,3,53,13,885,151,312,0.484,0,4,0,151,308,0.49,68,99,0.687,88,79,167,58,24,6,63,128,370
12,1,2004,22,1,4,49,4,570,81,197,0.411,6,32,0.188,75,165,0.455,35,53,0.66,26,73,99,40,10,13,54,75,203
12,2,2005,23,1,4,37,0,464,82,170,0.482,13,36,0.361,69,134,0.515,52,64,0.813,33,66,99,25,10,5,30,59,229
12,2,2005,23,1,4,40,0,475,86,177,0.486,13,36,0.361,73,141,0.518,53,65,0.815,35,67,102,25,10,5,30,59,238
12,3,2006,24,1,4,61,0,505,67,174,0.385,5,20,0.25,62,154,0.403,60,84,0.714,37,74,111,20,13,7,35,87,199
14,1,2011,22,1,5,41,0,215,32,66,0.485,0,0,-1,32,66,0.485,17,23,0.739,19,24,43,7,4,10,19,47,81
15,1,1997,22,1,5,63,38,1897,375,778,0.482,2,14,0.143,373,764,0.488,183,264,0.693,131,263,394,97,66,130,134,214,935
15,2,1998,23,1,5,63,58,2002,308,747,0.412,0,2,0,308,745,0.413,149,244,0.611,203,263,466,111,68,230,134,200,765
15,3,1999,24,1,5,46,0,945,136,261,0.521,0,0,-1,136,261,0.521,57,103,0.553,102,151,253,12,29,74,39,131,329
15,4,2000,25,1,5,59,11,1548,226,471,0.48,1,2,0.5,225,469,0.48,148,221,0.67,174,287,461,49,43,116,72,204,601
15,5,2001,26,1,5,63,63,2127,304,580,0.524,1,8,0.125,303,572,0.53,150,225,0.667,196,527,723,52,66,136,63,205,759
15,6,2002,27,1,5,29,29,1007,130,290,0.448,0,1,0,130,289,0.45,62,99,0.626,89,233,322,33,34,50,42,107,322
15,7,2003,28,1,5,29,9,616,93,227,0.41,2,5,0.4,91,222,0.41,33,50,0.66,75,133,208,47,20,40,27,69,221
15,8,2004,29,1,5,72,72,2162,262,549,0.477,0,2,0,262,547,0.479,98,136,0.721,211,516,727,132,86,187,98,239,622
15,9,2005,30,1,5,66,66,2015,279,600,0.465,0,4,0,279,596,0.468,125,173,0.723,131,530,661,152,61,199,103,177,683
15,10,2006,31,1,5,56,54,1857,302,649,0.465,1,11,0.091,301,638,0.472,111,156,0.712,132,536,668,115,79,184,92,158,716
15,11,2007,32,1,5,70,70,2369,312,659,0.473,0,2,0,312,657,0.475,161,221,0.729,164,652,816,223,87,231,122,183,785
15,12,2008,33,1,5,79,79,2758,286,635,0.45,6,20,0.3,280,615,0.455,143,202,0.708,230,807,1037,259,85,285,118,216,721
15,13,2009,34,1,5,62,55,1925,254,496,0.512,1,4,0.25,253,492,0.514,132,182,0.725,161,529,690,127,51,132,93,129,641
15,14,2010,35,1,5,23,23,718,72,145,0.497,0,1,0,72,144,0.5,18,31,0.581,83,172,255,35,26,47,27,56,162
15,14,2010,35,1,4,51,51,1596,166,356,0.466,2,6,0.333,164,350,0.469,60,91,0.659,166,450,616,151,69,99,64,105,394
15,14,2010,35,1,4,74,74,2314,238,501,0.475,2,7,0.286,236,494,0.478,78,122,0.639,249,622,871,186,95,146,91,161,556
15,15,2011,36,1,5,59,51,1540,117,294,0.398,0,1,0,117,293,0.399,43,70,0.614,182,424,606,121,40,92,62,140,277
15,16,2012,37,1,5,19,13,458,61,126,0.484,2,5,0.4,59,121,0.488,11,26,0.423,52,124,176,32,17,29,10,38,135
15,16,2012,37,1,5,40,40,894,67,161,0.416,0,0,-1,67,161,0.416,18,38,0.474,105,249,354,75,33,56,47,88,152
15,16,2012,37,1,5,59,53,1352,128,287,0.446,2,5,0.4,126,282,0.447,29,64,0.453,157,373,530,107,50,85,57,126,287
15,17,2013,38,1,4,24,4,250,17,53,0.321,0,0,-1,17,53,0.321,8,19,0.421,24,56,80,14,7,14,15,28,42
16,1,1991,22,1,4,52,0,380,56,123,0.455,0,0,-1,56,123,0.455,32,49,0.653,40,56,96,10,11,38,16,71,144
16,2,1992,23,1,5,81,47,1876,220,491,0.448,0,2,0,220,489,0.45,138,223,0.619,155,268,423,59,53,159,73,203,578
16,3,1993,24,1,4,79,13,1551,238,520,0.458,0,3,0,238,517,0.46,130,204,0.637,127,205,332,48,59,100,69,165,606
16,4,1994,25,1,4,76,74,2253,373,808,0.462,0,2,0,373,806,0.463,188,273,0.689,167,352,519,86,64,146,98,241,934
16,5,1995,26,1,4,73,59,2076,360,785,0.459,0,1,0,360,784,0.459,193,290,0.666,168,277,445,92,69,132,98,246,913
16,6,1996,27,1,4,82,82,2699,447,888,0.503,0,5,0,447,883,0.506,249,349,0.713,162,461,623,181,88,212,137,300,1143
16,7,1997,28,1,4,77,77,2516,442,942,0.469,1,4,0.25,441,938,0.47,263,370,0.711,207,408,615,126,46,117,130,276,1148
16,8,1998,29,1,4,81,28,1784,289,624,0.463,1,2,0.5,288,622,0.463,237,342,0.693,143,312,455,78,35,102,115,209,816
16,9,1999,30,1,5,17,1,325,44,101,0.436,0,0,-1,44,101,0.436,38,62,0.613,38,58,96,8,1,16,22,51,126
16,9,1999,30,1,5,32,32,1134,178,364,0.489,0,1,0,178,363,0.49,134,207,0.647,88,213,301,61,38,57,58,108,490
16,9,1999,30,1,5,49,33,1459,222,465,0.477,0,1,0,222,464,0.478,172,269,0.639,126,271,397,69,39,73,80,159,616
16,10,2000,31,1,5,78,77,2538,370,829,0.446,0,6,0,370,823,0.45,247,358,0.69,168,422,590,129,56,150,127,269,987
16,11,2001,32,1,4,78,78,2337,367,834,0.44,0,6,0,367,828,0.443,288,406,0.709,157,451,608,104,60,140,144,280,1022
16,12,2002,33,1,4,77,74,2156,384,794,0.484,0,2,0,384,792,0.485,306,384,0.797,133,397,530,102,60,137,138,264,1074
16,13,2003,34,1,5,15,0,184,16,48,0.333,0,0,-1,16,48,0.333,16,21,0.762,13,26,39,9,9,8,8,27,48
16,13,2003,34,1,5,41,1,685,101,247,0.409,0,1,0,101,246,0.411,93,115,0.809,34,108,142,42,24,31,42,102,295
16,13,2003,34,1,5,56,1,869,117,295,0.397,0,1,0,117,294,0.398,109,136,0.801,47,134,181,51,33,39,50,129,343
16,14,2004,35,1,5,65,27,892,138,314,0.439,0,0,-1,138,314,0.439,85,124,0.685,52,157,209,45,21,50,63,137,361
16,15,2005,36,1,5,30,1,340,39,116,0.336,0,2,0,39,114,0.342,40,51,0.784,25,57,82,16,8,6,28,47,118
16,15,2005,36,1,5,40,1,390,39,123,0.317,0,2,0,39,121,0.322,42,55,0.764,28,65,93,19,8,7,29,57,120
17,1,1985,22,1,3,56,0,625,130,262,0.496,0,1,0,130,261,0.498,56,70,0.8,41,48,89,24,28,3,69,107,316
17,2,1986,23,1,3,82,1,1292,294,608,0.484,2,9,0.222,292,599,0.487,58,73,0.795,83,153,236,45,62,7,86,164,648
17,3,1987,24,1,3,40,0,332,57,145,0.393,0,3,0,57,142,0.401,24,39,0.615,21,37,58,19,12,1,34,40,138
17,4,1988,25,1,3,13,1,242,57,101,0.564,1,3,0.333,56,98,0.571,28,39,0.718,8,19,27,15,11,2,26,41,143
17,5,1989,26,1,3,63,2,787,158,345,0.458,2,21,0.095,156,324,0.481,70,83,0.843,53,77,130,47,37,6,62,108,388
17,6,1990,27,1,2,82,81,3164,723,1581,0.457,9,54,0.167,714,1527,0.468,448,569,0.787,209,242,451,213,111,31,251,260,1903
17,7,1991,28,1,2,77,71,2893,652,1502,0.434,16,61,0.262,636,1441,0.441,358,446,0.803,161,185,346,214,121,48,190,204,1678
17,8,1992,29,1,3,78,41,2441,527,1137,0.464,13,37,0.351,514,1100,0.467,240,299,0.803,141,145,286,229,84,31,165,206,1307
17,9,1993,30,1,3,58,13,1062,194,396,0.49,2,5,0.4,192,391,0.491,59,87,0.678,59,96,155,62,34,5,51,150,449
17,10,1994,31,1,3,22,11,379,63,128,0.492,1,3,0.333,62,125,0.496,30,37,0.811,28,32,60,31,20,1,29,59,157
17,10,1994,31,1,3,41,3,835,164,384,0.427,6,25,0.24,158,359,0.44,64,83,0.771,48,78,126,51,30,14,55,75,398
17,10,1994,31,1,3,63,14,1214,227,512,0.443,7,28,0.25,220,484,0.455,94,120,0.783,76,110,186,82,50,15,84,134,555
17,11,1995,32,1,3,78,0,1128,161,392,0.411,15,42,0.357,146,350,0.417,132,159,0.83,60,93,153,69,32,8,65,122,469
19,1,2001,23,1,4,15,0,126,10,31,0.323,0,5,0,10,26,0.385,11,18,0.611,8,15,23,3,7,2,9,27,31
19,2,2004,26,1,4,76,11,1634,220,466,0.472,55,124,0.444,165,342,0.482,238,271,0.878,100,217,317,103,66,20,84,206,733
19,3,2005,27,1,4,58,16,1433,160,432,0.37,44,125,0.352,116,307,0.378,158,181,0.873,63,162,225,114,88,19,83,172,522
19,4,2006,28,1,4,36,0,402,46,111,0.414,13,29,0.448,33,82,0.402,19,27,0.704,11,44,55,33,23,0,27,65,124
19,5,2007,29,1,4,28,1,313,42,85,0.494,18,44,0.409,24,41,0.585,25,27,0.926,13,46,59,31,22,1,23,42,127
19,6,2008,30,1,4,37,1,440,43,126,0.341,25,81,0.309,18,45,0.4,13,19,0.684,26,70,96,22,10,2,23,62,124
19,7,2009,31,1,4,64,4,909,65,169,0.385,30,92,0.326,35,77,0.455,30,35,0.857,39,103,142,76,37,13,48,135,190
19,8,2010,32,1,4,29,0,267,14,36,0.389,3,9,0.333,11,27,0.407,17,18,0.944,7,22,29,24,9,3,7,56,48
19,9,2011,33,1,3,56,4,618,43,100,0.43,42,87,0.483,1,13,0.077,17,18,0.944,10,49,59,40,24,7,17,82,145
19,10,2012,34,1,3,44,0,277,14,55,0.255,10,49,0.204,4,6,0.667,5,6,0.833,4,30,34,16,8,2,8,38,43
27,1,1999,23,1,2,42,7,624,71,216,0.329,5,30,0.167,66,186,0.355,24,32,0.75,8,41,49,66,21,7,46,66,171
29,1,1985,23,1,4,62,15,1195,198,375,0.528,2,6,0.333,196,369,0.531,101,128,0.789,79,153,232,80,29,78,108,219,499
29,2,1986,24,1,4,17,0,258,49,93,0.527,0,0,-1,49,93,0.527,18,27,0.667,16,36,52,14,7,15,14,51,116
29,3,1987,25,1,4,65,2,695,134,265,0.506,1,3,0.333,133,262,0.508,73,103,0.709,60,96,156,34,14,48,40,146,342
29,4,1988,26,1,4,80,2,1483,281,517,0.544,1,4,0.25,280,513,0.546,142,182,0.78,94,195,289,103,38,83,116,272,705
29,5,1989,27,1,4,78,12,1488,226,471,0.48,0,1,0,226,470,0.481,130,152,0.855,106,168,274,91,31,62,82,221,582
29,6,1990,28,1,4,44,0,803,128,248,0.516,0,4,0,128,244,0.525,79,102,0.775,50,99,149,53,15,34,54,128,335
29,6,1990,28,1,4,33,4,924,228,473,0.482,0,3,0,228,470,0.485,158,196,0.806,65,108,173,66,15,34,71,119,614
29,6,1990,28,1,4,77,4,1727,356,721,0.494,0,7,0,356,714,0.499,237,298,0.795,115,207,322,119,30,68,125,247,949
29,7,1991,29,1,4,77,48,2527,628,1228,0.511,0,3,0,628,1225,0.513,295,389,0.758,163,257,420,191,45,101,171,315,1551
29,8,1992,30,1,4,81,27,1867,359,732,0.49,1,5,0.2,358,727,0.492,162,212,0.764,128,218,346,63,32,96,114,264,881
29,9,1993,31,1,4,71,46,1947,379,705,0.538,0,5,0,379,700,0.541,174,224,0.777,107,281,388,97,35,87,96,264,932
29,10,1994,32,1,4,34,0,465,78,160,0.488,0,1,0,78,159,0.491,42,58,0.724,12,39,51,15,9,22,15,75,198
29,11,1995,33,1,5,78,4,1677,290,546,0.531,1,4,0.25,289,542,0.533,165,201,0.821,81,184,265,67,24,68,87,253,746
29,12,1996,34,1,3,80,0,1532,233,510,0.457,0,3,0,233,507,0.46,114,144,0.792,71,129,200,74,28,65,78,254,580
29,13,1997,35,1,4,82,0,1460,252,522,0.483,0,3,0,252,519,0.486,99,127,0.78,60,135,195,74,24,63,75,214,603
29,14,1998,36,1,4,66,8,1086,151,325,0.465,0,0,-1,151,325,0.465,76,98,0.776,42,89,131,48,11,53,48,195,378
29,15,1999,37,1,4,18,0,152,21,52,0.404,0,1,0,21,51,0.412,5,7,0.714,9,22,31,9,1,10,9,31,47
29,16,2000,38,1,3,21,0,221,28,64,0.438,0,0,-1,28,64,0.438,11,14,0.786,8,24,32,7,3,6,9,42,67
30,1,1980,31,1,2,77,-1,1595,390,839,0.465,2,6,0.333,388,833,0.466,127,172,0.738,81,84,165,150,39,3,108,120,909
30,2,1981,32,1,2,39,-1,580,80,206,0.388,0,7,0,80,199,0.402,32,50,0.64,18,34,52,49,14,2,32,43,192
30,2,1981,32,1,2,47,-1,657,87,234,0.372,0,7,0,87,227,0.383,34,54,0.63,22,39,61,58,15,2,41,53,208
31,1,1996,21,1,2,60,10,590,90,217,0.415,11,42,0.262,79,175,0.451,49,60,0.817,27,75,102,43,10,5,40,77,240
31,2,1997,22,1,2,55,10,830,125,271,0.461,31,88,0.352,94,183,0.514,56,73,0.767,31,82,113,48,24,10,37,93,337
31,3,1998,23,1,2,51,40,1165,190,452,0.42,40,127,0.315,150,325,0.462,84,99,0.848,43,112,155,85,17,11,69,129,504
31,4,1999,24,1,2,28,2,364,67,179,0.374,25,66,0.379,42,113,0.372,25,36,0.694,23,36,59,16,7,1,24,36,184
31,4,1999,24,1,2,39,4,445,76,205,0.371,28,75,0.373,48,130,0.369,27,40,0.675,23,48,71,23,8,2,28,45,207
31,5,2000,25,1,3,50,2,1092,185,463,0.4,31,93,0.333,154,370,0.416,91,106,0.858,36,124,160,81,30,14,112,101,492
31,5,2000,25,1,3,57,2,1166,196,496,0.395,32,101,0.317,164,395,0.415,107,125,0.856,41,132,173,84,30,15,117,113,531
31,6,2001,26,1,2,35,0,309,53,112,0.473,17,37,0.459,36,75,0.48,46,60,0.767,11,33,44,11,4,3,19,45,169
32,1,1980,29,1,3,82,7,1994,362,763,0.474,12,41,0.293,350,722,0.485,178,241,0.739,106,224,330,156,120,36,143,214,914
32,2,1981,30,1,3,41,7,655,97,216,0.449,1,14,0.071,96,202,0.475,53,67,0.791,26,57,83,56,30,18,47,74,248
32,3,1982,31,1,3,56,27,1296,184,409,0.45,5,17,0.294,179,392,0.457,82,116,0.707,56,94,150,128,67,21,63,136,455
32,4,1983,32,1,3,77,0,883,135,315,0.429,3,19,0.158,132,296,0.446,60,81,0.741,51,86,137,71,48,10,79,140,333
32,5,1984,33,1,3,60,1,585,70,171,0.409,3,15,0.2,67,156,0.429,42,48,0.875,26,49,75,49,17,4,46,67,185
32,6,1985,34,1,3,47,0,397,62,149,0.416,9,23,0.391,53,126,0.421,17,17,1,21,22,43,24,21,6,24,44,150
33,1,1980,24,1,4,74,-1,1781,371,752,0.493,0,4,0,371,748,0.496,171,261,0.655,194,377,571,76,64,51,145,240,913
33,1,1980,24,1,4,79,-1,1838,378,768,0.492,0,4,0,378,764,0.495,173,263,0.658,199,389,588,77,66,52,154,246,929
33,2,1981,25,1,4,81,-1,2615,469,918,0.511,0,4,0,469,914,0.513,292,409,0.714,260,575,835,192,76,42,231,296,1230
33,3,1982,26,1,4,28,6,444,77,168,0.458,0,1,0,77,167,0.461,53,82,0.646,53,84,137,23,6,6,40,69,207
33,3,1982,26,1,4,46,42,1482,271,524,0.517,1,9,0.111,270,515,0.524,145,220,0.659,114,280,394,63,58,16,112,180,688
33,3,1982,26,1,4,74,48,1926,348,692,0.503,1,10,0.1,347,682,0.509,198,302,0.656,167,364,531,86,64,22,152,249,895
33,4,1983,27,1,4,82,26,2331,362,717,0.505,2,6,0.333,360,711,0.506,255,366,0.697,182,407,589,116,62,42,185,306,981
33,5,1984,28,1,4,82,57,2455,518,923,0.561,0,5,0,518,918,0.564,247,367,0.673,208,434,642,157,68,33,202,274,1283
33,6,1985,29,1,4,48,30,1120,190,363,0.523,0,3,0,190,360,0.528,118,164,0.72,90,233,323,56,25,17,100,141,498
33,7,1986,30,1,4,55,31,1557,232,466,0.498,0,4,0,232,462,0.502,149,217,0.687,146,346,492,70,38,30,106,203,613
33,8,1987,31,1,4,49,43,1443,201,399,0.504,0,2,0,201,397,0.506,126,169,0.746,131,368,499,83,29,13,103,159,528
34,1,2005,24,1,2,25,0,430,70,180,0.389,13,39,0.333,57,141,0.404,71,83,0.855,13,47,60,17,17,2,25,37,224
34,2,2006,25,1,2,78,6,1275,192,476,0.403,72,185,0.389,120,291,0.412,138,168,0.821,34,123,157,35,47,11,48,120,594
34,3,2007,26,1,2,72,47,1878,285,658,0.433,111,267,0.416,174,391,0.445,188,208,0.904,35,172,207,91,53,9,73,176,869
34,4,2008,27,1,2,80,18,2016,252,589,0.428,105,241,0.436,147,348,0.422,111,138,0.804,33,193,226,73,46,19,58,187,720
34,5,2009,28,1,2,21,0,141,9,33,0.273,1,8,0.125,8,25,0.32,6,6,1,2,12,14,3,3,1,7,14,25
34,5,2009,28,1,2,34,10,475,56,138,0.406,12,45,0.267,44,93,0.473,15,19,0.789,5,50,55,24,18,5,26,53,139
34,5,2009,28,1,2,55,10,616,65,171,0.38,13,53,0.245,52,118,0.441,21,25,0.84,7,62,69,27,21,6,33,67,164
34,6,2010,29,1,2,25,0,121,18,50,0.36,4,19,0.211,14,31,0.452,6,6,1,4,8,12,6,5,0,7,13,46
34,7,2011,30,1,2,54,1,582,89,199,0.447,17,46,0.37,72,153,0.471,40,52,0.769,12,56,68,23,17,6,23,43,235
34,8,2012,31,1,2,53,2,596,52,157,0.331,8,43,0.186,44,114,0.386,30,38,0.789,8,50,58,38,16,7,24,52,142
36,1,2000,24,1,1,79,30,1859,201,509,0.395,3,23,0.13,198,486,0.407,93,124,0.75,48,151,199,378,93,5,173,167,498
36,2,2001,25,1,1,72,6,1630,195,480,0.406,6,40,0.15,189,440,0.43,65,103,0.631,46,134,180,268,73,10,119,154,461
36,3,2002,26,1,1,46,18,1050,89,260,0.342,1,19,0.053,88,241,0.365,19,36,0.528,19,98,117,214,50,3,72,85,198
36,4,2003,27,1,1,49,26,912,83,233,0.356,0,8,0,83,225,0.369,33,50,0.66,12,71,83,203,45,5,81,70,199
36,5,2005,29,1,1,66,12,742,72,177,0.407,2,17,0.118,70,160,0.438,35,51,0.686,12,57,69,161,35,18,62,88,181
36,6,2006,30,1,1,45,8,589,53,137,0.387,4,15,0.267,49,122,0.402,40,55,0.727,9,53,62,101,24,9,40,71,150
36,7,2008,32,1,1,70,67,1960,218,476,0.458,45,129,0.349,173,347,0.499,64,85,0.753,27,173,200,388,107,28,124,172,545
36,8,2009,33,1,1,78,5,1787,167,386,0.433,21,88,0.239,146,298,0.49,57,78,0.731,40,165,205,364,96,13,155,142,412
36,9,2010,34,1,1,54,7,859,76,181,0.42,17,63,0.27,59,118,0.5,11,13,0.846,17,72,89,160,39,13,58,72,180
36,10,2011,35,1,1,14,0,153,10,30,0.333,4,12,0.333,6,18,0.333,2,2,1,0,12,12,26,9,1,14,19,26
36,10,2011,35,1,1,19,0,310,35,76,0.461,8,28,0.286,27,48,0.563,6,6,1,7,32,39,43,18,5,25,30,84
36,10,2011,35,1,1,33,0,463,45,106,0.425,12,40,0.3,33,66,0.5,8,8,1,7,44,51,69,27,6,39,49,110
36,11,2012,36,1,1,24,0,209,17,53,0.321,5,17,0.294,12,36,0.333,8,10,0.8,5,28,33,34,8,4,17,20,47
37,1,1981,22,1,3,54,-1,672,114,247,0.462,3,10,0.3,111,237,0.468,70,95,0.737,34,31,65,52,23,1,50,99,301
37,2,1982,23,1,2,75,0,1035,188,402,0.468,8,25,0.32,180,377,0.477,58,70,0.829,30,49,79,60,34,11,54,110,442
37,3,1983,24,1,2,81,28,1716,354,706,0.501,17,51,0.333,337,655,0.515,124,154,0.805,62,88,150,194,78,13,118,207,849
37,4,1984,25,1,2,73,54,2045,413,862,0.479,15,46,0.326,398,816,0.488,136,178,0.764,70,83,153,206,128,13,141,211,977
37,5,1985,26,1,2,69,11,1279,214,476,0.45,11,43,0.256,203,433,0.469,109,134,0.813,36,59,95,167,57,5,109,151,548
39,1,1984,22,1,2,55,5,688,145,316,0.459,5,19,0.263,140,297,0.471,47,61,0.77,38,48,86,71,19,4,42,81,342
41,1,2004,27,1,2,10,0,110,11,35,0.314,4,11,0.364,7,24,0.292,16,20,0.8,2,9,11,4,0,0,9,10,42
42,1,1981,23,1,2,60,-1,536,59,179,0.33,0,3,0,59,176,0.335,51,69,0.739,30,39,69,76,22,2,38,68,169
42,2,1982,24,1,2,75,1,923,119,280,0.425,0,0,-1,119,280,0.425,64,80,0.8,35,60,95,130,36,6,78,124,302
46,1,1980,23,1,2,13,-1,117,15,37,0.405,0,0,-1,15,37,0.405,2,7,0.286,5,14,19,9,2,3,10,19,32
47,1,1980,28,1,5,72,-1,1366,97,244,0.398,0,1,0,97,243,0.399,39,62,0.629,164,246,410,82,23,162,68,191,233
47,2,1981,29,1,4,77,-1,1635,134,300,0.447,0,0,-1,134,300,0.447,59,92,0.641,154,319,473,99,33,184,105,284,327
47,3,1982,30,1,4,80,9,1603,94,224,0.42,0,0,-1,94,224,0.42,41,69,0.594,129,227,356,97,42,134,94,237,229
47,4,1983,31,1,5,74,33,1554,90,197,0.457,0,0,-1,90,197,0.457,62,92,0.674,132,276,408,77,26,148,83,224,242
47,5,1984,32,1,4,69,3,1156,61,153,0.399,0,1,0,61,152,0.401,22,42,0.524,89,182,271,43,25,81,57,172,144
47,6,1985,33,1,5,70,14,1049,72,149,0.483,0,1,0,72,148,0.486,59,89,0.663,89,173,262,14,15,57,55,162,203
48,1,1986,22,1,4,64,7,1092,202,431,0.469,0,4,0,202,427,0.473,90,139,0.647,107,165,272,21,31,8,69,127,494
48,2,1987,23,1,4,78,77,2149,413,835,0.495,0,4,0,413,831,0.497,199,335,0.594,248,312,560,56,43,14,145,195,1025
48,3,1988,24,1,4,70,40,1610,296,585,0.506,0,2,0,296,583,0.508,154,235,0.655,180,217,397,63,33,9,101,172,746
48,4,1989,25,1,4,79,77,2077,334,681,0.49,1,5,0.2,333,676,0.493,153,254,0.602,230,342,572,75,46,25,120,250,822
48,5,1990,26,1,4,74,72,2462,546,1152,0.474,2,8,0.25,544,1144,0.476,341,486,0.702,271,292,563,72,36,17,181,201,1435
48,6,1991,27,1,4,51,38,1459,292,632,0.462,0,5,0,292,627,0.466,161,258,0.624,168,187,355,58,34,9,107,113,745
48,7,1992,28,1,4,78,67,2430,457,922,0.496,0,4,0,457,918,0.498,240,346,0.694,257,292,549,109,58,16,138,196,1154
48,8,1993,29,1,4,21,1,262,36,73,0.493,0,0,-1,36,73,0.493,27,34,0.794,18,28,46,5,4,1,25,31,99
49,1,1994,24,1,1,66,6,1122,162,388,0.418,26,88,0.295,136,300,0.453,90,107,0.841,25,109,134,192,59,7,94,136,440
49,2,1995,25,1,1,82,1,1882,253,593,0.427,63,191,0.33,190,402,0.473,214,254,0.843,38,173,211,405,94,14,167,209,783
49,3,1996,26,1,1,61,0,1682,289,658,0.439,73,210,0.348,216,448,0.482,235,285,0.825,51,137,188,278,53,4,157,166,886
49,4,1997,27,1,1,16,13,398,70,165,0.424,15,49,0.306,55,116,0.474,42,50,0.84,14,36,50,57,17,6,41,48,197
49,4,1997,27,1,1,22,9,539,100,241,0.415,19,62,0.306,81,179,0.453,106,124,0.855,12,38,50,99,23,6,60,66,325
49,4,1997,27,1,1,23,22,777,167,377,0.443,47,120,0.392,120,257,0.467,64,77,0.831,21,61,82,149,37,7,67,86,445
49,4,1997,27,1,1,61,44,1714,337,783,0.43,81,231,0.351,256,552,0.464,212,251,0.845,47,135,182,305,77,19,168,200,967
49,5,1998,28,1,1,75,72,2606,510,1156,0.441,15,80,0.188,495,1076,0.46,436,507,0.86,73,155,228,603,121,20,269,262,1471
49,6,1999,29,1,1,4,3,100,21,49,0.429,1,7,0.143,20,42,0.476,29,31,0.935,1,5,6,19,3,0,12,13,72
49,6,1999,29,1,1,8,3,199,39,93,0.419,2,10,0.2,37,83,0.446,47,50,0.94,5,10,15,36,9,0,20,22,127
49,7,2000,30,1,1,81,81,2899,545,1170,0.466,26,90,0.289,519,1080,0.481,390,445,0.876,69,232,301,729,102,8,267,255,1506
49,8,2001,31,1,1,76,75,2709,537,1132,0.474,30,98,0.306,507,1034,0.49,277,323,0.858,46,244,290,580,88,8,220,214,1381
49,9,2002,32,1,1,74,73,2605,554,1197,0.463,71,204,0.348,483,993,0.486,282,328,0.86,54,258,312,493,90,12,177,208,1461
49,10,2003,33,1,1,78,77,2700,546,1162,0.47,59,163,0.362,487,999,0.487,385,447,0.861,57,285,342,450,88,14,177,216,1536
49,11,2004,34,1,1,81,81,2838,620,1270,0.488,74,186,0.398,546,1084,0.504,289,331,0.873,44,227,271,592,102,18,220,247,1603
49,12,2005,35,1,1,59,38,1522,319,687,0.464,27,103,0.262,292,584,0.5,134,155,0.865,25,132,157,301,36,14,109,160,799
49,13,2006,36,1,1,78,75,2653,493,1112,0.443,70,190,0.368,423,922,0.459,289,335,0.863,40,247,287,491,74,11,175,225,1345
49,14,2007,37,1,1,58,30,1407,261,625,0.418,32,109,0.294,229,516,0.444,160,182,0.879,27,140,167,270,28,8,101,126,714
49,15,2008,38,1,1,17,1,299,50,130,0.385,9,22,0.409,41,108,0.38,21,25,0.84,5,26,31,35,9,3,19,29,130
49,15,2008,38,1,1,38,33,975,183,402,0.455,14,54,0.259,169,348,0.486,106,119,0.891,12,93,105,179,28,3,78,69,486
49,15,2008,38,1,1,55,34,1274,233,532,0.438,23,76,0.303,210,456,0.461,127,144,0.882,17,119,136,214,37,6,97,98,616
51,1,1998,23,1,5,74,8,1007,98,229,0.428,0,3,0,98,226,0.434,86,125,0.688,91,161,252,23,29,94,44,164,282
51,2,1999,24,1,5,43,0,545,58,129,0.45,1,1,1,57,128,0.445,34,67,0.507,49,101,150,19,23,56,27,100,151
51,3,2000,25,1,5,65,32,1581,216,402,0.537,0,4,0,216,398,0.543,135,208,0.649,102,287,389,26,33,124,71,175,567
51,4,2001,26,1,5,35,13,624,64,111,0.577,0,0,-1,64,111,0.577,37,57,0.649,47,94,141,11,13,31,25,89,165
51,5,2002,27,1,5,75,73,1917,190,326,0.583,0,1,0,190,325,0.585,113,194,0.582,176,349,525,29,40,95,53,208,493
51,6,2003,28,1,5,73,5,1247,133,256,0.52,0,4,0,133,252,0.528,66,124,0.532,132,296,428,20,38,85,56,176,332
51,7,2004,29,1,4,69,67,1743,161,360,0.447,0,0,-1,161,360,0.447,96,142,0.676,153,319,472,72,52,96,84,203,418
51,8,2005,30,1,5,62,50,1525,160,297,0.539,0,0,-1,160,297,0.539,112,143,0.783,102,314,416,40,55,82,64,170,432
51,9,2006,31,1,5,23,0,299,31,72,0.431,0,0,-1,31,72,0.431,26,35,0.743,19,44,63,2,6,10,16,48,88
51,9,2006,31,1,5,27,0,333,36,84,0.429,0,0,-1,36,84,0.429,26,35,0.743,20,50,70,4,6,12,18,52,98
52,1,1991,22,1,5,76,55,1719,210,413,0.508,0,0,-1,210,413,0.508,105,165,0.636,141,250,391,69,49,148,96,225,525
52,2,1992,23,1,5,80,77,2291,250,455,0.549,0,1,0,250,454,0.551,136,222,0.613,196,384,580,59,47,215,124,281,636
52,3,1993,24,1,5,55,45,1211,175,321,0.545,0,1,0,175,320,0.547,103,165,0.624,112,191,303,35,32,87,58,192,453
52,4,1994,25,1,5,41,8,674,71,137,0.518,0,0,-1,71,137,0.518,40,68,0.588,68,118,186,11,19,49,33,109,182
52,5,1995,26,1,5,58,24,820,76,147,0.517,0,1,0,76,146,0.521,57,98,0.582,57,117,174,15,14,80,33,146,209
52,6,1996,27,1,5,73,26,1044,90,216,0.417,0,1,0,90,215,0.419,70,96,0.729,86,162,248,20,27,78,53,173,250
52,7,1997,28,1,5,46,8,581,48,94,0.511,2,3,0.667,46,91,0.505,20,37,0.541,57,70,127,20,15,38,34,131,118
52,8,1998,29,1,5,37,2,363,37,89,0.416,0,0,-1,37,89,0.416,15,26,0.577,29,70,99,5,7,27,18,73,89
52,9,1999,30,1,5,19,1,137,20,35,0.571,0,0,-1,20,35,0.571,4,12,0.333,14,21,35,2,0,11,18,32,44
52,10,2000,31,1,5,25,2,185,20,37,0.541,0,0,-1,20,37,0.541,26,38,0.684,11,36,47,2,2,16,10,42,66
52,11,2001,32,1,5,31,14,384,32,85,0.376,0,0,-1,32,85,0.376,12,25,0.48,23,60,83,5,8,18,23,67,76
53,1,1991,21,1,3,63,0,730,204,419,0.487,1,6,0.167,203,413,0.492,110,166,0.663,77,73,150,35,22,5,69,70,519
53,2,1992,22,1,3,64,4,725,176,365,0.482,1,6,0.167,175,359,0.487,109,148,0.736,60,92,152,50,16,11,71,52,462
53,3,1993,23,1,3,74,46,1607,381,662,0.576,0,2,0,381,660,0.577,187,258,0.725,172,236,408,77,54,28,106,103,949
53,4,1994,24,1,3,53,43,1602,425,795,0.535,0,9,0,425,786,0.541,160,221,0.724,153,191,344,91,59,23,93,124,1010
53,5,1995,25,1,3,58,54,2029,497,977,0.509,58,146,0.397,439,831,0.528,209,292,0.716,169,295,464,105,60,19,143,131,1261
53,6,1996,26,1,3,78,71,2628,638,1203,0.53,51,184,0.277,587,1019,0.576,329,409,0.804,215,321,536,119,94,22,167,144,1656
53,7,1997,27,1,3,8,8,279,34,83,0.41,5,21,0.238,29,62,0.468,13,15,0.867,11,42,53,15,5,6,17,19,86
53,7,1997,27,1,3,42,32,1147,248,534,0.464,21,81,0.259,227,453,0.501,126,171,0.737,91,186,277,49,28,17,68,94,643
53,7,1997,27,1,3,50,40,1426,282,617,0.457,26,102,0.255,256,515,0.497,139,186,0.747,102,228,330,64,33,23,85,113,729
53,8,1998,28,1,3,12,9,364,75,157,0.478,6,20,0.3,69,137,0.504,47,61,0.77,24,48,72,25,11,8,33,29,203
53,8,1998,28,1,3,35,16,626,129,258,0.5,15,50,0.3,114,208,0.548,60,84,0.714,51,98,149,35,22,8,39,59,333
53,8,1998,28,1,3,47,25,990,204,415,0.492,21,70,0.3,183,345,0.53,107,145,0.738,75,146,221,60,33,16,72,88,536
53,9,1999,29,1,3,13,5,352,59,140,0.421,11,28,0.393,48,112,0.429,34,49,0.694,23,62,85,12,7,5,28,23,163
53,10,2000,30,1,3,69,25,2064,447,1002,0.446,44,134,0.328,403,868,0.464,209,248,0.843,172,290,462,90,56,24,125,165,1147
53,11,2001,31,1,3,13,0,166,28,71,0.394,11,40,0.275,17,31,0.548,8,10,0.8,7,19,26,7,6,3,9,19,75
53,11,2001,31,1,3,27,0,393,73,158,0.462,11,33,0.333,62,125,0.496,29,33,0.879,27,53,80,13,10,4,23,42,186
53,11,2001,31,1,3,40,0,559,101,229,0.441,22,73,0.301,79,156,0.506,37,43,0.86,34,72,106,20,16,7,32,61,261
54,1,2000,22,1,1,16,0,185,15,45,0.333,2,9,0.222,13,36,0.361,5,6,0.833,1,10,11,20,7,0,16,22,37
56,1,2005,24,1,1,36,0,433,42,125,0.336,12,49,0.245,30,76,0.395,15,24,0.625,4,27,31,51,13,0,24,30,111
61,1,1980,33,1,2,60,0,523,67,189,0.354,1,6,0.167,66,183,0.361,32,42,0.762,31,42,73,38,31,11,33,80,167
62,1,1986,22,1,3,36,0,273,49,88,0.557,0,0,-1,49,88,0.557,24,36,0.667,13,26,39,8,2,6,18,37,122
64,1,1980,23,1,1,79,-1,2623,357,661,0.54,4,9,0.444,353,652,0.541,180,231,0.779,75,199,274,556,183,32,216,197,898
64,2,1981,24,1,1,81,-1,2415,310,581,0.534,3,8,0.375,307,573,0.536,140,178,0.787,67,178,245,560,193,39,174,231,763
64,3,1982,25,1,1,79,79,2498,352,676,0.521,6,22,0.273,346,654,0.529,171,220,0.777,51,197,248,667,209,33,184,247,881
64,4,1983,26,1,1,79,79,2465,404,745,0.542,1,6,0.167,403,739,0.545,181,240,0.754,53,156,209,543,184,31,179,182,990
64,5,1984,27,1,1,75,75,2494,386,702,0.55,8,20,0.4,378,682,0.554,170,232,0.733,44,161,205,478,171,20,182,196,950
64,6,1985,28,1,1,78,78,2616,422,741,0.57,6,26,0.231,416,715,0.582,175,199,0.879,54,163,217,497,169,24,155,184,1025
64,7,1986,29,1,1,82,82,3270,490,913,0.537,4,17,0.235,486,896,0.542,282,335,0.842,55,180,235,753,207,27,238,160,1266
64,8,1987,30,1,1,68,68,2624,415,788,0.527,4,17,0.235,411,771,0.533,227,292,0.777,47,168,215,538,180,15,173,109,1061
64,9,1988,31,1,1,79,79,2871,428,865,0.495,3,22,0.136,425,843,0.504,227,275,0.825,59,194,253,635,167,22,160,116,1086
64,10,1989,32,1,1,71,70,2298,336,696,0.483,1,13,0.077,335,683,0.49,151,195,0.774,39,144,183,554,105,17,116,114,824
64,11,1990,33,1,1,31,13,753,92,159,0.579,3,7,0.429,89,152,0.586,57,65,0.877,11,62,73,151,42,5,36,32,244
64,11,1990,33,1,1,50,49,1766,215,450,0.478,1,9,0.111,214,441,0.485,114,137,0.832,39,128,167,302,82,5,85,46,545
64,11,1990,33,1,1,81,62,2519,307,609,0.504,4,16,0.25,303,593,0.511,171,202,0.847,50,190,240,453,124,10,121,78,789
64,12,1991,34,1,1,76,64,2147,241,483,0.499,5,20,0.25,236,463,0.51,105,129,0.814,22,151,173,435,128,10,108,138,592
64,13,1992,35,1,1,56,0,1086,115,249,0.462,3,6,0.5,112,243,0.461,26,43,0.605,29,66,95,185,83,0,36,73,259
64,14,1993,36,1,1,35,0,510,51,93,0.548,0,2,0,51,91,0.56,24,27,0.889,5,37,42,107,33,2,33,35,126
65,1,1989,21,1,2,75,44,2219,526,1271,0.414,60,191,0.314,466,1080,0.431,155,195,0.795,74,113,187,176,70,25,113,167,1267
65,2,1990,22,1,2,54,52,1762,377,924,0.408,47,142,0.331,330,782,0.422,144,192,0.75,52,127,179,132,46,6,100,113,945
65,3,1991,23,1,1,70,68,2100,410,922,0.445,48,148,0.324,362,774,0.468,234,282,0.83,45,146,191,250,73,16,131,167,1102
65,4,1992,24,1,1,21,11,545,108,240,0.45,8,27,0.296,100,213,0.469,36,53,0.679,9,45,54,86,14,8,42,47,260
65,4,1992,24,1,1,22,11,567,113,252,0.448,8,29,0.276,105,223,0.471,36,53,0.679,10,48,58,89,15,8,45,51,270
65,5,1993,25,1,2,60,23,1300,287,602,0.477,43,116,0.371,244,486,0.502,132,163,0.81,19,69,88,116,38,10,79,119,749
65,6,1994,26,1,2,60,59,2025,431,865,0.498,64,165,0.388,367,700,0.524,168,206,0.816,57,89,146,185,59,8,117,83,1094
65,7,1995,27,1,2,45,29,1468,254,639,0.397,86,274,0.314,168,365,0.46,137,159,0.862,23,90,113,128,67,15,62,85,731
65,8,1996,28,1,2,56,50,1865,289,679,0.426,125,337,0.371,164,342,0.48,83,113,0.735,22,123,145,166,45,10,79,117,786
65,9,1997,29,1,2,65,33,1833,332,749,0.443,110,314,0.35,222,435,0.51,124,149,0.832,25,156,181,182,52,7,96,108,898
65,10,1998,30,1,2,68,67,2263,408,956,0.427,120,311,0.386,288,645,0.447,146,187,0.781,30,143,173,203,71,14,116,102,1082
65,11,1999,31,1,2,38,35,1183,165,459,0.359,53,151,0.351,112,308,0.364,76,91,0.835,12,92,104,109,34,9,54,46,459
65,12,2000,32,1,2,53,19,957,124,320,0.388,41,123,0.333,83,197,0.421,59,78,0.756,10,70,80,62,22,1,38,70,348
66,1,1994,22,1,2,65,21,1604,327,696,0.47,1,23,0.043,326,673,0.484,124,161,0.77,88,102,190,126,63,10,108,148,779
66,2,1995,23,1,2,78,71,2651,512,1129,0.453,96,283,0.339,416,846,0.492,173,213,0.812,105,216,321,177,80,21,151,215,1293
66,3,1996,24,1,3,70,70,2324,426,905,0.471,52,154,0.338,374,751,0.498,151,214,0.706,67,172,239,154,67,18,129,205,1055
66,4,1997,25,1,2,79,79,2411,369,730,0.505,4,30,0.133,365,700,0.521,95,137,0.693,70,198,268,114,77,18,94,226,837
66,5,1998,26,1,2,82,82,2841,448,981,0.457,15,53,0.283,433,928,0.467,139,215,0.647,82,242,324,173,96,36,104,264,1050
66,6,1999,27,1,2,50,18,1266,172,415,0.414,8,37,0.216,164,378,0.434,33,67,0.493,33,108,141,73,39,16,42,146,385
66,7,2000,28,1,2,67,19,1309,120,273,0.44,18,54,0.333,102,219,0.466,9,21,0.429,23,115,138,80,44,14,46,158,267
66,8,2001,29,1,2,9,5,153,10,30,0.333,0,0,-1,10,30,0.333,1,2,0.5,5,15,20,9,4,2,5,14,21
66,9,2002,30,1,2,68,47,1631,224,466,0.481,0,4,0,224,462,0.485,46,67,0.687,57,183,240,110,34,21,70,156,494
66,10,2003,31,1,2,81,74,2351,325,651,0.499,10,25,0.4,315,626,0.503,40,69,0.58,73,211,284,163,65,13,108,225,700
66,11,2004,32,1,3,79,7,2067,278,578,0.481,0,10,0,278,568,0.489,47,77,0.61,77,183,260,136,60,12,85,184,603
66,12,2005,33,1,2,55,5,951,113,265,0.426,0,3,0,113,262,0.431,24,37,0.649,32,92,124,64,17,15,35,95,250
66,13,2006,34,1,3,42,0,448,42,108,0.389,0,8,0,42,100,0.42,8,8,1,20,41,61,19,13,2,17,38,92
69,1,1980,29,1,2,23,-1,380,52,135,0.385,2,6,0.333,50,129,0.388,18,26,0.692,9,26,35,47,15,10,26,29,124
69,1,1980,29,1,2,20,-1,470,84,214,0.393,3,6,0.5,81,208,0.389,31,41,0.756,10,33,43,42,18,5,29,26,202
69,1,1980,29,1,2,43,-1,850,136,349,0.39,5,12,0.417,131,337,0.389,49,67,0.731,19,59,78,89,33,15,55,55,326
70,1,1989,21,1,3,81,1,1539,277,634,0.437,5,24,0.208,272,610,0.446,191,244,0.783,114,142,256,77,48,11,136,161,750
70,2,1990,22,1,3,41,0,492,90,178,0.506,3,8,0.375,87,170,0.512,61,87,0.701,28,47,75,27,23,4,40,59,244
70,2,1990,22,1,3,55,0,591,105,220,0.477,3,9,0.333,102,211,0.483,80,111,0.721,35,55,90,31,26,5,45,70,293
70,3,1991,23,1,3,18,0,110,17,46,0.37,0,0,-1,17,46,0.37,9,16,0.563,11,7,18,2,3,1,6,16,43
71,1,1992,23,1,4,69,2,817,113,250,0.452,2,2,1,111,248,0.448,23,28,0.821,78,109,187,38,32,17,41,70,251
71,2,1993,24,1,4,59,9,834,165,340,0.485,0,0,-1,165,340,0.485,32,46,0.696,80,114,194,64,22,21,54,102,362
71,3,1994,25,1,4,30,0,391,51,120,0.425,3,14,0.214,48,106,0.453,10,13,0.769,29,71,100,15,10,11,18,48,115
71,3,1994,25,1,4,46,24,974,152,328,0.463,0,1,0,152,327,0.465,31,52,0.596,100,171,271,71,43,28,56,116,335
71,3,1994,25,1,4,76,24,1365,203,448,0.453,3,15,0.2,200,433,0.462,41,65,0.631,129,242,371,86,53,39,74,164,450
71,4,1995,26,1,4,68,17,1347,146,328,0.445,35,86,0.407,111,242,0.459,31,42,0.738,106,211,317,66,25,43,61,117,358
71,5,1996,27,1,4,74,0,651,73,179,0.408,37,98,0.378,36,81,0.444,17,26,0.654,51,105,156,26,19,14,22,65,200
71,6,1997,28,1,4,54,1,662,72,165,0.436,25,69,0.362,47,96,0.49,13,22,0.591,67,89,156,47,26,17,28,52,182
71,7,1998,29,1,4,82,0,1420,156,359,0.435,54,130,0.415,102,229,0.445,39,59,0.661,77,229,306,104,53,37,62,158,405
71,8,1999,30,1,4,46,0,697,63,172,0.366,26,68,0.382,37,104,0.356,14,17,0.824,29,88,117,30,22,12,28,52,166
71,9,2000,31,1,4,26,0,224,22,62,0.355,1,10,0.1,21,52,0.404,2,2,1,15,28,43,10,5,4,9,31,47
71,9,2000,31,1,4,24,2,347,31,63,0.492,5,16,0.313,26,47,0.553,6,6,1,27,52,79,16,10,6,11,39,73
71,9,2000,31,1,4,56,2,601,53,127,0.417,6,26,0.231,47,101,0.465,8,8,1,46,85,131,27,15,10,20,73,120
72,1,1996,23,1,1,28,0,250,25,79,0.316,13,47,0.277,12,32,0.375,22,27,0.815,1,18,19,32,8,1,28,22,85
72,2,1997,24,1,1,19,0,125,10,30,0.333,3,16,0.188,7,14,0.5,6,8,0.75,1,4,5,15,7,0,13,11,29
72,2,1997,24,1,1,23,0,155,14,40,0.35,5,19,0.263,9,21,0.429,6,8,0.75,1,5,6,17,9,0,18,16,39
73,1,1995,27,1,1,53,11,1021,106,279,0.38,41,125,0.328,65,154,0.422,55,73,0.753,14,55,69,219,42,3,76,116,308
73,2,1996,28,1,1,78,54,2408,324,778,0.416,95,259,0.367,229,519,0.441,259,304,0.852,51,194,245,548,111,8,230,246,1002
73,3,1997,29,1,1,65,61,2076,211,510,0.414,70,181,0.387,141,329,0.429,113,149,0.758,22,169,191,398,78,11,180,213,605
73,4,1998,30,1,1,68,0,1599,149,354,0.421,27,87,0.31,122,267,0.457,104,126,0.825,29,133,162,268,56,6,103,179,429
73,5,1999,31,1,1,48,0,1297,114,267,0.427,36,94,0.383,78,173,0.451,64,78,0.821,18,115,133,193,44,1,85,156,328
73,6,2000,32,1,1,71,2,1675,146,357,0.409,37,104,0.356,109,253,0.431,47,59,0.797,17,130,147,285,36,4,105,240,376
73,7,2001,33,1,1,26,0,550,42,113,0.372,12,42,0.286,30,71,0.423,21,25,0.84,10,54,64,119,22,8,58,82,117
73,7,2001,33,1,1,51,5,1309,93,222,0.419,20,64,0.313,73,158,0.462,39,46,0.848,14,124,138,236,37,7,98,160,245
73,7,2001,33,1,1,77,5,1859,135,335,0.403,32,106,0.302,103,229,0.45,60,71,0.845,24,178,202,355,59,15,156,242,362
73,8,2002,34,1,1,69,4,1576,97,296,0.328,33,120,0.275,64,176,0.364,58,71,0.817,18,136,154,351,56,5,123,177,285
73,9,2003,35,1,1,12,0,106,6,20,0.3,1,6,0.167,5,14,0.357,2,3,0.667,3,2,5,16,8,1,6,17,15
75,1,1980,30,1,5,82,-1,2394,372,760,0.489,0,2,0,372,758,0.491,125,169,0.74,143,421,564,151,56,65,175,271,869
75,2,1981,31,1,4,82,-1,2562,378,751,0.503,0,4,0,378,747,0.506,126,193,0.653,180,477,657,153,39,96,159,324,882
75,3,1982,32,1,5,59,13,867,74,171,0.433,0,0,-1,74,171,0.433,36,46,0.783,39,146,185,64,15,32,41,114,184
79,1,1993,22,1,2,23,0,332,45,106,0.425,2,12,0.167,43,94,0.457,50,66,0.758,24,27,51,53,22,5,50,53,142
79,2,1994,23,1,2,65,34,1515,244,562,0.434,39,119,0.328,205,443,0.463,145,208,0.697,93,142,235,136,89,28,140,186,672
79,3,1996,25,1,3,23,0,218,35,73,0.479,10,19,0.526,25,54,0.463,13,22,0.591,8,26,34,25,12,3,19,41,93
79,3,1996,25,1,3,32,17,818,115,264,0.436,36,87,0.414,79,177,0.446,56,71,0.789,26,94,120,92,58,16,76,100,322
79,3,1996,25,1,3,55,17,1036,150,337,0.445,46,106,0.434,104,231,0.45,69,93,0.742,34,120,154,117,70,19,95,141,415
79,4,1997,26,1,2,81,81,3127,396,949,0.417,147,383,0.384,249,566,0.44,237,306,0.775,85,347,432,315,201,45,200,245,1176
79,5,1998,27,1,2,78,78,2939,458,1071,0.428,100,307,0.326,358,764,0.469,271,327,0.829,94,310,404,282,190,57,228,198,1287
79,6,1999,28,1,2,50,50,1768,252,650,0.388,49,161,0.304,203,489,0.415,207,246,0.841,59,148,207,187,113,26,119,111,760
79,7,2000,29,1,2,73,73,2264,311,764,0.407,99,275,0.36,212,489,0.434,182,216,0.843,63,222,285,321,102,43,144,167,903
79,8,2001,30,1,2,81,81,2939,311,788,0.395,94,250,0.376,217,538,0.403,280,312,0.897,95,260,355,289,183,45,154,224,996
79,9,2002,31,1,2,81,81,2798,338,735,0.46,90,256,0.352,248,479,0.518,206,242,0.851,74,300,374,340,160,25,164,209,972
79,10,2003,32,1,2,80,80,2710,267,557,0.479,73,185,0.395,194,372,0.522,141,174,0.81,61,281,342,376,180,37,144,186,748
79,11,2004,33,1,2,82,82,2780,317,688,0.461,49,142,0.345,268,546,0.491,148,172,0.86,69,260,329,347,151,41,155,186,831
79,12,2005,34,1,2,21,13,529,47,128,0.367,5,23,0.217,42,105,0.4,20,22,0.909,9,45,54,46,37,5,36,45,119
79,12,2005,34,1,2,31,31,996,83,204,0.407,10,39,0.256,73,165,0.442,50,56,0.893,29,94,123,153,43,13,68,61,226
79,12,2005,34,1,2,52,44,1525,130,332,0.392,15,62,0.242,115,270,0.426,70,78,0.897,38,139,177,199,80,18,104,106,345
79,13,2006,35,1,2,7,7,185,9,26,0.346,0,1,0,9,25,0.36,8,12,0.667,2,11,13,14,9,1,6,10,26
86,1,2001,23,1,1,78,8,1268,160,400,0.4,5,17,0.294,155,383,0.405,97,137,0.708,26,106,132,207,49,1,139,153,422
86,2,2002,24,1,1,32,0,153,30,68,0.441,2,8,0.25,28,60,0.467,8,9,0.889,1,7,8,25,7,0,27,9,70
86,3,2006,28,1,1,27,0,230,25,71,0.352,4,16,0.25,21,55,0.382,19,24,0.792,2,12,14,42,3,2,14,30,73
87,1,1980,30,1,1,22,-1,254,30,69,0.435,3,8,0.375,27,61,0.443,12,15,0.8,10,9,19,40,13,2,17,13,75
87,1,1980,30,1,1,57,-1,1535,184,381,0.483,4,23,0.174,180,358,0.503,72,98,0.735,43,90,133,248,44,9,92,120,444
87,1,1980,30,1,1,79,-1,1789,214,450,0.476,7,31,0.226,207,419,0.494,84,113,0.743,53,99,152,288,57,11,109,133,519
88,1,1984,23,1,2,31,0,127,19,52,0.365,0,2,0,19,50,0.38,16,18,0.889,7,10,17,17,8,1,12,13,54
88,2,1985,24,1,2,62,3,562,64,152,0.421,0,5,0,64,147,0.435,41,53,0.774,29,40,69,48,35,2,42,66,169
89,1,1999,23,1,5,28,0,409,36,80,0.45,0,1,0,36,79,0.456,21,37,0.568,36,60,96,10,10,31,21,52,93
89,2,2000,24,1,5,81,20,1850,286,528,0.542,1,8,0.125,285,520,0.548,121,176,0.688,162,343,505,71,45,114,125,231,694
89,3,2001,25,1,4,35,3,752,82,199,0.412,0,0,-1,82,199,0.412,63,105,0.6,58,128,186,34,16,44,48,101,227
89,3,2001,25,1,4,46,0,968,167,320,0.522,0,1,0,167,319,0.524,79,135,0.585,78,170,248,38,16,110,42,143,413
89,3,2001,25,1,4,81,3,1720,249,519,0.48,0,1,0,249,518,0.481,142,240,0.592,136,298,434,72,32,154,90,244,640
89,4,2002,26,1,5,81,31,2185,380,775,0.49,0,5,0,380,770,0.494,155,230,0.674,182,421,603,88,58,122,140,258,915
89,5,2003,27,1,5,80,11,1780,226,451,0.501,0,4,0,226,447,0.506,84,128,0.656,138,313,451,80,38,150,94,227,536
93,1,1998,21,1,5,58,1,740,93,207,0.449,0,0,-1,93,207,0.449,46,77,0.597,63,105,168,19,12,81,38,73,232
93,2,2000,23,1,5,57,6,820,96,197,0.487,0,3,0,96,194,0.495,46,78,0.59,65,114,179,25,13,73,34,80,238
97,1,1991,25,1,3,52,1,320,28,75,0.373,0,1,0,28,74,0.378,12,22,0.545,42,37,79,3,6,4,5,45,68
98,1,1986,24,1,1,45,1,469,75,184,0.408,3,15,0.2,72,169,0.426,12,20,0.6,6,40,46,82,20,3,49,65,165
99,1,1981,26,1,2,29,-1,395,35,99,0.354,0,2,0,35,97,0.361,24,36,0.667,19,22,41,25,11,1,32,35,94
100,1,1991,23,1,4,74,68,2602,514,1100,0.467,13,38,0.342,501,1062,0.472,323,442,0.731,269,490,759,163,71,99,217,217,1364
100,2,1992,24,1,4,65,58,2207,483,958,0.504,23,76,0.303,460,882,0.522,300,393,0.763,203,415,618,205,54,98,248,168,1289
100,3,1993,25,1,4,76,73,2759,564,1226,0.46,23,99,0.232,541,1127,0.48,421,521,0.808,247,605,852,276,92,126,243,210,1572
100,4,1994,26,1,4,77,77,2778,541,1209,0.447,38,121,0.314,503,1088,0.462,439,567,0.774,262,608,870,262,68,142,208,209,1559
100,5,1995,27,1,4,56,54,2103,371,875,0.424,28,120,0.233,343,755,0.454,376,490,0.767,167,424,591,187,35,94,172,162,1146
100,6,1996,28,1,4,11,11,294,48,118,0.407,7,21,0.333,41,97,0.423,20,32,0.625,13,59,72,31,4,10,28,30,123
100,7,1997,29,1,4,57,54,2102,364,836,0.435,32,119,0.269,332,717,0.463,272,365,0.745,157,416,573,193,50,75,184,164,1032
100,8,1998,30,1,4,59,58,2135,356,867,0.411,26,98,0.265,330,769,0.429,302,391,0.772,149,438,587,145,46,68,157,144,1040
100,9,1999,31,1,4,37,29,1178,168,406,0.414,7,33,0.212,161,373,0.432,143,190,0.753,76,252,328,78,24,42,90,96,486
100,10,2000,32,1,4,74,64,2347,446,979,0.456,51,141,0.362,395,838,0.471,296,377,0.785,124,508,632,175,34,130,173,195,1239
100,11,2001,33,1,4,34,3,683,97,255,0.38,20,51,0.392,77,204,0.377,63,92,0.685,46,138,184,39,10,21,42,53,277
100,12,2002,34,1,4,58,58,2080,331,735,0.45,28,83,0.337,303,652,0.465,185,227,0.815,167,342,509,98,42,51,119,158,875
100,13,2003,35,1,5,64,35,1742,223,498,0.448,22,67,0.328,201,431,0.466,134,171,0.784,151,299,450,87,53,69,96,171,602
100,14,2004,36,1,5,34,30,843,107,259,0.413,8,36,0.222,99,223,0.444,49,65,0.754,45,147,192,46,23,26,57,79,271
103,1,2001,23,1,5,23,0,222,27,71,0.38,0,1,0,27,70,0.386,17,24,0.708,12,25,37,6,2,3,11,27,71
103,2,2002,24,1,5,25,2,365,41,95,0.432,0,1,0,41,94,0.436,24,32,0.75,31,51,82,9,6,4,13,40,106
103,3,2003,25,1,5,13,3,104,17,36,0.472,0,0,-1,17,36,0.472,2,2,1,12,17,29,1,2,1,2,10,36
103,4,2004,26,1,5,20,16,545,79,165,0.479,1,4,0.25,78,161,0.484,67,85,0.788,36,75,111,17,11,11,31,71,226
103,5,2005,27,1,5,70,44,942,174,376,0.463,6,14,0.429,168,362,0.464,48,71,0.676,84,100,184,18,15,13,63,147,402
104,1,1988,26,1,3,29,11,431,66,191,0.346,1,2,0.5,65,189,0.344,20,36,0.556,36,45,81,13,11,6,16,51,153
105,1,1991,22,1,1,82,9,1355,162,393,0.412,6,34,0.176,156,359,0.435,71,95,0.747,56,97,153,232,65,12,98,149,401
105,2,1992,23,1,1,81,28,1976,295,649,0.455,10,52,0.192,285,597,0.477,216,262,0.824,69,120,189,366,73,13,167,151,816
105,3,1993,24,1,1,81,37,2232,318,686,0.464,42,137,0.307,276,549,0.503,177,220,0.805,58,108,166,373,80,11,108,199,855
105,4,1994,25,1,1,76,4,1726,233,519,0.449,20,99,0.202,213,420,0.507,102,131,0.779,50,109,159,263,75,12,107,132,588
105,5,1995,26,1,1,68,65,2207,261,607,0.43,16,76,0.211,245,531,0.461,141,174,0.81,46,145,191,416,99,13,156,185,679
105,6,1996,27,1,1,29,3,733,87,218,0.399,25,82,0.305,62,136,0.456,29,38,0.763,11,48,59,126,31,5,48,78,228
105,6,1996,27,1,1,52,52,1882,231,559,0.413,63,172,0.366,168,387,0.434,139,173,0.803,38,163,201,296,63,12,123,175,664
105,6,1996,27,1,1,81,55,2615,318,777,0.409,88,254,0.346,230,523,0.44,168,211,0.796,49,211,260,422,94,17,171,253,892
105,7,1997,28,1,1,51,13,1183,122,314,0.389,30,102,0.294,92,212,0.434,37,49,0.755,39,79,118,149,35,7,59,96,311
105,8,1998,29,1,1,53,44,1471,166,438,0.379,13,57,0.228,153,381,0.402,78,88,0.886,17,106,123,248,51,13,89,135,423
105,9,1999,30,1,1,48,32,1272,183,414,0.442,6,25,0.24,177,389,0.455,83,101,0.822,21,96,117,222,45,11,82,113,455
105,10,2000,31,1,1,80,54,1924,276,607,0.455,8,39,0.205,268,568,0.472,85,104,0.817,30,142,172,290,58,11,103,178,645
105,11,2001,32,1,1,47,0,804,91,239,0.381,2,16,0.125,89,223,0.399,48,56,0.857,9,39,48,138,27,6,59,87,232
105,12,2002,33,1,1,47,1,693,56,146,0.384,4,20,0.2,52,126,0.413,33,37,0.892,12,43,55,107,13,4,31,59,149
105,13,2003,34,1,1,14,0,175,22,49,0.449,0,7,0,22,42,0.524,8,8,1,1,10,11,16,6,0,10,17,52
105,13,2003,34,1,1,21,11,516,34,119,0.286,7,25,0.28,27,94,0.287,27,34,0.794,10,38,48,56,11,4,18,43,102
105,13,2003,34,1,1,35,11,691,56,168,0.333,7,32,0.219,49,136,0.36,35,42,0.833,11,48,59,72,17,4,28,60,154
105,14,2004,35,1,1,22,1,170,12,34,0.353,0,0,-1,12,34,0.353,4,6,0.667,2,8,10,15,3,0,9,27,28
106,1,1998,24,1,2,23,0,103,21,55,0.382,9,20,0.45,12,35,0.343,8,14,0.571,7,7,14,3,6,3,8,12,59
109,1,1980,28,1,2,36,-1,963,191,410,0.466,0,1,0,191,409,0.467,113,124,0.911,29,65,94,100,30,7,82,76,495
109,2,1981,29,1,2,12,-1,329,62,126,0.492,0,0,-1,62,126,0.492,24,29,0.828,6,23,29,42,7,4,22,23,148
110,1,2002,23,1,5,70,68,1440,158,343,0.461,0,1,0,158,342,0.462,134,181,0.74,138,158,296,58,29,22,56,234,450
110,2,2003,24,1,5,22,7,421,38,86,0.442,0,1,0,38,85,0.447,44,62,0.71,32,28,60,14,5,6,19,70,120
110,3,2004,25,1,5,81,31,1732,147,295,0.498,0,1,0,147,294,0.5,188,262,0.718,117,199,316,77,26,18,79,255,482
110,4,2005,26,1,5,50,38,961,65,157,0.414,0,1,0,65,156,0.417,83,119,0.697,57,107,164,61,11,6,34,146,213
110,5,2006,27,1,5,79,41,1730,129,280,0.461,0,0,-1,129,280,0.461,157,219,0.717,134,199,333,97,36,27,61,252,415
110,6,2007,28,1,5,82,9,913,75,170,0.441,0,0,-1,75,170,0.441,54,83,0.651,71,100,171,60,13,8,37,147,204
110,7,2008,29,1,5,70,9,702,36,82,0.439,0,1,0,36,81,0.444,46,74,0.622,40,76,116,37,10,6,22,106,118
110,8,2009,30,1,5,26,3,201,16,35,0.457,0,0,-1,16,35,0.457,8,11,0.727,20,17,37,7,2,1,9,35,40
110,9,2010,31,1,5,34,10,261,12,31,0.387,0,0,-1,12,31,0.387,10,25,0.4,22,40,62,6,2,3,10,42,34
110,10,2011,32,1,5,23,0,157,5,15,0.333,0,0,-1,5,15,0.333,7,10,0.7,7,10,17,1,4,1,5,24,17
110,10,2011,32,1,5,28,0,181,6,21,0.286,0,0,-1,6,21,0.286,7,10,0.7,14,10,24,2,4,1,7,29,19
112,1,2007,22,1,3,52,9,777,87,228,0.382,13,47,0.277,74,181,0.409,48,82,0.585,28,76,104,83,32,3,57,75,235
112,2,2008,23,1,2,46,8,634,57,175,0.326,8,32,0.25,49,143,0.343,23,38,0.605,19,56,75,89,24,8,56,56,145
112,3,2009,24,1,1,39,14,815,97,224,0.433,13,28,0.464,84,196,0.429,24,37,0.649,29,70,99,101,29,10,53,73,231
112,3,2009,24,1,1,48,14,890,105,247,0.425,13,31,0.419,92,216,0.426,28,46,0.609,31,76,107,111,31,10,58,80,251
112,4,2010,25,1,2,43,0,470,47,128,0.367,4,17,0.235,43,111,0.387,13,21,0.619,13,37,50,44,23,1,32,45,111
115,1,1984,23,1,3,48,0,446,81,163,0.497,0,3,0,81,160,0.506,56,91,0.615,19,37,56,38,23,18,46,49,218
119,1,1988,23,1,4,75,17,1122,156,363,0.43,0,1,0,156,362,0.431,106,150,0.707,54,164,218,65,36,70,116,175,418
119,2,1989,24,1,4,67,10,1119,166,341,0.487,0,2,0,166,339,0.49,106,161,0.658,112,122,234,30,42,63,85,160,438
124,1,1992,24,1,5,45,1,381,48,101,0.475,0,0,-1,48,101,0.475,24,32,0.75,33,36,69,12,9,7,27,40,120
124,2,1993,25,1,5,46,0,467,81,171,0.474,0,4,0,81,167,0.485,57,81,0.704,48,75,123,37,13,5,28,43,219
124,3,1994,26,1,5,14,1,201,29,56,0.518,0,1,0,29,55,0.527,12,15,0.8,19,31,50,6,4,1,10,33,70
124,3,1994,26,1,5,16,8,378,66,109,0.606,0,1,0,66,108,0.611,31,38,0.816,34,55,89,28,5,7,23,36,163
124,3,1994,26,1,5,30,9,579,95,165,0.576,0,2,0,95,163,0.583,43,53,0.811,53,86,139,34,9,8,33,69,233
124,4,1995,27,1,5,82,3,2064,344,647,0.532,8,29,0.276,336,618,0.544,119,194,0.613,160,266,426,110,42,18,123,218,815
124,5,1996,28,1,5,74,1,958,153,327,0.468,5,30,0.167,148,297,0.498,84,110,0.764,58,119,177,68,20,11,79,126,395
124,6,1997,29,1,5,74,15,1614,214,454,0.471,2,10,0.2,212,444,0.477,144,171,0.842,128,195,323,104,46,18,109,154,574
124,7,1998,30,1,5,18,0,209,28,62,0.452,0,0,-1,28,62,0.452,32,44,0.727,16,30,46,12,9,5,11,27,88
128,1,2004,22,1,1,17,0,139,7,27,0.259,0,1,0,7,26,0.269,0,0,-1,3,3,6,24,10,0,10,14,14
132,1,1993,23,1,1,65,0,645,62,158,0.392,7,30,0.233,55,128,0.43,25,35,0.714,13,37,50,150,18,2,69,66,156
132,2,1994,24,1,1,23,2,136,18,41,0.439,1,7,0.143,17,34,0.5,11,15,0.733,2,7,9,28,3,0,20,12,48
133,1,1992,23,1,1,51,1,741,77,193,0.399,10,37,0.27,67,156,0.429,91,104,0.875,18,60,78,141,45,2,74,94,255
133,2,1993,24,1,1,9,0,102,13,23,0.565,0,3,0,13,20,0.65,16,21,0.762,1,6,7,16,6,0,8,17,42
133,2,1993,24,1,1,10,0,105,14,24,0.583,0,3,0,14,21,0.667,16,21,0.762,1,6,7,16,6,0,8,18,44
133,3,1994,25,1,1,51,0,467,40,94,0.426,11,38,0.289,29,56,0.518,26,38,0.684,8,36,44,86,22,2,38,47,117
134,1,1980,23,1,4,79,-1,1781,367,750,0.489,1,4,0.25,366,746,0.491,136,181,0.751,202,305,507,42,20,79,140,246,871
134,2,1981,24,1,5,71,-1,1420,213,471,0.452,1,3,0.333,212,468,0.453,62,90,0.689,166,274,440,52,18,51,77,219,489
134,3,1982,25,1,5,76,38,1818,281,669,0.42,1,8,0.125,280,661,0.424,119,160,0.744,200,350,550,115,37,106,88,285,682
134,4,1983,26,1,5,80,60,2099,320,723,0.443,0,5,0,320,718,0.446,135,197,0.685,214,397,611,116,27,136,162,318,775
134,5,1984,27,1,5,81,38,1662,304,663,0.459,0,7,0,304,656,0.463,185,230,0.804,176,300,476,76,26,106,110,247,793
134,6,1985,28,1,5,80,78,2031,404,856,0.472,0,2,0,404,854,0.473,161,235,0.685,229,402,631,86,28,197,149,304,969
134,7,1986,29,1,5,78,78,2112,422,906,0.466,3,7,0.429,419,899,0.466,174,219,0.795,190,420,610,81,42,227,117,315,1021
134,8,1987,30,1,5,69,64,1561,235,524,0.448,0,3,0,235,521,0.451,79,109,0.725,162,311,473,68,13,101,78,257,549
134,9,1988,31,1,5,45,32,865,118,270,0.437,0,1,0,118,269,0.439,50,67,0.746,98,172,270,30,12,94,59,145,286
134,10,1989,32,1,5,79,72,1864,220,444,0.495,1,4,0.25,219,440,0.498,79,106,0.745,212,407,619,78,36,211,73,302,520
134,11,1990,33,1,5,79,0,1176,138,304,0.454,0,3,0,138,301,0.458,25,39,0.641,118,221,339,44,18,95,39,211,301
134,12,1991,34,1,5,67,1,746,57,145,0.393,0,1,0,57,144,0.396,33,42,0.786,54,134,188,22,7,61,22,120,147
134,13,1992,35,1,5,35,0,344,35,82,0.427,0,0,-1,35,82,0.427,7,11,0.636,38,63,101,21,4,27,15,57,77
135,1,1992,27,1,5,33,1,132,22,40,0.55,0,0,-1,22,40,0.55,4,13,0.308,14,22,36,3,2,6,8,29,48
136,1,1980,23,1,2,82,-1,1973,303,578,0.524,5,20,0.25,298,558,0.534,111,143,0.776,101,128,229,221,86,38,142,215,722
136,2,1981,24,1,2,81,-1,2625,321,654,0.491,4,19,0.211,317,635,0.499,117,149,0.785,121,215,336,332,133,78,164,249,763
136,3,1982,25,1,2,76,14,2197,383,741,0.517,2,17,0.118,381,724,0.526,139,171,0.813,84,185,269,230,120,61,151,216,907
136,4,1983,26,1,2,82,3,2148,266,497,0.535,5,21,0.238,261,476,0.548,102,130,0.785,82,192,274,315,115,50,128,208,639
136,5,1984,27,1,2,82,9,2387,273,549,0.497,38,121,0.314,235,428,0.549,155,185,0.838,53,209,262,482,113,67,148,267,739
136,6,1985,28,1,2,82,20,2189,276,593,0.465,35,123,0.285,241,470,0.513,115,133,0.865,56,199,255,429,93,49,156,208,702
136,7,1986,29,1,2,82,15,2269,274,606,0.452,63,163,0.387,211,443,0.476,147,170,0.865,44,200,244,466,89,43,151,238,758
136,8,1987,30,1,2,82,2,2253,322,736,0.438,89,231,0.385,233,505,0.461,126,148,0.851,58,196,254,373,78,43,102,199,859
136,9,1988,31,1,2,61,8,1793,189,482,0.392,57,178,0.32,132,304,0.434,97,113,0.858,50,178,228,289,66,26,101,136,532
136,10,1989,32,1,2,80,13,1943,213,494,0.431,80,210,0.381,133,284,0.468,81,93,0.871,33,158,191,314,72,32,94,186,587
136,11,1990,33,1,2,80,10,1851,191,493,0.387,50,157,0.318,141,336,0.42,83,94,0.883,59,168,227,215,67,36,91,206,515
138,1,1986,23,1,3,16,0,174,27,64,0.422,0,1,0,27,63,0.429,10,14,0.714,11,14,25,11,11,2,12,21,64
138,2,1987,24,1,3,32,0,438,43,117,0.368,1,4,0.25,42,113,0.372,42,57,0.737,36,60,96,17,17,2,20,48,129
138,2,1987,24,1,3,31,15,732,113,264,0.428,0,0,-1,113,264,0.428,49,67,0.731,52,67,119,80,38,3,46,81,275
138,2,1987,24,1,3,63,15,1170,156,381,0.409,1,4,0.25,155,377,0.411,91,124,0.734,88,127,215,97,55,5,66,129,404
138,3,1988,25,1,3,30,1,591,99,203,0.488,1,3,0.333,98,200,0.49,33,40,0.825,48,82,130,59,30,3,38,53,232
138,3,1988,25,1,3,54,4,1148,158,322,0.491,0,3,0,158,319,0.495,77,98,0.786,79,141,220,56,42,15,66,128,393
138,3,1988,25,1,3,84,5,1739,257,525,0.49,1,6,0.167,256,519,0.493,110,138,0.797,127,223,350,115,72,18,104,181,625
138,4,1989,26,1,3,77,30,1655,245,454,0.54,0,2,0,245,452,0.542,141,179,0.788,176,222,398,118,82,13,92,222,631
138,5,1990,27,1,3,82,80,3011,521,1083,0.481,0,11,0,521,1072,0.486,161,209,0.77,219,385,604,216,175,41,143,288,1203
138,6,1991,28,1,3,82,82,3196,587,1311,0.448,2,10,0.2,585,1301,0.45,296,371,0.798,185,404,589,347,162,53,209,257,1472
138,7,1992,29,1,3,11,8,344,57,142,0.401,0,1,0,57,141,0.404,44,53,0.83,24,45,69,33,12,6,26,31,158
138,7,1992,29,1,3,69,1,1863,246,488,0.504,0,3,0,246,485,0.507,130,148,0.878,139,264,403,107,70,14,71,162,622
138,7,1992,29,1,3,80,9,2207,303,630,0.481,0,4,0,303,626,0.484,174,201,0.866,163,309,472,140,82,20,97,193,780
138,8,1993,30,1,3,82,58,2555,385,766,0.503,0,5,0,385,761,0.506,180,218,0.826,194,325,519,173,108,32,108,252,950
138,9,1994,31,1,3,82,17,2149,268,588,0.456,6,29,0.207,262,559,0.469,117,144,0.813,150,239,389,122,99,24,92,212,659
138,10,1995,32,1,3,81,4,1389,205,464,0.442,14,56,0.25,191,408,0.468,78,114,0.684,98,164,262,67,55,16,74,161,502
138,11,1996,33,1,3,22,0,354,38,92,0.413,2,6,0.333,36,86,0.419,23,28,0.821,26,39,65,23,16,3,17,51,101
138,11,1996,33,1,3,49,2,930,117,259,0.452,1,12,0.083,116,247,0.47,77,92,0.837,55,124,179,61,47,17,50,96,312
138,11,1996,33,1,3,71,2,1284,155,351,0.442,3,18,0.167,152,333,0.456,100,120,0.833,81,163,244,84,63,20,67,147,413
138,12,1997,34,1,3,70,65,2305,253,600,0.422,74,208,0.356,179,392,0.457,86,108,0.796,76,218,294,124,90,7,85,176,666
138,13,1998,35,1,3,79,79,2699,328,747,0.439,49,141,0.348,279,606,0.46,101,128,0.789,78,284,362,173,105,7,86,197,806
138,14,1999,36,1,3,47,6,1066,131,335,0.391,38,119,0.319,93,216,0.431,52,80,0.65,37,108,145,43,31,7,43,74,352
138,15,2000,37,1,3,54,5,941,88,247,0.356,10,44,0.227,78,203,0.384,33,39,0.846,40,125,165,60,36,5,29,99,219
138,16,2001,38,1,3,15,1,117,9,38,0.237,0,5,0,9,33,0.273,2,4,0.5,3,10,13,4,2,0,3,18,20
139,1,1980,23,1,5,78,-1,826,90,216,0.417,0,0,-1,90,216,0.417,45,68,0.662,104,166,270,63,9,31,60,120,225
139,2,1981,24,1,5,82,-1,1960,366,747,0.49,0,3,0,366,744,0.492,125,175,0.714,228,408,636,117,42,99,131,212,857
139,3,1982,25,1,5,82,21,2189,336,648,0.519,1,4,0.25,335,644,0.52,159,213,0.746,211,418,629,130,33,126,139,235,832
139,4,1983,26,1,5,82,71,2496,457,920,0.497,0,2,0,457,918,0.498,232,322,0.72,243,474,717,154,47,109,228,242,1146
139,5,1984,27,1,5,82,82,2674,385,824,0.467,3,9,0.333,382,815,0.469,231,275,0.84,169,406,575,202,58,120,175,227,1004
139,6,1985,28,1,5,82,50,2062,276,568,0.486,0,1,0,276,567,0.487,149,200,0.745,130,292,422,140,32,64,124,189,701
139,7,1986,29,1,5,67,4,1709,255,519,0.491,3,12,0.25,252,507,0.497,127,171,0.743,132,301,433,150,28,53,104,133,640
139,8,1987,30,1,5,82,39,2287,294,619,0.475,0,5,0,294,614,0.479,95,129,0.736,199,341,540,209,38,87,114,202,683
139,9,1988,31,1,5,80,32,2328,344,715,0.481,1,9,0.111,343,706,0.486,115,153,0.752,170,357,527,154,36,95,109,149,804
139,10,1989,32,1,5,81,7,1483,203,440,0.461,2,8,0.25,201,432,0.465,71,96,0.74,92,223,315,103,29,45,93,134,479
139,11,1991,34,1,5,28,0,147,17,38,0.447,0,0,-1,17,38,0.447,13,22,0.591,10,23,33,4,5,5,2,18,47
142,1,1980,28,1,3,24,-1,160,29,81,0.358,2,9,0.222,27,72,0.375,8,14,0.571,2,17,19,12,7,1,13,24,68
152,1,1998,22,1,4,40,0,256,46,110,0.418,1,3,0.333,45,107,0.421,57,68,0.838,20,21,41,9,12,7,18,27,150
152,2,1999,23,1,4,42,30,784,110,255,0.431,11,33,0.333,99,222,0.446,57,70,0.814,37,53,90,24,10,13,48,106,288
152,3,2000,24,1,4,55,11,668,91,229,0.397,7,27,0.259,84,202,0.416,63,81,0.778,51,48,99,33,17,16,37,83,252
152,4,2001,25,1,4,47,22,901,122,270,0.452,6,22,0.273,116,248,0.468,68,83,0.819,28,82,110,37,21,16,62,117,318
152,5,2002,26,1,4,7,4,131,21,45,0.467,0,1,0,21,44,0.477,11,15,0.733,9,16,25,5,2,5,10,21,53
152,6,2004,28,1,4,56,25,1207,211,471,0.448,44,113,0.389,167,358,0.466,103,119,0.866,58,117,175,45,37,20,55,131,569
153,1,2002,22,1,1,15,0,129,23,56,0.411,15,35,0.429,8,21,0.381,8,8,1,2,8,10,24,4,0,9,8,69
153,1,2002,22,1,1,21,0,156,26,68,0.382,15,39,0.385,11,29,0.379,12,13,0.923,2,9,11,26,5,0,10,10,79
156,1,1980,31,1,1,81,-1,1794,249,578,0.431,1,17,0.059,248,561,0.442,172,212,0.811,27,89,116,246,74,4,130,133,671
156,2,1981,32,1,1,66,-1,1708,220,485,0.454,1,21,0.048,219,464,0.472,185,214,0.864,26,74,100,283,61,3,134,87,626
156,3,1982,33,1,1,27,0,552,84,210,0.4,2,8,0.25,82,202,0.406,65,73,0.89,6,32,38,75,23,2,30,40,235
156,3,1982,33,1,1,28,20,840,138,288,0.479,8,21,0.381,130,267,0.487,76,86,0.884,7,37,44,112,21,4,52,56,360
156,3,1982,33,1,1,55,20,1392,222,498,0.446,10,29,0.345,212,469,0.452,141,159,0.887,13,69,82,187,44,6,82,96,595
156,4,1983,34,1,1,66,0,922,169,375,0.451,6,31,0.194,163,344,0.474,68,76,0.895,14,65,79,127,27,0,44,44,412
156,5,1984,35,1,1,6,0,107,11,30,0.367,1,6,0.167,10,24,0.417,7,11,0.636,2,7,9,17,5,0,4,7,30
156,5,1984,35,1,1,9,0,108,9,22,0.409,0,0,-1,9,22,0.409,5,5,1,3,8,11,21,3,0,6,4,23
156,5,1984,35,1,1,15,0,215,20,52,0.385,1,6,0.167,19,46,0.413,12,16,0.75,5,15,20,38,8,0,10,11,53
156,6,1985,36,1,1,4,2,115,7,17,0.412,0,2,0,7,15,0.467,4,6,0.667,2,12,14,22,3,0,11,5,18
157,1,1988,22,1,3,29,0,258,34,68,0.5,0,0,-1,34,68,0.5,19,25,0.76,27,37,64,15,5,8,25,42,87
158,1,2008,20,1,2,22,0,171,26,53,0.491,1,3,0.333,25,50,0.5,19,28,0.679,7,14,21,18,7,0,22,12,72
158,1,2008,20,1,2,28,0,508,72,180,0.4,9,34,0.265,63,146,0.432,53,76,0.697,20,69,89,33,12,2,33,35,206
158,1,2008,20,1,2,50,0,679,98,233,0.421,10,37,0.27,88,196,0.449,72,104,0.692,27,83,110,51,19,2,55,47,278
158,2,2009,21,1,1,56,10,1130,124,270,0.459,2,14,0.143,122,256,0.477,48,81,0.593,53,107,160,145,39,6,79,96,298
158,2,2009,21,1,1,63,10,1174,131,285,0.46,2,15,0.133,129,270,0.478,53,92,0.576,57,109,166,150,40,6,82,101,317
161,1,1986,24,1,4,21,0,128,6,24,0.25,0,0,-1,6,24,0.25,14,25,0.56,9,21,30,1,2,3,6,38,26
163,1,1998,22,1,4,26,0,243,32,86,0.372,4,13,0.308,28,73,0.384,8,14,0.571,10,35,45,8,9,5,13,32,76
163,2,1999,23,1,4,27,0,249,32,75,0.427,8,29,0.276,24,46,0.522,20,23,0.87,16,29,45,10,7,8,23,32,92
163,3,2000,24,1,4,81,14,1885,288,653,0.441,63,174,0.362,225,479,0.47,196,231,0.848,135,381,516,89,44,60,121,203,835
163,4,2001,25,1,4,81,23,1874,276,701,0.394,70,207,0.338,206,494,0.417,200,231,0.866,123,264,387,92,36,50,136,180,822
163,5,2002,26,1,4,76,1,1286,185,448,0.413,49,145,0.338,136,303,0.449,97,114,0.851,74,220,294,77,26,29,67,106,516
163,6,2003,27,1,4,49,0,633,86,209,0.411,27,69,0.391,59,140,0.421,53,65,0.815,40,115,155,56,6,13,28,48,252
163,7,2004,28,1,4,77,0,1051,119,307,0.388,56,144,0.389,63,163,0.387,93,104,0.894,60,183,243,52,24,14,55,101,387
163,8,2005,29,1,4,73,22,1827,188,497,0.378,45,174,0.259,143,323,0.443,226,256,0.883,103,272,375,98,48,17,104,154,647
163,9,2006,30,1,4,50,26,1148,132,285,0.463,54,140,0.386,78,145,0.538,90,102,0.882,62,203,265,62,22,7,48,105,408
163,10,2007,31,1,4,61,2,727,78,222,0.351,26,91,0.286,52,131,0.397,45,52,0.865,33,153,186,44,14,6,33,68,227
163,11,2008,32,1,4,44,0,457,61,137,0.445,22,61,0.361,39,76,0.513,29,32,0.906,33,71,104,30,8,6,22,60,173
163,12,2009,33,1,4,14,0,100,14,39,0.359,5,15,0.333,9,24,0.375,7,12,0.583,11,23,34,9,1,1,6,5,40
165,1,1984,22,1,5,45,0,354,64,112,0.571,0,0,-1,64,112,0.571,38,91,0.418,35,47,82,22,12,7,19,58,166
166,1,1993,23,1,1,40,0,243,37,72,0.514,2,14,0.143,35,58,0.603,26,38,0.684,4,13,17,55,11,0,30,29,102
166,2,1994,24,1,1,45,0,313,45,99,0.455,11,24,0.458,34,75,0.453,31,36,0.861,11,20,31,77,15,1,27,36,132
166,3,1995,25,1,1,80,0,1019,93,231,0.403,11,36,0.306,82,195,0.421,98,121,0.81,27,70,97,205,39,6,70,105,295
166,4,1996,26,1,1,58,4,617,51,114,0.447,8,27,0.296,43,87,0.494,62,72,0.861,20,34,54,102,22,6,51,60,172
166,5,1997,27,1,1,48,0,659,79,154,0.513,20,49,0.408,59,105,0.562,54,64,0.844,15,32,47,102,18,0,42,79,232
166,6,1998,28,1,1,26,2,379,29,90,0.322,6,20,0.3,23,70,0.329,32,34,0.941,4,28,32,63,10,1,42,28,96
166,7,1999,29,1,1,24,0,363,47,116,0.405,13,35,0.371,34,81,0.42,40,47,0.851,8,22,30,58,9,0,33,30,147
166,7,1999,29,1,1,27,0,382,51,124,0.411,14,36,0.389,37,88,0.42,43,50,0.86,8,23,31,63,11,0,33,31,159
166,8,2000,30,1,1,69,0,937,106,251,0.422,33,80,0.413,73,171,0.427,80,93,0.86,17,58,75,128,27,5,54,104,325
166,9,2001,31,1,1,31,0,264,22,65,0.338,4,7,0.571,18,58,0.31,17,19,0.895,13,15,28,34,6,0,19,32,65
166,10,2002,32,1,1,41,0,802,98,208,0.471,31,69,0.449,67,139,0.482,57,66,0.864,16,59,75,141,19,1,51,77,284
166,11,2003,33,1,1,12,0,180,14,41,0.341,4,13,0.308,10,28,0.357,9,15,0.6,1,14,15,29,3,0,9,16,41
167,1,1980,23,1,5,71,-1,900,187,370,0.505,0,0,-1,187,370,0.505,94,123,0.764,81,157,238,53,22,17,74,141,468
167,2,1981,24,1,5,74,-1,1084,248,460,0.539,0,2,0,248,458,0.541,99,140,0.707,97,195,292,62,31,19,114,192,595
167,3,1982,25,1,4,78,7,1132,219,430,0.509,0,2,0,219,428,0.512,67,91,0.736,61,184,245,99,22,9,108,227,505
167,4,1983,26,1,5,81,71,2317,433,878,0.493,0,1,0,433,877,0.494,148,196,0.755,225,443,668,144,57,35,162,296,1014
167,5,1984,27,1,4,80,80,2492,452,915,0.494,0,2,0,452,913,0.495,141,190,0.742,151,507,658,158,64,23,146,282,1045
167,6,1985,28,1,5,63,63,2069,410,797,0.514,0,4,0,410,793,0.517,177,227,0.78,139,379,518,109,50,17,166,247,997
167,7,1986,29,1,5,31,30,1007,195,408,0.478,0,2,0,195,406,0.48,97,139,0.698,92,188,280,47,27,12,87,136,487
167,8,1987,30,1,4,49,11,1056,172,382,0.45,0,0,-1,172,382,0.45,79,110,0.718,123,189,312,38,26,7,85,145,423
167,9,1988,31,1,4,62,9,946,140,307,0.456,0,1,0,140,306,0.458,59,80,0.738,82,153,235,37,20,10,65,143,339
167,10,1989,32,1,4,53,28,1096,197,394,0.5,0,2,0,197,392,0.503,72,97,0.742,84,197,281,47,29,18,111,160,466
167,11,1990,33,1,5,37,1,391,77,159,0.484,0,0,-1,77,159,0.484,21,37,0.568,28,65,93,13,12,4,32,60,175
168,1,1983,21,1,4,70,69,2531,684,1309,0.523,0,1,0,684,1308,0.523,292,412,0.709,303,441,744,177,129,62,204,294,1660
168,2,1984,22,1,4,81,80,2907,737,1491,0.494,0,3,0,737,1488,0.495,380,528,0.72,323,454,777,139,92,57,218,298,1854
168,3,1985,23,1,4,79,78,2722,759,1532,0.495,0,1,0,759,1531,0.496,343,463,0.741,244,472,716,228,117,67,190,264,1861
168,4,1986,24,1,4,82,82,2669,681,1438,0.474,0,2,0,681,1436,0.474,265,404,0.656,222,472,694,193,121,51,191,283,1627
168,5,1987,25,1,4,82,77,2770,729,1426,0.511,0,3,0,729,1423,0.512,249,376,0.662,214,486,700,229,129,81,172,296,1707
168,6,1988,26,1,4,76,76,2629,675,1392,0.485,1,3,0.333,674,1389,0.485,270,406,0.665,184,369,553,181,78,46,170,274,1621
168,7,1989,27,1,3,80,78,2824,730,1563,0.467,7,15,0.467,723,1548,0.467,362,460,0.787,281,369,650,198,106,72,201,265,1829
168,8,1990,28,1,4,81,78,2821,728,1532,0.475,19,59,0.322,709,1473,0.481,343,440,0.78,226,451,677,219,110,52,202,286,1818
168,9,1991,29,1,4,67,62,2195,503,1039,0.484,7,33,0.212,496,1006,0.493,164,240,0.683,194,327,521,157,61,30,131,225,1177
168,10,1992,30,1,4,70,67,2149,514,1053,0.488,5,13,0.385,509,1040,0.489,177,249,0.711,247,384,631,102,58,34,115,210,1210
168,11,1994,32,1,4,59,29,1133,183,428,0.428,0,2,0,183,426,0.43,63,107,0.589,132,165,297,50,31,13,59,137,429
168,12,1995,33,1,4,76,20,1273,224,464,0.483,0,0,-1,224,464,0.483,72,123,0.585,138,240,378,59,36,19,95,188,520
168,13,1996,34,1,4,81,13,1777,270,584,0.462,1,7,0.143,269,577,0.466,104,160,0.65,162,283,445,89,56,30,69,263,645
168,14,1997,35,1,4,45,3,828,155,319,0.486,3,5,0.6,152,314,0.484,57,82,0.695,70,113,183,39,33,7,45,113,370
168,15,1998,36,1,4,30,1,529,103,216,0.477,0,0,-1,103,216,0.477,28,40,0.7,42,93,135,26,16,5,34,79,234
168,15,1998,36,1,4,44,2,656,97,212,0.458,0,1,0,97,211,0.46,39,58,0.672,55,93,148,21,22,5,17,102,233
168,15,1998,36,1,4,74,3,1185,200,428,0.467,0,1,0,200,427,0.468,67,98,0.684,97,186,283,47,38,10,51,181,467
168,16,1999,37,1,4,50,0,1011,186,424,0.439,1,1,1,185,423,0.437,81,114,0.711,95,160,255,58,46,10,58,168,454
168,17,2000,38,1,4,22,0,398,76,177,0.429,0,0,-1,76,177,0.429,32,39,0.821,45,62,107,21,13,8,27,74,184
172,1,2000,23,1,1,75,11,1793,265,655,0.405,49,151,0.325,216,504,0.429,127,169,0.751,57,127,184,247,91,13,132,174,706
172,2,2001,24,1,1,66,11,1495,178,517,0.344,48,143,0.336,130,374,0.348,79,116,0.681,47,90,137,227,67,14,91,160,483
172,3,2002,25,1,1,58,1,501,78,187,0.417,12,46,0.261,66,141,0.468,24,32,0.75,14,38,52,60,18,5,36,53,192
175,1,1999,24,1,5,15,6,161,3,18,0.167,0,0,-1,3,18,0.167,0,2,0,13,15,28,1,1,11,5,30,6
175,1,1999,24,1,5,16,6,162,3,18,0.167,0,0,-1,3,18,0.167,0,2,0,13,15,28,1,1,11,5,30,6
176,1,1993,27,1,5,20,0,166,16,41,0.39,0,0,-1,16,41,0.39,26,36,0.722,17,32,49,12,7,2,8,30,58
179,1,1987,22,1,2,67,0,636,139,326,0.426,17,60,0.283,122,266,0.459,30,38,0.789,30,48,78,58,27,4,44,86,325
179,2,1988,23,1,2,79,8,1499,340,742,0.458,28,81,0.346,312,661,0.472,79,101,0.782,43,123,166,149,94,22,108,128,787
179,3,1989,24,1,2,48,0,813,256,521,0.491,19,55,0.345,237,466,0.509,40,46,0.87,26,78,104,50,42,4,44,68,571
179,4,1990,25,1,2,67,13,1860,461,990,0.466,52,147,0.354,409,843,0.485,96,104,0.923,31,137,168,159,98,26,100,148,1070
179,5,1991,26,1,2,76,14,1515,337,715,0.471,32,86,0.372,305,629,0.485,96,114,0.842,47,152,199,166,75,25,80,125,802
179,6,1992,27,1,2,77,0,2020,504,1038,0.486,74,183,0.404,430,855,0.503,127,152,0.836,57,202,259,177,93,20,134,156,1209
179,7,1993,28,1,2,80,0,2094,498,1102,0.452,95,237,0.401,403,865,0.466,136,157,0.866,51,235,286,180,87,23,129,150,1227
179,8,1994,29,1,2,82,0,2173,533,1171,0.455,152,378,0.402,381,793,0.48,117,134,0.873,71,191,262,221,98,27,120,161,1335
179,9,1995,30,1,2,69,0,1718,343,778,0.441,154,361,0.427,189,417,0.453,95,111,0.856,41,127,168,113,55,18,98,144,935
179,10,1996,31,1,2,82,29,2371,441,974,0.453,164,406,0.404,277,568,0.488,146,171,0.854,68,196,264,176,108,25,130,173,1192
179,11,1997,32,1,2,68,20,2078,384,836,0.459,126,296,0.426,258,540,0.478,114,142,0.803,40,171,211,118,60,14,93,147,1008
179,12,1998,33,1,2,52,1,971,194,434,0.447,61,145,0.421,133,289,0.46,41,52,0.788,26,75,101,69,31,4,54,85,490
179,13,1999,34,1,2,42,0,864,163,336,0.485,69,145,0.476,94,191,0.492,28,34,0.824,18,67,85,48,36,3,45,42,423
179,14,2000,35,1,2,67,9,1095,194,454,0.427,95,242,0.393,99,212,0.467,24,32,0.75,11,89,100,89,32,9,40,66,507
179,15,2001,36,1,2,71,1,956,162,382,0.424,62,145,0.428,100,237,0.422,43,51,0.843,16,69,85,75,27,8,39,66,429
179,16,2002,37,1,2,56,4,886,141,347,0.406,45,131,0.344,96,216,0.444,33,37,0.892,23,58,81,61,22,6,41,50,360
185,1,2001,20,1,5,35,0,259,17,65,0.262,0,1,0,17,64,0.266,13,28,0.464,22,34,56,10,9,16,21,44,47
185,2,2002,21,1,5,50,0,638,72,178,0.404,0,1,0,72,177,0.407,41,70,0.586,55,107,162,23,17,24,46,108,185
188,1,1980,22,1,4,67,-1,726,122,271,0.45,0,0,-1,122,271,0.45,68,101,0.673,71,126,197,28,21,54,79,116,312
188,2,1981,23,1,4,82,-1,2539,444,889,0.499,1,2,0.5,443,887,0.499,256,361,0.709,192,415,607,98,74,143,219,332,1145
188,3,1982,24,1,4,10,0,180,31,65,0.477,0,0,-1,31,65,0.477,4,11,0.364,17,31,48,13,3,7,19,42,66
188,3,1982,24,1,4,67,0,1288,230,440,0.523,0,0,-1,230,440,0.523,133,213,0.624,110,233,343,52,39,76,120,228,593
188,3,1982,24,1,4,77,0,1468,261,505,0.517,0,0,-1,261,505,0.517,137,224,0.612,127,264,391,65,42,83,139,270,659
188,4,1983,25,1,4,69,39,1715,376,756,0.497,0,1,0,376,755,0.498,224,320,0.7,168,300,468,65,42,59,190,256,976
188,4,1983,25,1,4,75,39,1765,385,774,0.497,0,1,0,385,773,0.498,226,322,0.702,171,303,474,67,43,60,196,271,996
188,5,1984,26,1,4,73,0,1174,254,517,0.491,0,1,0,254,516,0.492,138,192,0.719,104,190,294,79,33,40,101,197,646
188,6,1985,27,1,4,74,28,1297,156,349,0.447,0,1,0,156,348,0.448,73,108,0.676,122,222,344,39,30,50,100,286,385
188,7,1986,28,1,4,48,36,1245,202,443,0.456,0,4,0,202,439,0.46,129,167,0.772,102,232,334,50,33,40,99,207,533
188,8,1987,29,1,4,34,2,542,112,239,0.469,0,0,-1,112,239,0.469,58,80,0.725,48,89,137,20,12,23,54,119,282
188,9,1988,30,1,4,65,0,869,109,241,0.452,0,4,0,109,237,0.46,70,89,0.787,73,137,210,42,17,28,70,180,288
189,1,1999,23,1,2,27,10,249,34,86,0.395,1,5,0.2,33,81,0.407,9,13,0.692,24,30,54,13,9,2,11,24,78
189,2,2000,24,1,2,46,2,449,58,140,0.414,2,10,0.2,56,130,0.431,45,65,0.692,26,46,72,30,13,4,24,55,163
194,1,1994,22,1,5,82,63,2560,435,869,0.501,1,5,0.2,434,864,0.502,234,411,0.569,277,344,621,163,60,114,162,231,1105
194,2,1995,23,1,4,82,82,3361,594,1229,0.483,7,24,0.292,587,1205,0.487,256,432,0.593,289,557,846,296,86,116,221,277,1451
194,3,1996,24,1,4,82,82,3319,699,1429,0.489,10,48,0.208,689,1381,0.499,321,479,0.67,263,545,808,212,68,91,216,272,1729
194,4,1997,25,1,4,78,78,3159,632,1251,0.505,15,54,0.278,617,1197,0.515,358,521,0.687,267,537,804,211,81,112,245,275,1637
194,5,1998,26,1,5,82,82,2944,631,1164,0.542,1,7,0.143,630,1157,0.545,311,526,0.591,286,370,656,152,91,86,174,278,1574
194,6,1999,27,1,4,34,31,1162,198,437,0.453,0,3,0,198,434,0.456,72,160,0.45,86,125,211,56,32,34,76,121,468
194,7,2000,28,1,5,79,75,2849,514,1129,0.455,2,8,0.25,512,1121,0.457,281,412,0.682,227,378,605,148,47,66,213,288,1311
194,8,2001,29,1,4,76,27,2129,347,822,0.422,1,16,0.063,346,806,0.429,232,321,0.723,179,251,430,90,38,73,158,264,927
194,9,2002,30,1,5,55,41,1710,315,649,0.485,1,8,0.125,314,641,0.49,143,226,0.633,168,182,350,72,22,36,127,197,774
194,10,2003,31,1,5,52,9,942,99,207,0.478,0,4,0,99,203,0.488,72,107,0.673,90,108,198,29,22,30,61,146,270
194,11,2004,32,1,4,17,0,313,40,99,0.404,1,2,0.5,39,97,0.402,32,45,0.711,36,34,70,12,7,9,25,62,113
194,11,2004,32,1,4,37,33,1000,168,333,0.505,0,1,0,168,332,0.506,82,112,0.732,76,134,210,54,22,23,52,98,418
194,11,2004,32,1,4,54,33,1313,208,432,0.481,1,3,0.333,207,429,0.483,114,157,0.726,112,168,280,66,29,32,77,160,531
194,12,2005,33,1,4,24,0,191,13,38,0.342,0,1,0,13,37,0.351,7,15,0.467,17,20,37,9,2,4,15,31,33
194,12,2005,33,1,4,27,0,204,13,42,0.31,0,1,0,13,41,0.317,9,17,0.529,17,22,39,10,2,4,17,38,35
199,1,1982,22,1,3,80,4,1700,311,652,0.477,0,8,0,311,644,0.483,145,212,0.684,157,254,411,147,55,17,106,199,767
199,2,1983,23,1,4,81,81,2722,505,919,0.55,0,5,0,505,914,0.553,196,278,0.705,222,390,612,279,78,21,171,229,1206
199,3,1984,24,1,4,80,66,2600,424,747,0.568,1,6,0.167,423,741,0.571,200,270,0.741,204,378,582,254,105,23,166,256,1049
199,4,1985,25,1,3,82,41,2091,289,493,0.586,1,3,0.333,288,490,0.588,199,257,0.774,133,312,445,234,65,13,140,220,778
199,5,1986,26,1,3,82,33,2139,356,688,0.517,0,19,0,356,669,0.532,183,255,0.718,178,182,360,251,81,10,139,212,895
199,6,1987,27,1,3,63,39,1822,249,462,0.539,0,5,0,249,457,0.545,112,146,0.767,115,193,308,170,52,17,113,173,610
200,1,1980,28,1,3,77,-1,2330,384,760,0.505,1,3,0.333,383,757,0.506,139,209,0.665,192,264,456,279,85,49,189,268,908
200,2,1981,29,1,3,76,-1,2375,431,882,0.489,0,6,0,431,876,0.492,199,281,0.708,150,277,427,240,80,85,197,284,1061
200,3,1982,30,1,3,43,1,979,156,306,0.51,1,3,0.333,155,303,0.512,67,114,0.588,87,139,226,46,25,37,64,133,380
200,3,1982,30,1,3,39,37,1037,178,406,0.438,1,3,0.333,177,403,0.439,101,153,0.66,87,127,214,68,38,24,85,139,458
200,3,1982,30,1,3,82,38,2016,334,712,0.469,2,6,0.333,332,706,0.47,168,267,0.629,174,266,440,114,63,61,149,272,838
202,1,2004,22,1,1,81,2,1385,177,442,0.4,27,86,0.314,150,356,0.421,99,131,0.756,30,103,133,175,88,13,125,171,480
202,2,2005,23,1,1,81,2,1145,115,286,0.402,21,59,0.356,94,227,0.414,121,163,0.742,29,97,126,155,63,13,79,146,372
202,3,2006,24,1,1,18,1,269,33,80,0.413,6,19,0.316,27,61,0.443,27,30,0.9,4,15,19,32,7,0,23,38,99
202,3,2006,24,1,1,40,28,1228,186,388,0.479,16,44,0.364,170,344,0.494,91,117,0.778,19,97,116,188,47,11,96,124,479
202,3,2006,24,1,1,58,29,1497,219,468,0.468,22,63,0.349,197,405,0.486,118,147,0.803,23,112,135,220,54,11,119,162,578
202,4,2007,25,1,1,45,1,503,84,196,0.429,5,29,0.172,79,167,0.473,48,60,0.8,10,28,38,60,23,3,40,70,221
202,5,2008,26,1,1,12,2,259,42,82,0.512,15,37,0.405,27,45,0.6,15,19,0.789,1,24,25,36,6,5,21,27,114
202,5,2008,26,1,1,24,1,310,44,109,0.404,25,65,0.385,19,44,0.432,12,16,0.75,3,17,20,25,8,8,16,38,125
202,5,2008,26,1,1,36,3,569,86,191,0.45,40,102,0.392,46,89,0.517,27,35,0.771,4,41,45,61,14,13,37,65,239
202,6,2009,27,1,1,16,0,166,15,39,0.385,2,14,0.143,13,25,0.52,10,15,0.667,0,15,15,22,10,2,11,21,42
202,6,2009,27,1,1,22,0,206,21,57,0.368,3,19,0.158,18,38,0.474,11,18,0.611,1,17,18,28,11,2,14,26,56
202,7,2010,28,1,1,22,0,244,39,73,0.534,7,24,0.292,32,49,0.653,24,29,0.828,3,20,23,26,12,2,20,30,109
203,1,2002,23,1,1,19,4,228,24,68,0.353,1,7,0.143,23,61,0.377,9,10,0.9,5,13,18,34,17,1,12,29,58
204,1,1985,21,1,4,82,60,2347,427,783,0.545,1,6,0.167,426,777,0.548,293,400,0.733,266,437,703,155,95,80,209,301,1148
204,2,1986,22,1,4,80,80,2952,595,1041,0.572,17,75,0.227,578,966,0.598,396,578,0.685,354,672,1026,312,173,125,350,333,1603
204,3,1987,23,1,4,68,62,2740,557,937,0.594,21,104,0.202,536,833,0.643,429,564,0.761,390,604,994,331,119,104,322,252,1564
204,4,1988,24,1,4,80,80,3170,753,1283,0.587,44,157,0.28,709,1126,0.63,714,951,0.751,385,566,951,254,100,103,304,278,2264
204,5,1989,25,1,4,79,79,3088,700,1208,0.579,35,162,0.216,665,1046,0.636,602,799,0.753,403,583,986,325,126,67,254,262,2037
204,6,1990,26,1,4,79,79,3085,706,1177,0.6,20,92,0.217,686,1085,0.632,557,744,0.749,361,548,909,307,148,50,243,250,1989
204,7,1991,27,1,4,67,67,2498,665,1167,0.57,44,155,0.284,621,1012,0.614,475,658,0.722,258,422,680,284,110,33,210,173,1849
204,8,1992,28,1,4,75,75,2881,622,1126,0.552,32,137,0.234,590,989,0.597,454,653,0.695,271,559,830,308,136,44,235,196,1730
204,9,1993,29,1,4,76,76,2859,716,1376,0.52,67,220,0.305,649,1156,0.561,445,582,0.765,237,691,928,385,119,74,233,196,1944
204,10,1994,30,1,4,65,65,2298,518,1046,0.495,48,178,0.27,470,868,0.541,318,452,0.704,198,529,727,296,101,37,206,160,1402
204,11,1995,31,1,4,68,66,2382,554,1141,0.486,74,219,0.338,480,922,0.521,379,507,0.748,203,553,756,276,110,45,150,201,1561
204,12,1996,32,1,4,71,71,2632,580,1160,0.5,49,175,0.28,531,985,0.539,440,566,0.777,243,578,821,262,114,56,218,208,1649
204,13,1997,33,1,4,53,53,2009,335,692,0.484,58,205,0.283,277,487,0.569,288,415,0.694,212,504,716,248,69,25,151,153,1016
204,14,1998,34,1,4,68,41,2243,361,744,0.485,18,84,0.214,343,660,0.52,296,397,0.746,241,553,794,217,71,28,147,187,1036
204,15,1999,35,1,4,42,40,1526,240,502,0.478,4,25,0.16,236,477,0.495,192,267,0.719,167,349,516,192,43,13,100,89,676
204,16,2000,36,1,4,20,18,620,106,222,0.477,6,26,0.231,100,196,0.51,71,110,0.645,71,138,209,63,14,4,44,48,289
208,1,1980,27,1,4,20,-1,287,24,60,0.4,0,0,-1,24,60,0.4,16,32,0.5,34,43,77,18,5,12,18,52,64
217,1,2005,22,1,1,11,1,169,25,55,0.455,5,15,0.333,20,40,0.5,7,9,0.778,6,15,21,27,5,1,11,16,62
217,1,2005,22,1,1,27,0,314,20,69,0.29,9,37,0.243,11,32,0.344,7,10,0.7,5,14,19,42,14,0,16,35,56
217,1,2005,22,1,1,38,1,483,45,124,0.363,14,52,0.269,31,72,0.431,14,19,0.737,11,29,40,69,19,1,27,51,118
217,2,2006,23,1,1,17,0,261,35,97,0.361,2,13,0.154,33,84,0.393,6,9,0.667,8,14,22,50,10,0,14,12,78
217,2,2006,23,1,1,19,0,282,38,104,0.365,2,14,0.143,36,90,0.4,9,12,0.75,9,16,25,52,10,0,15,13,87
218,1,1998,24,1,1,27,0,256,18,38,0.474,9,21,0.429,9,17,0.529,11,13,0.846,5,30,35,49,10,1,30,28,56
218,2,1999,25,1,2,17,0,183,10,32,0.313,8,24,0.333,2,8,0.25,9,13,0.692,3,17,20,29,7,1,12,24,37
218,3,2000,26,1,1,16,0,159,15,33,0.455,7,18,0.389,8,15,0.533,4,5,0.8,0,12,12,33,2,0,13,23,41
219,1,1993,23,1,2,47,0,552,76,206,0.369,21,63,0.333,55,143,0.385,33,49,0.673,10,33,43,68,35,3,42,57,206
219,2,1994,24,1,2,72,7,1242,158,382,0.414,32,115,0.278,126,267,0.472,97,122,0.795,36,110,146,168,102,17,83,110,445
219,3,1995,25,1,2,52,0,602,57,134,0.425,16,48,0.333,41,86,0.477,61,80,0.763,15,34,49,85,30,4,41,54,191
219,4,1996,26,1,2,68,0,712,91,185,0.492,44,93,0.473,47,92,0.511,31,37,0.838,17,46,63,85,33,11,42,51,257
219,5,1997,27,1,2,58,8,965,100,246,0.407,48,124,0.387,52,122,0.426,37,46,0.804,26,73,99,115,55,3,59,56,285
219,6,1998,28,1,2,49,1,374,38,104,0.365,18,61,0.295,20,43,0.465,27,29,0.931,8,29,37,51,24,3,22,33,121
219,7,1999,29,1,2,43,0,736,59,138,0.428,24,79,0.304,35,59,0.593,71,84,0.845,25,71,96,112,53,5,47,61,213
219,8,2000,30,1,2,62,1,1281,161,346,0.465,66,154,0.429,95,192,0.495,107,116,0.922,38,121,159,150,75,7,85,104,495
219,9,2001,31,1,2,62,2,1010,103,255,0.404,46,132,0.348,57,123,0.463,64,73,0.877,16,78,94,130,28,6,53,66,316
219,10,2002,32,1,2,82,6,1985,255,522,0.489,121,258,0.469,134,264,0.508,108,116,0.931,42,192,234,274,94,20,111,134,739
219,11,2003,33,1,2,80,0,1473,191,424,0.45,87,214,0.407,104,210,0.495,86,100,0.86,33,147,180,206,63,14,81,104,555
219,12,2004,34,1,2,57,9,1101,120,297,0.404,51,138,0.37,69,159,0.434,60,71,0.845,25,98,123,147,57,8,53,66,351
219,13,2005,35,1,2,16,0,275,31,77,0.403,11,32,0.344,20,45,0.444,10,13,0.769,4,17,21,28,14,2,14,28,83
219,13,2005,35,1,2,53,2,1230,130,291,0.447,60,133,0.451,70,158,0.443,52,58,0.897,22,116,138,139,46,7,53,67,372
219,13,2005,35,1,2,69,2,1505,161,368,0.438,71,165,0.43,90,203,0.443,62,71,0.873,26,133,159,167,60,9,67,95,455
219,14,2006,36,1,2,20,0,342,25,65,0.385,12,32,0.375,13,33,0.394,24,29,0.828,1,30,31,26,13,1,22,25,86
220,1,1996,24,1,2,79,44,1898,283,597,0.474,123,296,0.416,160,301,0.532,111,137,0.81,38,130,168,230,95,22,120,196,800
220,2,1997,25,1,2,59,0,1094,155,379,0.409,56,173,0.324,99,206,0.481,76,93,0.817,30,80,110,154,51,15,76,88,442
220,3,1998,26,1,2,17,0,259,23,62,0.371,12,34,0.353,11,28,0.393,12,12,1,2,26,28,21,14,4,9,30,70
220,3,1998,26,1,2,41,36,1341,190,444,0.428,78,195,0.4,112,249,0.45,103,122,0.844,27,116,143,132,50,23,95,88,561
220,3,1998,26,1,2,58,36,1600,213,506,0.421,90,229,0.393,123,277,0.444,115,134,0.858,29,142,171,153,64,27,104,118,631
220,4,1999,27,1,2,37,30,1181,141,356,0.396,52,172,0.302,89,184,0.484,78,101,0.772,39,105,144,116,42,11,72,98,412
220,5,2000,28,1,2,80,74,2726,327,707,0.463,164,399,0.411,163,308,0.529,127,157,0.809,50,322,372,291,103,31,142,228,945
220,6,2001,29,1,2,67,20,1778,198,401,0.494,109,229,0.476,89,172,0.517,84,103,0.816,33,178,211,225,80,14,86,126,589
220,7,2002,30,1,2,81,81,3040,401,790,0.508,164,387,0.424,237,403,0.588,198,234,0.846,58,383,441,426,147,37,165,182,1164
220,8,2003,31,1,2,75,68,2480,264,577,0.458,118,293,0.403,146,284,0.514,128,161,0.795,48,253,301,384,113,15,142,199,774
220,9,2004,32,1,2,59,53,1803,215,427,0.504,114,252,0.452,101,175,0.577,91,110,0.827,21,183,204,342,85,16,139,121,635
220,10,2005,33,1,2,81,8,1742,194,459,0.423,100,280,0.357,94,179,0.525,113,135,0.837,29,161,190,178,39,20,64,123,601
220,11,2006,34,1,2,74,5,1259,156,345,0.452,80,202,0.396,76,143,0.531,39,59,0.661,29,130,159,123,39,27,52,99,431
220,12,2007,35,1,2,75,28,1631,202,425,0.475,128,287,0.446,74,138,0.536,103,117,0.88,17,143,160,138,56,12,61,88,635
220,13,2008,36,1,3,31,1,554,77,160,0.481,48,112,0.429,29,48,0.604,19,20,0.95,12,43,55,54,17,3,18,43,221
220,14,2009,37,1,2,56,1,857,70,172,0.407,49,131,0.374,21,41,0.512,19,20,0.95,17,77,94,78,24,3,48,45,208
223,1,2006,22,1,3,19,0,141,15,37,0.405,1,7,0.143,14,30,0.467,8,10,0.8,7,21,28,8,9,2,9,17,39
225,1,1980,28,1,4,12,-1,164,12,34,0.353,0,0,-1,12,34,0.353,10,15,0.667,11,22,33,14,8,0,9,27,34
226,1,2002,26,1,5,27,10,408,53,132,0.402,4,12,0.333,49,120,0.408,29,37,0.784,32,64,96,22,10,5,32,94,139
227,1,1980,23,1,2,16,-1,235,72,146,0.493,8,19,0.421,64,127,0.504,28,39,0.718,13,16,29,31,14,2,20,26,180
227,2,1981,24,1,2,77,-1,1560,439,902,0.487,14,54,0.259,425,848,0.501,170,199,0.854,71,86,157,196,82,6,149,120,1062
227,3,1982,25,1,2,75,0,1229,327,692,0.473,12,41,0.293,315,651,0.484,166,211,0.787,53,55,108,111,41,5,93,100,832
227,4,1983,26,1,2,15,3,277,53,129,0.411,2,5,0.4,51,124,0.411,10,20,0.5,10,8,18,14,13,3,12,18,118
227,4,1983,26,1,2,19,3,304,55,145,0.379,2,5,0.4,53,140,0.379,11,22,0.5,11,8,19,14,14,3,12,19,123
228,1,2006,22,1,4,57,3,495,34,80,0.425,0,1,0,34,79,0.43,33,53,0.623,61,83,144,7,15,11,38,111,101
229,1,2003,25,1,4,75,2,1248,197,467,0.422,18,81,0.222,179,386,0.464,69,88,0.784,82,175,257,52,42,16,69,120,481
232,1,1990,25,1,2,59,8,729,93,170,0.547,1,4,0.25,92,166,0.554,55,82,0.671,44,80,124,38,35,11,32,94,242
232,2,1991,26,1,2,16,4,263,38,86,0.442,0,2,0,38,84,0.452,20,29,0.69,21,32,53,15,19,6,17,25,96
232,2,1991,26,1,2,40,4,682,95,196,0.485,3,22,0.136,92,174,0.529,50,64,0.781,62,61,123,47,41,12,36,83,243
232,2,1991,26,1,2,56,8,945,133,282,0.472,3,24,0.125,130,258,0.504,70,93,0.753,83,93,176,62,60,18,53,108,339
233,1,1983,26,1,5,54,5,558,85,191,0.445,0,3,0,85,188,0.452,8,17,0.471,45,74,119,29,15,13,28,56,178
234,1,2003,24,1,5,55,0,682,96,206,0.466,0,2,0,96,204,0.471,70,103,0.68,65,100,165,16,9,22,46,135,262
234,2,2004,25,1,4,12,0,132,16,32,0.5,0,1,0,16,31,0.516,9,12,0.75,11,20,31,5,2,5,5,23,41
234,2,2004,25,1,4,14,1,147,27,49,0.551,1,1,1,26,48,0.542,5,8,0.625,11,24,35,5,1,6,11,31,60
234,2,2004,25,1,5,36,4,487,60,128,0.469,0,1,0,60,127,0.472,30,56,0.536,42,79,121,10,14,18,22,69,150
234,2,2004,25,1,5,62,5,766,103,209,0.493,1,3,0.333,102,206,0.495,44,76,0.579,64,123,187,20,17,29,38,123,251
234,3,2006,27,1,4,18,0,119,12,32,0.375,0,0,-1,12,32,0.375,12,16,0.75,7,26,33,2,2,1,7,8,36
234,3,2006,27,1,5,23,0,281,33,72,0.458,0,0,-1,33,72,0.458,16,19,0.842,38,46,84,2,9,7,13,48,82
234,3,2006,27,1,5,41,0,400,45,104,0.433,0,0,-1,45,104,0.433,28,35,0.8,45,72,117,4,11,8,20,56,118
236,1,1986,23,1,2,64,0,639,101,222,0.455,0,7,0,101,215,0.47,75,103,0.728,12,50,62,74,23,3,47,80,277
236,2,1987,24,1,2,64,8,804,144,315,0.457,0,10,0,144,305,0.472,93,126,0.738,16,44,60,124,29,5,60,76,381
236,3,1988,25,1,2,67,1,1227,278,613,0.454,16,41,0.39,262,572,0.458,141,188,0.75,26,87,113,158,31,5,75,84,713
236,4,1989,26,1,2,82,0,1672,287,628,0.457,11,34,0.324,276,594,0.465,194,238,0.815,30,110,140,197,42,9,104,125,779
236,5,1990,27,1,2,60,48,1477,275,544,0.506,2,13,0.154,273,531,0.514,102,135,0.756,27,72,99,154,28,3,89,115,654
236,6,1991,28,1,2,79,2,1863,397,862,0.461,14,49,0.286,383,813,0.471,270,316,0.854,34,125,159,217,45,6,113,145,1078
236,7,1992,29,1,2,76,2,1637,316,659,0.48,2,17,0.118,314,642,0.489,145,171,0.848,19,93,112,159,36,5,91,116,779
236,8,1993,30,1,2,41,0,497,83,200,0.415,1,6,0.167,82,194,0.423,56,72,0.778,4,25,29,54,9,5,22,39,223
236,9,1994,31,1,2,51,1,814,130,273,0.476,5,19,0.263,125,254,0.492,73,97,0.753,7,32,39,83,22,1,41,66,338
236,10,1995,32,1,2,28,0,280,43,114,0.377,11,31,0.355,32,83,0.386,19,26,0.731,3,8,11,37,8,1,17,28,116
255,1,2002,25,1,2,74,12,890,103,240,0.429,12,44,0.273,91,196,0.464,36,48,0.75,31,80,111,71,21,4,48,109,254
255,2,2003,26,1,2,75,32,1173,93,211,0.441,21,51,0.412,72,160,0.45,23,34,0.676,47,98,145,57,52,8,43,134,230
255,3,2004,27,1,2,82,4,2020,329,805,0.409,62,166,0.373,267,639,0.418,195,248,0.786,60,181,241,107,63,13,111,262,915
255,4,2005,28,1,2,63,32,1790,303,667,0.454,54,134,0.403,249,533,0.467,112,150,0.747,48,153,201,91,44,8,79,205,772
255,5,2006,29,1,2,79,79,2959,425,930,0.457,197,446,0.442,228,484,0.471,115,146,0.788,44,209,253,207,76,22,89,248,1162
255,6,2007,30,1,2,78,78,2917,410,950,0.432,205,496,0.413,205,454,0.452,118,152,0.776,48,203,251,196,50,22,83,233,1143
255,7,2008,31,1,2,75,75,2646,317,753,0.421,176,439,0.401,141,314,0.449,79,91,0.868,47,227,274,168,54,27,65,220,889
255,8,2009,32,1,2,22,22,712,76,177,0.429,44,94,0.468,32,83,0.386,16,21,0.762,8,56,64,29,13,2,18,57,212
255,8,2009,32,1,2,45,44,1603,223,507,0.44,70,177,0.395,153,330,0.464,71,81,0.877,33,146,179,113,37,6,68,109,587
255,8,2009,32,1,2,67,66,2315,299,684,0.437,114,271,0.421,185,413,0.448,87,102,0.853,41,202,243,142,50,8,86,166,799
255,9,2010,33,1,2,5,5,157,24,55,0.436,9,24,0.375,15,31,0.484,3,3,1,5,16,21,10,4,2,5,13,60
255,9,2010,33,1,2,6,5,180,28,61,0.459,12,27,0.444,16,34,0.471,3,3,1,5,18,23,13,4,2,5,15,71
255,10,2011,34,1,2,68,63,2097,191,467,0.409,68,193,0.352,123,274,0.449,91,102,0.892,31,145,176,118,56,14,63,169,541
255,11,2012,35,1,2,34,33,796,81,174,0.466,34,87,0.391,47,87,0.54,21,25,0.84,6,43,49,38,13,2,21,78,217
259,1,1986,21,1,5,79,37,2088,324,661,0.49,1,3,0.333,323,658,0.491,229,307,0.746,161,439,600,79,64,206,145,286,878
259,2,1987,22,1,5,72,61,2230,320,713,0.449,0,2,0,320,711,0.45,188,263,0.715,134,452,586,135,60,187,184,251,828
259,3,1988,23,1,5,66,59,2171,340,693,0.491,0,8,0,340,685,0.496,180,255,0.706,112,418,530,172,50,225,223,203,860
259,4,1989,24,1,5,79,62,2585,491,907,0.541,0,2,0,491,905,0.543,317,426,0.744,164,532,696,157,57,221,237,221,1299
259,5,1990,25,1,5,71,58,2313,362,688,0.526,0,1,0,362,687,0.527,235,321,0.732,156,501,657,159,59,187,187,217,959
259,6,1991,26,1,5,31,27,899,157,313,0.502,0,0,-1,157,313,0.502,87,126,0.69,62,192,254,45,28,54,97,74,401
259,6,1991,26,1,5,39,38,1337,229,465,0.492,0,0,-1,229,465,0.492,123,169,0.728,95,374,469,74,26,91,138,110,581
259,6,1991,26,1,5,70,65,2236,386,778,0.496,0,0,-1,386,778,0.496,210,295,0.712,157,566,723,119,54,145,235,184,982
259,7,1992,27,1,5,63,61,1941,354,740,0.478,0,2,0,354,738,0.48,171,249,0.687,130,383,513,76,39,118,175,185,879
259,8,1993,28,1,5,28,0,306,52,108,0.481,0,0,-1,52,108,0.481,22,37,0.595,24,72,96,10,14,13,36,61,126
259,8,1993,28,1,5,31,6,448,81,163,0.497,0,0,-1,81,163,0.497,47,67,0.701,27,86,113,12,17,35,42,73,209
259,8,1993,28,1,5,59,6,754,133,271,0.491,0,0,-1,133,271,0.491,69,104,0.663,51,158,209,22,31,48,78,134,335
259,9,1994,29,1,5,77,74,1817,283,589,0.48,0,0,-1,283,589,0.48,152,214,0.71,135,364,499,44,35,90,97,198,718
259,10,1995,30,1,5,61,57,1598,271,531,0.51,0,0,-1,271,531,0.51,133,175,0.76,94,346,440,38,23,64,125,151,675
259,11,1996,31,1,5,13,13,404,71,161,0.441,0,0,-1,71,161,0.441,39,56,0.696,31,72,103,16,10,15,34,40,181
259,11,1996,31,1,5,70,58,1492,223,429,0.52,0,3,0,223,426,0.523,101,138,0.732,110,326,436,48,35,70,110,184,547
259,11,1996,31,1,5,83,71,1896,294,590,0.498,0,3,0,294,587,0.501,140,194,0.722,141,398,539,64,45,85,144,224,728
259,12,1998,33,1,5,14,0,197,22,41,0.537,0,0,-1,22,41,0.537,19,30,0.633,18,35,53,3,4,4,12,26,63
262,1,1993,23,1,1,75,2,857,110,260,0.423,26,80,0.325,84,180,0.467,30,41,0.732,12,51,63,136,30,0,50,110,276
262,2,1994,24,1,1,74,5,983,105,263,0.399,27,75,0.36,78,188,0.415,11,15,0.733,16,74,90,163,39,1,40,84,248
265,1,1989,24,1,2,64,21,1406,255,567,0.45,65,160,0.406,190,407,0.467,131,166,0.789,57,140,197,80,37,22,82,197,706
266,1,1990,24,1,3,55,34,990,137,286,0.479,0,0,-1,137,286,0.479,64,96,0.667,84,104,188,54,23,10,62,133,338
266,2,1991,25,1,3,27,13,334,40,107,0.374,0,0,-1,40,107,0.374,35,47,0.745,30,34,64,28,8,2,20,50,115
266,3,1992,26,1,3,52,45,831,79,209,0.378,0,1,0,79,208,0.38,35,50,0.7,62,99,161,38,19,9,33,121,193
266,3,1992,26,1,3,54,45,833,80,211,0.379,0,1,0,80,210,0.381,35,50,0.7,63,99,162,38,19,9,33,122,195
269,1,1987,22,1,3,56,45,1567,401,758,0.529,0,3,0,401,755,0.531,186,287,0.648,132,170,302,104,36,40,153,188,988
269,1,1987,22,1,3,63,45,1586,407,766,0.531,0,3,0,407,763,0.533,187,288,0.649,136,173,309,105,38,40,153,196,1001
269,2,1988,23,1,3,73,56,1922,540,960,0.563,0,0,-1,540,960,0.563,192,320,0.6,176,219,395,110,55,63,162,207,1272
269,3,1989,24,1,4,29,17,556,108,231,0.468,0,0,-1,108,231,0.468,43,63,0.683,32,83,115,20,10,13,40,69,259
269,3,1989,24,1,4,40,14,799,146,270,0.541,1,2,0.5,145,268,0.541,57,80,0.713,54,98,152,57,19,35,49,114,350
269,3,1989,24,1,4,69,31,1355,254,501,0.507,1,2,0.5,253,499,0.507,100,143,0.699,86,181,267,77,29,48,89,183,609
270,1,1980,23,1,1,68,-1,869,88,250,0.352,10,26,0.385,78,224,0.348,58,87,0.667,16,47,63,139,58,5,104,105,244
271,1,1980,25,1,5,17,-1,502,86,187,0.46,1,4,0.25,85,183,0.464,33,44,0.75,30,90,120,51,19,18,51,68,206
271,1,1980,25,1,5,56,-1,1389,213,431,0.494,0,1,0,213,430,0.495,66,97,0.68,96,237,333,127,54,74,106,178,492
271,1,1980,25,1,5,73,-1,1891,299,618,0.484,1,5,0.2,298,613,0.486,99,141,0.702,126,327,453,178,73,92,157,246,698
271,2,1981,26,1,5,59,-1,1956,364,770,0.473,0,4,0,364,766,0.475,196,254,0.772,124,276,400,172,72,67,190,184,924
271,3,1982,27,1,5,75,72,2467,405,802,0.505,3,11,0.273,402,791,0.508,127,158,0.804,219,434,653,159,66,98,160,214,940
271,4,1983,28,1,5,21,15,599,85,182,0.467,0,1,0,85,181,0.47,38,50,0.76,53,102,155,49,14,17,35,61,208
271,5,1984,29,1,5,82,58,1734,248,451,0.55,0,1,0,248,450,0.551,83,101,0.822,117,292,409,130,71,53,79,230,579
271,6,1985,30,1,5,72,35,1401,201,397,0.506,0,3,0,201,394,0.51,76,94,0.809,103,221,324,93,53,44,68,207,478
271,7,1986,31,1,5,72,51,1344,201,415,0.484,1,2,0.5,200,413,0.484,66,83,0.795,118,258,376,80,58,51,58,196,469
271,8,1987,32,1,5,73,2,895,140,316,0.443,2,7,0.286,138,309,0.447,47,58,0.81,80,151,231,39,39,28,45,138,329
272,1,1996,23,1,1,59,1,571,69,163,0.423,8,25,0.32,61,138,0.442,75,90,0.833,11,33,44,97,20,3,63,80,221
272,2,1997,24,1,1,76,46,2064,274,620,0.442,57,155,0.368,217,465,0.467,149,197,0.756,36,130,166,318,98,5,153,221,754
272,3,1998,25,1,1,82,0,1547,201,480,0.419,21,70,0.3,180,410,0.439,112,131,0.855,28,94,122,281,85,5,111,193,535
272,4,1999,26,1,1,49,0,1043,127,305,0.416,22,59,0.373,105,246,0.427,70,83,0.843,19,61,80,169,42,4,62,111,346
272,5,2000,27,1,1,82,0,1691,271,561,0.483,35,93,0.376,236,468,0.504,156,190,0.821,16,126,142,272,76,5,107,204,733
272,6,2001,28,1,1,77,21,2457,347,788,0.44,37,97,0.381,310,691,0.449,187,226,0.827,38,184,222,473,110,11,127,246,918
272,7,2002,29,1,1,30,18,793,112,254,0.441,8,25,0.32,104,229,0.454,47,51,0.922,10,71,81,149,32,1,40,72,279
272,7,2002,29,1,1,44,3,954,116,264,0.439,13,34,0.382,103,230,0.448,57,65,0.877,10,60,70,175,57,6,59,101,302
272,7,2002,29,1,1,74,21,1747,228,518,0.44,21,59,0.356,207,459,0.451,104,116,0.897,20,131,151,324,89,7,99,173,581
272,8,2003,30,1,1,72,52,1807,231,583,0.396,36,109,0.33,195,474,0.411,105,123,0.854,26,121,147,255,44,7,106,174,603
272,9,2004,31,1,1,61,1,762,64,172,0.372,3,20,0.15,61,152,0.401,40,46,0.87,17,51,68,112,31,4,33,66,171
272,10,2005,32,1,1,76,6,1461,190,452,0.42,26,85,0.306,164,367,0.447,108,122,0.885,19,88,107,143,66,9,67,148,514
276,1,1980,30,1,1,82,-1,2035,251,626,0.401,11,52,0.212,240,574,0.418,226,286,0.79,65,143,208,307,62,6,147,161,739
276,2,1981,31,1,1,73,-1,1112,118,306,0.386,32,95,0.337,86,211,0.408,67,98,0.684,25,49,74,200,47,2,76,85,335
277,1,1999,20,1,1,50,50,1758,260,605,0.43,15,74,0.203,245,531,0.461,127,169,0.751,30,106,136,325,78,5,146,122,662
277,2,2000,21,1,1,82,82,3155,459,1031,0.445,77,212,0.363,382,819,0.466,195,250,0.78,73,233,306,665,132,15,247,171,1190
277,3,2001,22,1,1,82,82,3190,525,1157,0.454,108,285,0.379,417,872,0.478,143,188,0.761,47,257,304,685,107,12,248,148,1301
277,4,2002,23,1,1,80,80,2659,446,985,0.453,51,138,0.37,395,847,0.466,155,193,0.803,37,185,222,403,87,15,134,133,1098
277,5,2003,24,1,1,55,55,1835,329,700,0.47,56,137,0.409,273,563,0.485,161,187,0.861,34,113,147,285,72,8,127,93,875
277,6,2004,25,1,1,82,82,2980,527,1170,0.45,148,378,0.392,379,792,0.479,304,373,0.815,67,210,277,444,112,18,175,146,1506
277,7,2005,26,1,1,80,80,3084,560,1264,0.443,131,364,0.36,429,900,0.477,320,413,0.775,77,255,332,541,124,30,203,191,1571
277,8,2006,27,1,1,82,82,3167,597,1382,0.432,192,497,0.386,405,885,0.458,342,403,0.849,29,211,240,444,82,10,199,169,1728
277,9,2007,28,1,1,82,82,2784,471,1166,0.404,173,481,0.36,298,685,0.435,288,347,0.83,39,224,263,388,88,6,197,139,1403
277,10,2008,29,1,1,15,12,473,78,192,0.406,24,61,0.393,54,131,0.412,23,31,0.742,11,45,56,75,19,2,38,34,203
277,10,2008,29,1,1,33,32,1100,170,411,0.414,69,187,0.369,101,224,0.451,55,69,0.797,5,99,104,215,35,2,81,63,464
277,10,2008,29,1,1,48,44,1573,248,603,0.411,93,248,0.375,155,355,0.437,78,100,0.78,16,144,160,290,54,4,119,97,667
277,11,2009,30,1,1,79,79,2740,437,1005,0.435,167,428,0.39,270,577,0.468,135,171,0.789,38,240,278,392,98,11,128,145,1176
277,12,2010,31,1,1,80,80,2195,268,644,0.416,126,324,0.389,142,320,0.444,68,79,0.861,20,164,184,310,67,3,90,157,730
277,13,2011,32,1,1,22,12,582,55,126,0.437,40,88,0.455,15,38,0.395,10,16,0.625,2,47,49,55,11,3,32,47,160
277,13,2011,32,1,1,56,56,1674,192,441,0.435,113,256,0.441,79,185,0.427,29,46,0.63,15,128,143,202,38,6,68,125,526
277,13,2011,32,1,1,80,68,2285,248,576,0.431,153,348,0.44,95,228,0.417,39,62,0.629,17,178,195,265,50,9,101,175,688
277,14,2012,33,1,1,39,4,557,35,124,0.282,27,85,0.318,8,39,0.205,6,8,0.75,5,54,59,80,21,3,20,45,103
287,1,1986,23,1,5,48,0,409,44,94,0.468,0,0,-1,44,94,0.468,36,67,0.537,25,66,91,17,3,12,28,65,124
287,2,1987,24,1,5,30,0,160,20,51,0.392,0,0,-1,20,51,0.392,13,28,0.464,11,25,36,13,4,9,15,33,53
287,3,1988,25,1,5,73,1,658,58,132,0.439,0,0,-1,58,132,0.439,46,65,0.708,52,82,134,35,8,29,49,108,162
287,4,1989,26,1,5,37,0,208,24,52,0.462,0,0,-1,24,52,0.462,20,25,0.8,11,33,44,12,3,13,14,36,68
287,5,1990,27,1,5,40,33,481,33,87,0.379,0,0,-1,33,87,0.379,17,31,0.548,28,71,99,24,1,22,30,93,83
287,5,1990,27,1,5,47,33,531,39,98,0.398,0,0,-1,39,98,0.398,20,37,0.541,29,79,108,25,1,22,35,102,98
288,1,1980,23,1,4,82,82,2955,693,1463,0.474,58,143,0.406,635,1320,0.481,301,360,0.836,216,636,852,370,143,53,263,279,1745
288,2,1981,24,1,4,82,82,3239,719,1503,0.478,20,74,0.27,699,1429,0.489,283,328,0.863,191,704,895,451,161,63,289,239,1741
288,3,1982,25,1,4,77,58,2923,711,1414,0.503,11,52,0.212,700,1362,0.514,328,380,0.863,200,637,837,447,143,66,254,244,1761
288,4,1983,26,1,4,79,79,2982,747,1481,0.504,22,77,0.286,725,1404,0.516,351,418,0.84,193,677,870,458,148,71,240,197,1867
288,5,1984,27,1,4,79,77,3028,758,1542,0.492,18,73,0.247,740,1469,0.504,374,421,0.888,181,615,796,520,144,69,237,197,1908
288,6,1985,28,1,3,80,77,3161,918,1760,0.522,56,131,0.427,862,1629,0.529,403,457,0.882,164,678,842,531,129,98,248,208,2295
288,7,1986,29,1,3,82,81,3113,796,1606,0.496,82,194,0.423,714,1412,0.506,441,492,0.896,190,615,805,557,166,51,266,182,2115
288,8,1987,30,1,3,74,73,3005,786,1497,0.525,90,225,0.4,696,1272,0.547,414,455,0.91,124,558,682,566,135,70,240,185,2076
288,9,1988,31,1,3,76,75,2965,881,1672,0.527,98,237,0.414,783,1435,0.546,415,453,0.916,108,595,703,467,125,57,213,157,2275
288,10,1989,32,1,3,6,6,189,49,104,0.471,0,0,-1,49,104,0.471,18,19,0.947,1,36,37,29,6,5,11,18,116
288,11,1990,33,1,3,75,75,2944,718,1517,0.473,65,195,0.333,653,1322,0.494,319,343,0.93,90,622,712,562,106,61,243,173,1820
288,12,1991,34,1,3,60,60,2277,462,1017,0.454,77,198,0.389,385,819,0.47,163,183,0.891,53,456,509,431,108,58,187,118,1164
288,13,1992,35,1,3,45,45,1662,353,758,0.466,52,128,0.406,301,630,0.478,150,162,0.926,46,388,434,306,42,33,125,82,908
289,1,1980,24,1,2,82,-1,2885,781,1546,0.505,10,36,0.278,771,1510,0.511,286,412,0.694,170,161,331,202,136,22,179,226,1858
289,2,1981,25,1,2,71,-1,2593,710,1306,0.544,10,35,0.286,700,1271,0.551,317,455,0.697,119,139,258,233,93,18,173,172,1747
289,3,1982,26,1,2,37,22,1025,225,480,0.469,0,10,0,225,470,0.479,74,127,0.583,30,67,97,124,30,5,64,74,524
289,4,1983,27,1,2,62,54,1885,426,834,0.511,2,6,0.333,424,828,0.512,82,145,0.566,53,97,150,239,85,16,114,155,936
289,5,1984,28,1,2,69,57,2168,583,1147,0.508,5,20,0.25,578,1127,0.513,194,319,0.608,74,96,170,266,86,17,170,180,1365
289,6,1985,29,1,2,56,45,1842,495,968,0.511,4,21,0.19,491,947,0.518,161,259,0.622,60,88,148,232,84,7,117,145,1155
289,7,1986,30,1,2,77,74,2395,542,1056,0.513,8,22,0.364,534,1034,0.516,122,210,0.581,88,114,202,261,85,17,179,228,1214
289,8,1987,31,1,2,7,6,127,19,42,0.452,0,1,0,19,41,0.463,6,9,0.667,3,4,7,17,3,0,9,16,44
289,9,1988,32,1,2,67,59,1882,337,736,0.458,9,25,0.36,328,711,0.461,47,92,0.511,73,94,167,222,54,11,129,143,730
289,10,1989,33,1,2,13,0,108,18,36,0.5,1,3,0.333,17,33,0.515,0,2,0,4,9,13,9,3,1,12,10,37
291,1,1982,22,1,2,82,16,1979,439,855,0.513,1,4,0.25,438,851,0.515,212,276,0.768,97,157,254,105,46,30,113,122,1091
291,2,1983,23,1,2,75,62,2349,513,1042,0.492,3,15,0.2,510,1027,0.497,297,381,0.78,108,185,293,185,37,29,118,116,1326
291,3,1984,24,1,2,81,81,3025,721,1320,0.546,1,11,0.091,720,1309,0.55,372,458,0.812,124,249,373,288,56,37,169,127,1815
291,4,1985,25,1,2,81,80,2834,625,1230,0.508,6,20,0.3,619,1210,0.512,342,413,0.828,107,193,300,289,61,16,162,96,1598
291,5,1986,26,1,2,82,81,2787,677,1318,0.514,4,29,0.138,673,1289,0.522,404,483,0.836,88,203,291,271,79,25,189,138,1762
291,6,1987,27,1,2,80,80,2758,626,1264,0.495,5,15,0.333,621,1249,0.497,419,474,0.884,96,182,278,266,64,21,174,142,1676
291,7,1988,28,1,2,71,69,2580,497,1050,0.473,0,5,0,497,1045,0.476,331,379,0.873,82,164,246,262,64,18,144,112,1325
291,8,1989,29,1,2,78,78,2946,594,1249,0.476,30,85,0.353,564,1164,0.485,316,370,0.854,70,203,273,288,65,20,165,137,1534
291,9,1990,30,1,2,80,80,2934,626,1256,0.498,13,43,0.302,613,1213,0.505,287,340,0.844,88,192,280,289,77,21,174,128,1552
291,10,1991,31,1,2,80,80,2965,634,1316,0.482,40,114,0.351,594,1202,0.494,282,326,0.865,63,193,256,301,69,19,159,153,1590
291,11,1992,32,1,2,75,74,2527,535,1161,0.461,65,169,0.385,470,992,0.474,239,266,0.898,78,161,239,204,50,22,153,134,1374
291,12,1993,33,1,2,60,33,1434,239,539,0.443,31,73,0.425,208,466,0.446,71,90,0.789,23,79,102,157,22,10,65,129,580
291,13,1994,34,1,2,55,1,969,161,369,0.436,30,84,0.357,131,285,0.46,48,53,0.906,23,70,93,76,25,6,44,100,400
292,1,1993,22,1,3,27,0,109,14,42,0.333,0,3,0,14,39,0.359,6,8,0.75,10,13,23,7,4,2,5,14,34
293,1,1985,21,1,3,60,0,551,87,237,0.367,0,2,0,87,235,0.37,28,55,0.509,42,54,96,26,25,3,44,55,202
295,1,1988,22,1,1,10,0,112,15,41,0.366,2,11,0.182,13,30,0.433,5,6,0.833,2,4,6,18,3,0,8,16,37
296,1,2007,23,1,1,14,0,166,9,30,0.3,1,5,0.2,8,25,0.32,6,6,1,6,9,15,17,5,0,12,9,25
298,1,1991,24,1,2,38,0,214,26,61,0.426,2,16,0.125,24,45,0.533,10,14,0.714,4,16,20,26,9,2,18,35,64
298,2,1992,25,1,2,43,0,189,25,55,0.455,6,16,0.375,19,39,0.487,8,11,0.727,9,13,22,19,14,1,14,26,64
298,3,1993,26,1,2,61,2,642,65,150,0.433,11,43,0.256,54,107,0.505,20,32,0.625,18,50,68,72,16,5,31,61,161
301,1,1982,23,1,2,49,2,546,102,222,0.459,4,18,0.222,98,204,0.48,18,28,0.643,14,27,41,68,23,2,54,57,226
302,1,1990,22,1,1,50,17,1267,212,571,0.371,18,80,0.225,194,491,0.395,63,81,0.778,42,98,140,210,82,14,111,110,505
302,2,1991,23,1,1,72,70,2585,432,1039,0.416,14,91,0.154,418,948,0.441,139,176,0.79,67,182,249,441,169,40,207,180,1017
302,3,1992,24,1,1,72,67,2548,429,993,0.432,12,54,0.222,417,939,0.444,126,177,0.712,101,168,269,492,170,40,152,182,996
302,4,1993,25,1,1,80,78,2820,414,964,0.429,118,315,0.375,296,649,0.456,123,169,0.728,89,191,280,671,203,23,187,156,1069
302,5,1994,26,1,1,81,81,2915,444,1079,0.411,114,341,0.334,330,738,0.447,116,159,0.73,117,307,424,789,212,44,196,144,1118
302,6,1995,27,1,1,80,80,3069,509,1198,0.425,199,555,0.359,310,643,0.482,156,214,0.729,117,276,393,616,200,26,242,164,1373
302,7,1996,28,1,1,81,81,2893,455,1123,0.405,231,623,0.371,224,500,0.448,127,170,0.747,110,222,332,478,212,17,188,151,1268
302,8,1997,29,1,1,78,78,3056,501,1159,0.432,221,604,0.366,280,555,0.505,131,174,0.753,114,299,413,463,212,20,185,141,1354
302,9,1998,30,1,1,70,69,2700,368,938,0.392,90,334,0.269,278,604,0.46,95,134,0.709,81,260,341,469,183,21,176,122,921
302,10,1999,31,1,1,48,48,1763,247,651,0.379,77,251,0.307,170,400,0.425,69,91,0.758,45,179,224,278,99,9,115,61,640
302,11,2000,32,1,1,73,72,2459,327,837,0.391,101,301,0.336,226,536,0.422,67,95,0.705,55,215,270,489,146,22,143,122,822
302,12,2001,33,1,1,69,59,2352,317,801,0.396,73,225,0.324,244,576,0.424,53,76,0.697,71,201,272,462,163,20,128,134,760
302,13,2002,34,1,1,35,0,599,50,146,0.342,15,42,0.357,35,104,0.337,4,8,0.5,8,44,52,114,24,4,37,20,119
306,1,1994,25,1,4,67,8,690,76,174,0.437,0,0,-1,76,174,0.437,46,75,0.613,76,118,194,56,19,33,52,93,198
306,2,1995,26,1,4,68,9,889,100,210,0.476,0,2,0,100,208,0.481,38,67,0.567,107,133,240,60,26,33,59,146,238
306,3,1996,27,1,4,57,2,715,79,167,0.473,0,2,0,79,165,0.479,25,44,0.568,69,101,170,42,25,35,47,109,183
306,4,1997,28,1,4,58,18,1009,92,179,0.514,1,3,0.333,91,176,0.517,56,83,0.675,113,163,276,35,22,26,50,121,241
306,5,1998,29,1,4,70,3,1029,107,187,0.572,0,4,0,107,183,0.585,39,78,0.5,114,184,298,37,29,25,51,157,253
306,6,1999,30,1,4,14,3,162,13,33,0.394,0,1,0,13,32,0.406,6,12,0.5,24,22,46,2,1,4,6,27,32
306,6,1999,30,1,4,20,0,368,23,67,0.343,0,0,-1,23,67,0.343,22,42,0.524,34,71,105,10,18,12,15,47,68
306,6,1999,30,1,4,34,3,530,36,100,0.36,0,1,0,36,99,0.364,28,54,0.519,58,93,151,12,19,16,21,74,100
306,7,2000,31,1,4,38,1,446,44,89,0.494,0,2,0,44,87,0.506,19,33,0.576,52,61,113,10,15,7,28,78,107
306,8,2001,32,1,4,30,6,387,23,47,0.489,0,0,-1,23,47,0.489,8,15,0.533,35,50,85,8,13,5,18,75,54
306,8,2001,32,1,4,38,0,918,107,247,0.433,2,8,0.25,105,239,0.439,43,68,0.632,146,169,315,51,29,17,55,90,259
306,8,2001,32,1,4,68,6,1305,130,294,0.442,2,8,0.25,128,286,0.448,51,83,0.614,181,219,400,59,42,22,73,165,313
306,9,2002,33,1,4,72,21,1426,115,251,0.458,0,1,0,115,250,0.46,29,45,0.644,149,219,368,44,49,26,52,176,259
306,10,2003,34,1,5,50,3,836,65,134,0.485,0,0,-1,65,134,0.485,20,35,0.571,68,137,205,50,33,19,43,121,150
306,11,2004,35,1,5,16,0,294,18,47,0.383,0,0,-1,18,47,0.383,2,3,0.667,22,47,69,10,11,5,8,49,38
306,11,2004,35,1,4,46,3,756,97,206,0.471,0,3,0,97,203,0.478,13,24,0.542,76,130,206,45,38,19,35,86,207
306,11,2004,35,1,4,62,3,1050,115,253,0.455,0,3,0,115,250,0.46,15,27,0.556,98,177,275,55,49,24,43,135,245
307,1,2001,25,1,5,64,50,1098,101,200,0.505,0,0,-1,101,200,0.505,46,66,0.697,97,134,231,32,39,76,62,183,248
307,2,2002,26,1,5,44,0,415,32,76,0.421,0,0,-1,32,76,0.421,30,37,0.811,26,59,85,10,16,19,23,59,94
307,3,2003,27,1,5,27,7,518,45,80,0.563,0,0,-1,45,80,0.563,30,40,0.75,49,76,125,21,20,17,33,75,120
307,3,2003,27,1,5,54,24,885,105,267,0.393,0,0,-1,105,267,0.393,71,99,0.717,62,121,183,35,22,51,70,112,281
307,3,2003,27,1,5,81,31,1403,150,347,0.432,0,0,-1,150,347,0.432,101,139,0.727,111,197,308,56,42,68,103,187,401
307,4,2004,28,1,5,82,73,2402,342,604,0.566,0,0,-1,342,604,0.566,159,221,0.719,207,382,589,75,80,106,150,253,843
307,5,2005,29,1,5,82,57,2130,327,618,0.529,0,1,0,327,617,0.53,117,164,0.713,143,254,397,129,33,64,158,229,771
307,6,2006,30,1,5,39,25,1083,194,380,0.511,0,0,-1,194,380,0.511,97,127,0.764,36,126,162,66,15,36,120,107,485
307,6,2006,30,1,5,42,30,1157,179,354,0.506,0,0,-1,179,354,0.506,71,95,0.747,60,143,203,33,25,40,74,147,429
307,6,2006,30,1,5,81,55,2240,373,734,0.508,0,0,-1,373,734,0.508,168,222,0.757,96,269,365,99,40,76,194,254,914
307,7,2007,31,1,5,82,81,2544,427,839,0.509,9,31,0.29,418,808,0.517,147,195,0.754,136,369,505,67,43,58,159,239,1010
307,8,2008,32,1,5,69,46,1542,238,515,0.462,17,44,0.386,221,471,0.469,88,138,0.638,69,194,263,41,33,34,70,133,581
307,9,2009,33,1,5,20,0,207,30,78,0.385,11,27,0.407,19,51,0.373,8,13,0.615,10,31,41,4,1,7,14,17,79
311,1,1988,23,1,1,79,14,1628,166,426,0.39,3,16,0.188,163,410,0.398,58,74,0.784,35,101,136,404,127,3,101,138,393
311,2,1989,24,1,1,79,21,1755,178,418,0.426,1,13,0.077,177,405,0.437,66,88,0.75,53,112,165,620,111,7,124,141,423
311,3,1990,25,1,1,81,65,2743,326,664,0.491,5,26,0.192,321,638,0.503,106,134,0.791,48,159,207,867,166,3,146,168,763
311,4,1991,26,1,1,81,46,2299,241,524,0.46,0,12,0,241,512,0.471,86,108,0.796,58,158,216,669,137,3,120,160,568
311,5,1992,27,1,1,82,69,2790,317,671,0.472,2,27,0.074,315,644,0.489,94,120,0.783,58,177,235,743,170,6,156,156,730
311,6,1993,28,1,1,81,80,2833,331,730,0.453,6,26,0.231,325,704,0.462,140,168,0.833,51,247,298,711,161,5,154,179,808
311,7,1994,29,1,1,77,77,2746,354,751,0.471,2,12,0.167,352,739,0.476,125,155,0.806,78,235,313,780,133,2,171,147,835
311,8,1995,30,1,1,78,78,2629,348,730,0.477,6,30,0.2,342,700,0.489,160,180,0.889,51,206,257,675,103,0,132,151,862
311,9,1997,32,1,1,65,65,1880,204,443,0.46,60,144,0.417,144,299,0.482,54,64,0.844,25,116,141,469,82,2,108,114,522
311,10,1998,33,1,1,59,31,1554,139,318,0.437,4,16,0.25,135,302,0.447,59,66,0.894,30,101,131,327,65,3,104,56,341
311,10,1998,33,1,1,61,31,1570,141,323,0.437,4,16,0.25,137,307,0.446,61,68,0.897,30,102,132,331,67,3,105,58,347
311,11,1999,34,1,1,36,5,714,76,154,0.494,0,6,0,76,148,0.514,31,36,0.861,16,57,73,134,43,1,47,44,183
311,12,2000,35,1,1,80,5,1731,157,358,0.439,17,51,0.333,140,307,0.456,79,87,0.908,25,110,135,299,65,4,59,119,410
312,1,2000,26,1,4,11,0,113,7,13,0.538,0,0,-1,7,13,0.538,12,20,0.6,12,18,30,5,2,6,8,24,26
312,1,2000,26,1,4,13,0,118,7,13,0.538,0,0,-1,7,13,0.538,15,24,0.625,13,18,31,5,2,6,10,25,29
313,1,1986,23,1,5,80,60,2090,128,278,0.46,0,1,0,128,277,0.462,42,86,0.488,123,354,477,23,28,397,65,255,298
313,2,1987,24,1,5,82,12,1552,103,231,0.446,0,1,0,103,230,0.448,45,67,0.672,84,278,362,11,20,302,61,189,251
313,3,1988,25,1,5,77,4,1136,75,165,0.455,0,1,0,75,164,0.457,26,49,0.531,72,203,275,13,11,208,35,160,176
313,4,1989,26,1,5,80,4,1769,127,344,0.369,20,91,0.22,107,253,0.423,40,66,0.606,116,346,462,27,11,345,79,226,314
313,5,1990,27,1,5,75,20,1310,56,169,0.331,9,48,0.188,47,121,0.388,25,49,0.51,33,243,276,36,13,238,51,194,146
313,6,1991,28,1,5,82,6,1522,65,164,0.396,1,14,0.071,64,150,0.427,24,41,0.585,66,284,350,20,16,247,63,184,155
313,7,1992,29,1,5,71,2,1267,49,128,0.383,0,9,0,49,119,0.412,12,26,0.462,54,168,222,22,11,205,41,139,110
313,8,1993,30,1,5,58,23,855,52,127,0.409,10,32,0.313,42,95,0.442,12,19,0.632,44,149,193,18,14,119,50,87,126
313,9,1994,31,1,5,14,0,116,4,19,0.211,0,3,0,4,16,0.25,0,0,-1,3,15,18,1,2,16,5,13,8
318,1,1993,23,1,2,74,38,1578,227,565,0.402,7,42,0.167,220,523,0.421,129,167,0.772,52,144,196,122,75,18,112,223,590
318,2,1994,24,1,2,56,4,559,63,156,0.404,19,54,0.352,44,102,0.431,31,40,0.775,20,41,61,31,16,12,17,90,176
318,3,1995,25,1,2,18,0,239,36,72,0.5,14,37,0.378,22,35,0.629,11,16,0.688,7,20,27,17,5,4,14,37,97
318,3,1995,25,1,2,23,0,290,39,84,0.464,15,41,0.366,24,43,0.558,14,20,0.7,8,24,32,24,6,4,17,47,107
321,1,1999,24,1,3,39,4,432,49,151,0.325,1,10,0.1,48,141,0.34,21,42,0.5,25,68,93,38,22,11,39,60,120
322,1,1991,22,1,4,34,6,750,103,230,0.448,0,0,-1,103,230,0.448,44,76,0.579,59,102,161,49,39,5,41,62,250
322,2,1992,23,1,4,79,18,2287,294,658,0.447,1,4,0.25,293,654,0.448,151,241,0.627,192,293,485,125,94,26,133,194,740
322,3,1993,24,1,4,70,35,1764,229,497,0.461,0,7,0,229,490,0.467,143,241,0.593,188,267,455,96,86,17,105,183,601
322,4,1994,25,1,3,73,38,1402,162,288,0.563,0,0,-1,162,288,0.563,50,105,0.476,150,194,344,88,76,13,89,175,374
322,5,1995,26,1,4,58,23,1126,88,193,0.456,1,5,0.2,87,188,0.463,44,67,0.657,113,149,262,80,48,23,79,159,221
323,1,1996,23,1,1,11,0,131,16,50,0.32,3,19,0.158,13,31,0.419,9,11,0.818,1,8,9,21,5,1,12,18,44
323,2,1997,24,1,1,16,4,409,44,101,0.436,11,35,0.314,33,66,0.5,18,20,0.9,7,21,28,50,3,2,20,28,117
323,2,1997,24,1,1,21,4,430,46,105,0.438,12,37,0.324,34,68,0.5,18,20,0.9,7,22,29,53,3,2,27,28,122
324,1,2007,22,1,4,61,0,669,99,171,0.579,0,0,-1,99,171,0.579,56,103,0.544,64,112,176,10,11,21,33,94,254
324,2,2008,23,1,4,70,53,1773,238,434,0.548,0,0,-1,238,434,0.548,99,217,0.456,192,317,509,55,36,61,68,155,575
324,3,2009,24,1,5,62,7,995,113,214,0.528,0,0,-1,113,214,0.528,32,85,0.376,104,154,258,31,22,48,31,106,258
324,4,2010,25,1,4,63,28,1045,117,223,0.525,0,0,-1,117,223,0.525,19,58,0.328,124,191,315,29,30,48,37,111,253
325,1,2004,23,1,5,16,0,258,22,56,0.393,0,1,0,22,55,0.4,14,18,0.778,13,41,54,15,4,14,18,40,58
325,2,2005,24,1,5,67,23,859,74,172,0.43,0,0,-1,74,172,0.43,52,71,0.732,86,138,224,49,10,32,52,160,200
327,1,1980,33,1,2,6,-1,106,14,40,0.35,0,0,-1,14,40,0.35,6,7,0.857,4,7,11,7,5,0,13,13,34
327,1,1980,33,1,2,75,-1,2286,391,875,0.447,19,50,0.38,372,825,0.451,169,189,0.894,50,166,216,302,92,3,184,219,970
327,1,1980,33,1,2,81,-1,2392,405,915,0.443,19,50,0.38,386,865,0.446,175,196,0.893,54,173,227,309,97,3,197,232,1004
327,2,1981,34,1,2,52,-1,1146,160,371,0.431,11,39,0.282,149,332,0.449,75,94,0.798,17,67,84,161,33,8,111,126,406
328,1,2000,23,1,5,11,0,143,16,46,0.348,0,0,-1,16,46,0.348,10,14,0.714,15,17,32,7,3,14,6,23,42
328,2,2001,24,1,5,15,7,293,46,84,0.548,0,0,-1,46,84,0.548,20,33,0.606,24,48,72,19,12,30,17,55,112
328,2,2001,24,1,5,40,22,640,74,168,0.44,0,0,-1,74,168,0.44,33,45,0.733,53,121,174,23,17,81,36,91,181
328,2,2001,24,1,5,55,29,933,120,252,0.476,0,0,-1,120,252,0.476,53,78,0.679,77,169,246,42,29,111,53,146,293
328,3,2002,25,1,5,15,15,279,35,82,0.427,0,0,-1,35,82,0.427,23,24,0.958,20,34,54,16,6,13,16,47,93
328,4,2003,26,1,5,47,0,575,52,119,0.437,0,2,0,52,117,0.444,34,47,0.723,32,77,109,12,11,33,22,74,138
328,5,2004,27,1,5,71,35,1206,135,290,0.466,0,2,0,135,288,0.469,75,94,0.798,86,194,280,28,17,101,45,150,345
328,6,2005,28,1,5,17,0,189,15,29,0.517,0,0,-1,15,29,0.517,12,16,0.75,13,36,49,4,4,12,8,23,42
328,6,2005,28,1,5,34,1,262,34,79,0.43,0,1,0,34,78,0.436,14,16,0.875,16,42,58,4,11,16,8,55,82
328,6,2005,28,1,5,51,1,451,49,108,0.454,0,1,0,49,107,0.458,26,32,0.813,29,78,107,8,15,28,16,78,124
328,7,2006,29,1,5,33,2,250,20,47,0.426,1,2,0.5,19,45,0.422,5,9,0.556,19,33,52,12,9,9,8,44,46
328,8,2007,30,1,5,44,1,380,31,66,0.47,1,2,0.5,30,64,0.469,6,10,0.6,27,54,81,18,4,29,9,71,69
328,9,2008,31,1,5,31,0,204,9,27,0.333,0,0,-1,9,27,0.333,6,10,0.6,6,32,38,8,6,18,4,35,24
330,1,2000,27,1,3,17,6,167,28,63,0.444,0,3,0,28,60,0.467,6,11,0.545,14,26,40,10,6,3,6,9,62
334,1,1980,23,1,4,13,-1,125,24,52,0.462,0,0,-1,24,52,0.462,8,13,0.615,19,20,39,2,4,2,8,25,56
335,1,2002,23,1,5,33,1,245,13,32,0.406,0,0,-1,13,32,0.406,13,25,0.52,21,34,55,4,3,16,14,38,39
336,1,2000,22,1,3,46,0,423,49,115,0.426,0,1,0,49,114,0.43,24,38,0.632,22,63,85,14,14,9,21,46,122
336,2,2001,23,1,3,44,0,375,53,114,0.465,1,5,0.2,52,109,0.477,33,40,0.825,30,47,77,4,10,21,11,45,140
336,3,2002,24,1,4,52,0,585,61,174,0.351,1,5,0.2,60,169,0.355,39,47,0.83,38,72,110,11,18,15,11,64,162
338,1,1998,26,1,3,61,9,1305,122,298,0.409,20,59,0.339,102,239,0.427,76,122,0.623,79,95,174,81,87,29,52,174,340
338,2,1999,27,1,3,30,1,494,26,93,0.28,7,26,0.269,19,67,0.284,11,24,0.458,15,37,52,28,21,9,13,51,70
338,3,2000,28,1,3,42,0,311,26,73,0.356,1,2,0.5,25,71,0.352,6,12,0.5,14,22,36,16,9,5,5,37,59
338,3,2000,28,1,3,27,2,567,46,121,0.38,26,56,0.464,20,65,0.308,19,31,0.613,13,47,60,18,14,10,14,81,137
338,3,2000,28,1,3,69,2,878,72,194,0.371,27,58,0.466,45,136,0.331,25,43,0.581,27,69,96,34,23,15,19,118,196
338,4,2001,29,1,3,82,72,2685,211,581,0.363,103,307,0.336,108,274,0.394,98,161,0.609,45,200,245,132,83,53,74,269,623
338,5,2002,30,1,3,59,59,1699,155,398,0.389,56,148,0.378,99,250,0.396,46,96,0.479,42,120,162,88,62,25,66,116,412
338,6,2003,31,1,3,82,82,2566,223,479,0.466,101,229,0.441,122,250,0.488,36,89,0.404,59,180,239,113,66,42,72,195,583
338,7,2004,32,1,3,82,82,2624,211,502,0.42,77,212,0.363,134,290,0.462,66,114,0.579,45,208,253,113,84,33,90,166,565
338,8,2005,33,1,3,82,82,2627,251,598,0.42,102,253,0.403,149,345,0.432,71,112,0.634,50,235,285,126,55,39,57,175,675
338,9,2006,34,1,3,82,82,2755,232,536,0.433,104,245,0.424,128,291,0.44,51,84,0.607,35,285,320,126,79,30,67,191,619
338,10,2007,35,1,3,82,82,2464,189,467,0.405,89,232,0.384,100,235,0.426,43,73,0.589,23,200,223,117,62,25,65,175,510
338,11,2008,36,1,3,81,81,2448,174,428,0.407,90,215,0.419,84,213,0.394,45,69,0.652,33,201,234,91,54,22,46,177,483
338,12,2009,37,1,3,80,10,1506,79,187,0.422,42,98,0.429,37,89,0.416,14,26,0.538,16,129,145,40,36,13,25,123,214
342,1,1997,23,1,2,22,2,154,21,63,0.333,2,16,0.125,19,47,0.404,11,22,0.5,7,8,15,13,10,4,16,17,55
345,1,1980,22,1,2,64,-1,1102,221,467,0.473,0,4,0,221,463,0.477,104,136,0.765,51,82,133,95,59,19,96,132,546
345,2,1981,23,1,2,44,-1,757,121,313,0.387,0,0,-1,121,313,0.387,45,55,0.818,24,51,75,37,23,16,69,79,287
349,1,2007,23,1,2,23,5,199,11,39,0.282,2,13,0.154,9,26,0.346,2,6,0.333,3,20,23,9,5,2,9,32,26
351,1,1982,22,1,3,39,0,331,54,103,0.524,0,1,0,54,102,0.529,29,48,0.604,31,34,65,11,12,5,28,37,137
355,1,1982,22,1,2,51,1,339,55,122,0.451,0,1,0,55,121,0.455,42,62,0.677,12,26,38,22,14,6,37,61,152
355,2,1983,23,1,2,51,5,532,69,176,0.392,0,3,0,69,173,0.399,46,90,0.511,30,48,78,28,32,27,42,84,184
358,1,2002,22,1,4,26,0,118,13,25,0.52,0,2,0,13,23,0.565,4,8,0.5,7,17,24,3,0,6,6,10,30
358,2,2003,23,1,4,67,11,1314,151,314,0.481,1,6,0.167,150,308,0.487,35,67,0.522,162,247,409,67,16,32,76,125,338
358,3,2005,25,1,4,18,0,119,15,24,0.625,0,1,0,15,23,0.652,3,8,0.375,8,20,28,5,1,2,5,12,33
358,4,2006,26,1,4,46,1,367,32,79,0.405,1,5,0.2,31,74,0.419,2,3,0.667,40,67,107,17,5,7,19,39,67
359,1,1994,21,1,5,49,45,1385,201,491,0.409,0,3,0,201,488,0.412,102,168,0.607,98,208,306,98,45,147,148,170,504
359,2,1995,22,1,5,82,59,2365,315,693,0.455,0,3,0,315,690,0.457,148,232,0.638,243,416,659,53,54,274,142,338,778
359,3,1996,23,1,5,12,11,334,43,97,0.443,0,0,-1,43,97,0.443,19,25,0.76,34,72,106,8,8,38,31,42,105
359,3,1996,23,1,5,67,57,1995,344,776,0.443,1,4,0.25,343,772,0.444,150,221,0.679,187,345,532,55,41,250,148,244,839
359,3,1996,23,1,5,79,68,2329,387,873,0.443,1,4,0.25,386,869,0.444,169,246,0.687,221,417,638,63,49,288,179,286,944
359,4,1997,24,1,5,33,32,1060,207,449,0.461,0,3,0,207,446,0.464,68,106,0.642,103,183,286,32,17,88,70,115,482
359,4,1997,24,1,5,40,38,1228,199,456,0.436,0,5,0,199,451,0.441,81,122,0.664,118,207,325,20,23,160,64,122,479
359,4,1997,24,1,5,73,70,2288,406,905,0.449,0,8,0,406,897,0.453,149,228,0.654,221,390,611,52,40,248,134,237,961
359,5,1998,25,1,5,64,46,1822,300,711,0.422,1,3,0.333,299,708,0.422,130,180,0.722,164,354,518,60,51,214,96,214,731
359,6,1999,26,1,5,49,33,1294,167,348,0.48,0,4,0,167,344,0.485,86,115,0.748,130,262,392,40,35,159,56,153,420
359,7,2000,27,1,5,77,54,1901,266,555,0.479,1,5,0.2,265,550,0.482,114,149,0.765,160,337,497,60,71,190,74,260,647
359,8,2001,28,1,5,82,35,2001,219,447,0.49,1,6,0.167,218,441,0.494,140,178,0.787,160,448,608,38,36,228,88,256,579
359,9,2002,29,1,5,53,16,757,78,163,0.479,0,1,0,78,162,0.481,59,64,0.922,53,123,176,20,28,64,25,128,215
359,10,2003,30,1,5,81,39,1731,201,375,0.536,0,1,0,201,374,0.537,141,175,0.806,151,325,476,54,65,170,67,242,543
359,11,2004,31,1,5,66,5,773,89,188,0.473,0,1,0,89,187,0.476,41,49,0.837,72,101,173,20,33,74,17,130,219
359,12,2005,32,1,5,77,14,885,84,186,0.452,0,0,-1,84,186,0.452,43,63,0.683,70,144,214,15,25,63,33,153,211
360,1,1997,28,1,5,36,0,251,25,58,0.431,0,0,-1,25,58,0.431,9,13,0.692,26,42,68,7,5,5,9,34,59
361,1,1996,25,1,4,53,0,369,54,120,0.45,0,0,-1,54,120,0.45,23,41,0.561,38,41,79,8,17,8,26,71,131
363,1,1982,23,1,4,10,3,176,21,52,0.404,0,0,-1,21,52,0.404,11,12,0.917,14,19,33,6,5,4,13,17,53
363,2,1983,24,1,4,62,2,680,131,308,0.425,0,1,0,131,307,0.427,76,108,0.704,73,100,173,46,27,26,45,81,338
364,1,1987,23,1,3,32,0,219,48,96,0.5,0,2,0,48,94,0.511,42,54,0.778,23,30,53,16,16,3,24,39,138
364,2,1988,24,1,3,20,3,308,56,134,0.418,1,5,0.2,55,129,0.426,20,23,0.87,20,28,48,16,16,11,29,41,133
364,3,1989,25,1,3,67,4,811,202,436,0.463,7,31,0.226,195,405,0.481,87,120,0.725,63,69,132,60,45,3,64,99,498
365,1,2004,27,1,4,11,0,132,13,28,0.464,0,0,-1,13,28,0.464,8,12,0.667,15,19,34,6,4,2,12,21,34
365,1,2004,27,1,4,15,0,154,16,33,0.485,0,0,-1,16,33,0.485,8,12,0.667,18,21,39,7,4,2,13,29,40
367,1,1992,21,1,1,82,9,1605,252,601,0.419,1,23,0.043,251,578,0.434,100,124,0.806,49,113,162,316,81,22,136,107,605
367,2,1993,22,1,1,82,8,1622,297,621,0.478,13,42,0.31,284,579,0.491,118,143,0.825,37,142,179,302,79,27,107,122,725
367,3,1994,23,1,1,73,10,1548,230,548,0.42,7,32,0.219,223,516,0.432,139,162,0.858,38,121,159,277,84,16,111,108,606
367,4,1995,24,1,1,67,41,1961,341,762,0.448,48,121,0.397,293,641,0.457,159,186,0.855,35,151,186,363,107,14,144,118,889
367,5,1996,25,1,1,75,75,2570,510,1096,0.465,91,235,0.387,419,861,0.487,338,381,0.887,47,201,248,487,132,33,142,146,1449
367,6,1997,26,1,1,78,78,2868,575,1313,0.438,101,271,0.373,474,1042,0.455,268,297,0.902,48,253,301,490,138,30,178,177,1519
367,7,1998,27,1,1,50,48,1784,339,731,0.464,31,93,0.333,308,638,0.483,132,156,0.846,23,153,176,387,111,17,145,120,841
367,8,1999,28,1,1,15,14,505,85,208,0.409,7,28,0.25,78,180,0.433,26,31,0.839,11,42,53,104,24,3,36,25,203
367,8,1999,28,1,1,21,20,712,127,299,0.425,5,19,0.263,122,280,0.436,39,47,0.83,16,65,81,205,39,7,38,57,298
367,8,1999,28,1,1,36,34,1217,212,507,0.418,12,47,0.255,200,460,0.435,65,78,0.833,27,107,134,309,63,10,74,82,501
367,9,2000,29,1,1,71,71,2587,486,1042,0.466,53,132,0.402,433,910,0.476,187,208,0.899,44,194,238,629,134,30,184,158,1212
367,10,2001,30,1,1,78,78,2821,511,1134,0.451,33,91,0.363,478,1043,0.458,195,224,0.871,60,238,298,583,161,21,155,138,1250
367,11,2002,31,1,1,32,28,962,155,365,0.425,4,23,0.174,151,342,0.442,83,84,0.988,17,76,93,264,52,6,43,49,397
368,1,1980,24,1,1,82,-1,1589,269,687,0.392,21,86,0.244,248,601,0.413,141,162,0.87,50,117,167,223,93,9,135,165,700
368,2,1981,25,1,1,80,-1,2595,319,817,0.39,57,169,0.337,262,648,0.404,107,132,0.811,66,132,198,452,136,17,162,194,802
368,3,1982,26,1,1,81,3,1616,230,565,0.407,46,138,0.333,184,427,0.431,119,152,0.783,40,126,166,438,65,11,139,183,625
368,4,1983,27,1,1,15,0,140,14,42,0.333,1,8,0.125,13,34,0.382,10,13,0.769,3,16,19,23,7,0,14,20,39
368,5,1984,28,1,1,82,0,1428,213,521,0.409,15,51,0.294,198,470,0.421,120,137,0.876,41,102,143,252,84,6,109,155,561
368,6,1985,29,1,1,56,6,746,106,250,0.424,6,26,0.231,100,224,0.446,69,82,0.841,11,47,58,122,47,4,54,76,287
368,7,1986,30,1,1,33,0,269,26,70,0.371,4,14,0.286,22,56,0.393,14,18,0.778,2,21,23,39,13,0,17,43,70
369,1,2003,22,1,1,64,41,1503,171,464,0.369,101,286,0.353,70,178,0.393,85,111,0.766,18,127,145,164,38,3,59,80,528
369,2,2004,23,1,1,31,2,403,39,137,0.285,19,66,0.288,20,71,0.282,13,20,0.65,7,26,33,39,18,4,19,27,110
369,2,2004,23,1,1,36,2,443,43,158,0.272,19,74,0.257,24,84,0.286,13,20,0.65,9,27,36,51,18,4,24,32,118
372,1,1984,23,1,5,57,8,472,68,177,0.384,0,0,-1,68,177,0.384,32,46,0.696,48,61,109,17,11,38,35,98,168
372,2,1985,24,1,5,78,0,1083,162,317,0.511,0,0,-1,162,317,0.511,89,127,0.701,92,164,256,40,21,82,63,179,413
372,3,1986,25,1,5,82,63,1792,272,570,0.477,0,1,0,272,569,0.478,141,198,0.712,159,299,458,114,50,116,122,214,685
372,4,1987,26,1,5,76,10,1467,241,497,0.485,0,0,-1,241,497,0.485,118,202,0.584,129,221,350,47,56,61,100,229,600
372,5,1988,27,1,5,81,73,2258,390,788,0.495,0,0,-1,390,788,0.495,188,286,0.657,191,360,551,103,46,107,107,198,968
372,6,1989,28,1,5,48,4,513,86,179,0.48,0,0,-1,86,179,0.48,28,51,0.549,51,84,135,22,9,37,29,59,200
372,7,1990,29,1,5,30,8,554,86,186,0.462,0,0,-1,86,186,0.462,32,51,0.627,43,84,127,13,9,33,28,63,204
372,7,1990,29,1,5,51,47,1325,212,510,0.416,0,1,0,212,509,0.417,94,142,0.662,111,179,290,84,33,75,68,133,518
372,7,1990,29,1,5,81,55,1879,298,696,0.428,0,1,0,298,695,0.429,126,193,0.653,154,263,417,97,42,108,96,196,722
372,8,1991,30,1,5,73,44,1505,197,435,0.453,0,0,-1,197,435,0.453,35,79,0.443,114,231,345,73,35,80,69,132,429
372,9,1992,31,1,5,67,25,1176,161,344,0.468,0,1,0,161,343,0.469,41,77,0.532,98,183,281,89,27,99,41,117,363
372,10,1993,32,1,5,12,0,107,15,31,0.484,0,0,-1,15,31,0.484,2,5,0.4,10,18,28,6,2,3,5,12,32
372,11,1994,33,1,5,26,3,247,8,26,0.308,0,1,0,8,25,0.32,3,14,0.214,15,41,56,8,6,19,9,30,19
373,1,2004,23,1,1,13,1,160,13,35,0.371,5,14,0.357,8,21,0.381,1,6,0.167,2,9,11,17,7,0,10,9,32
373,2,2005,24,1,1,18,0,185,11,37,0.297,3,15,0.2,8,22,0.364,6,13,0.462,6,16,22,12,8,1,13,11,31
374,1,1980,28,1,4,67,-1,1016,90,184,0.489,0,5,0,90,179,0.503,14,29,0.483,101,156,257,75,42,43,47,129,194
374,2,1981,29,1,4,78,-1,1107,101,197,0.513,0,2,0,101,195,0.518,15,40,0.375,127,154,281,55,43,58,48,158,217
374,3,1982,30,1,4,71,9,966,81,175,0.463,1,6,0.167,80,169,0.473,7,19,0.368,106,158,264,42,39,46,37,127,170
375,1,1980,24,1,2,82,-1,2815,548,1182,0.464,6,32,0.188,542,1150,0.471,184,219,0.84,54,160,214,216,98,48,167,154,1286
375,2,1981,25,1,2,29,-1,548,95,246,0.386,1,3,0.333,94,243,0.387,26,34,0.765,13,20,33,55,34,9,38,42,217
375,2,1981,25,1,2,46,-1,904,180,385,0.468,0,4,0,180,381,0.472,65,80,0.813,21,32,53,93,27,25,54,53,425
375,2,1981,25,1,2,75,-1,1452,275,631,0.436,1,7,0.143,274,624,0.439,91,114,0.798,34,52,86,148,61,34,92,95,642
375,3,1982,26,1,2,25,4,595,182,361,0.504,3,10,0.3,179,351,0.51,77,88,0.875,13,37,50,67,23,7,34,37,444
375,3,1982,26,1,2,47,41,1724,387,833,0.465,5,21,0.238,382,812,0.47,134,172,0.779,42,69,111,121,59,23,91,114,913
375,3,1982,26,1,2,72,45,2319,569,1194,0.477,8,31,0.258,561,1163,0.482,211,260,0.812,55,106,161,188,82,30,125,151,1357
375,4,1983,27,1,2,21,18,563,98,245,0.4,0,3,0,98,242,0.405,44,51,0.863,9,28,37,27,20,6,25,27,240
375,4,1983,27,1,2,53,34,1401,246,562,0.438,7,15,0.467,239,547,0.437,98,119,0.824,50,57,107,69,70,19,72,96,597
375,4,1983,27,1,2,74,52,1964,344,807,0.426,7,18,0.389,337,789,0.427,142,170,0.835,59,85,144,96,90,25,97,123,837
375,5,1984,28,1,2,13,3,210,27,58,0.466,0,1,0,27,57,0.474,11,17,0.647,5,8,13,6,6,5,7,10,65
375,5,1984,28,1,2,40,5,782,152,345,0.441,3,13,0.231,149,332,0.449,41,50,0.82,17,33,50,44,18,16,33,54,348
375,5,1984,28,1,2,53,8,992,179,403,0.444,3,14,0.214,176,389,0.452,52,67,0.776,22,41,63,50,24,21,40,64,413
375,6,1985,29,1,2,11,0,245,49,84,0.583,0,2,0,49,82,0.598,16,18,0.889,8,10,18,11,5,5,5,15,114
375,6,1985,29,1,2,20,0,326,62,118,0.525,0,2,0,62,116,0.534,23,25,0.92,9,12,21,17,6,6,9,23,147
375,7,1986,30,1,2,40,3,552,83,215,0.386,5,17,0.294,78,198,0.394,33,37,0.892,14,39,53,40,17,6,21,43,204
375,7,1986,30,1,2,44,3,570,86,224,0.384,5,17,0.294,81,207,0.391,34,38,0.895,14,39,53,40,17,6,23,44,211
378,1,1980,28,1,3,82,-1,2304,377,785,0.48,2,7,0.286,375,778,0.482,197,243,0.811,170,342,512,341,88,6,179,211,953
378,2,1981,29,1,3,82,-1,2001,271,611,0.444,5,18,0.278,266,593,0.449,166,198,0.838,103,327,430,383,63,3,171,190,713
378,3,1982,30,1,3,82,54,2035,218,499,0.437,3,18,0.167,215,481,0.447,134,164,0.817,119,220,339,448,65,6,165,222,573
378,4,1983,31,1,3,37,0,371,44,99,0.444,6,13,0.462,38,86,0.442,10,14,0.714,24,35,59,70,6,1,31,46,104
382,1,1980,26,1,3,81,-1,2316,594,1243,0.478,5,27,0.185,589,1216,0.484,230,266,0.865,104,197,301,237,94,20,172,216,1423
382,2,1981,27,1,3,77,-1,2215,537,1102,0.487,3,21,0.143,534,1081,0.494,213,241,0.884,78,211,289,234,88,28,150,182,1290
382,3,1982,28,1,3,41,4,924,209,433,0.483,4,9,0.444,205,424,0.483,89,103,0.864,37,88,125,109,28,3,64,91,511
382,4,1983,29,1,3,70,5,1855,421,856,0.492,1,13,0.077,420,843,0.498,164,196,0.837,44,202,246,207,40,9,122,155,1007
382,5,1984,30,1,3,81,10,2431,509,1094,0.465,6,31,0.194,503,1063,0.473,196,243,0.807,80,252,332,265,53,14,148,224,1220
382,6,1985,31,1,3,80,15,2042,460,990,0.465,14,39,0.359,446,951,0.469,181,206,0.879,55,175,230,171,47,18,116,128,1115
382,7,1986,32,1,3,58,14,1161,199,451,0.441,6,18,0.333,193,433,0.446,106,119,0.891,29,94,123,108,31,8,68,81,510
382,8,1987,33,1,3,34,4,418,79,171,0.462,1,6,0.167,78,165,0.473,16,20,0.8,14,38,52,35,10,2,15,50,175
387,1,1986,22,1,5,32,2,219,22,43,0.512,0,0,-1,22,43,0.512,10,19,0.526,10,39,49,5,3,12,20,54,54
389,1,2010,22,1,4,52,4,654,55,103,0.534,0,0,-1,55,103,0.534,37,62,0.597,105,108,213,22,15,5,23,115,147
389,2,2011,23,1,5,63,6,677,48,94,0.511,0,0,-1,48,94,0.511,40,59,0.678,74,110,184,18,14,3,24,119,136
389,3,2012,24,1,4,35,0,239,15,45,0.333,0,1,0,15,44,0.341,7,15,0.467,33,42,75,9,4,1,10,33,37
391,1,1982,23,1,2,63,19,1027,165,364,0.453,9,32,0.281,156,332,0.47,61,84,0.726,61,59,120,156,49,13,83,123,400
391,2,1983,24,1,2,58,0,466,91,213,0.427,3,13,0.231,88,200,0.44,34,43,0.791,33,29,62,66,26,9,43,79,219
392,1,1992,22,1,3,37,0,270,43,97,0.443,2,11,0.182,41,86,0.477,17,21,0.81,13,26,39,11,8,2,18,19,105
392,2,1993,23,1,3,55,2,571,93,233,0.399,6,26,0.231,87,207,0.42,35,40,0.875,22,59,81,34,10,2,39,46,227
392,3,1994,24,1,3,34,0,190,36,99,0.364,4,23,0.174,32,76,0.421,9,10,0.9,5,16,21,3,0,2,12,19,85
393,1,1989,23,1,1,82,6,1372,156,371,0.42,55,153,0.359,101,218,0.463,61,69,0.884,19,75,94,306,69,3,65,116,428
393,2,1990,24,1,1,72,1,975,119,276,0.431,31,79,0.392,88,197,0.447,50,57,0.877,15,49,64,207,47,0,38,105,319
393,3,1991,25,1,1,80,0,980,159,370,0.43,45,135,0.333,114,235,0.485,61,72,0.847,28,44,72,204,53,5,51,122,424
393,4,1992,26,1,1,82,0,1082,167,374,0.447,32,90,0.356,135,284,0.475,51,63,0.81,27,72,99,205,66,7,51,82,417
393,5,1993,27,1,1,82,0,1516,183,385,0.475,41,99,0.414,142,286,0.497,112,135,0.83,22,77,99,243,79,3,72,136,519
393,6,1994,28,1,1,73,0,1225,142,289,0.491,23,61,0.377,119,228,0.522,74,85,0.871,10,92,102,149,51,2,55,98,381
393,7,1995,29,1,1,28,0,186,35,65,0.538,8,17,0.471,27,48,0.563,18,21,0.857,1,12,13,22,8,1,14,14,96
393,7,1995,29,1,1,31,0,622,91,210,0.433,17,52,0.327,74,158,0.468,46,58,0.793,13,40,53,94,26,3,33,42,245
393,7,1995,29,1,1,59,0,808,126,275,0.458,25,69,0.362,101,206,0.49,64,79,0.81,14,52,66,116,34,4,47,56,341
393,8,1996,30,1,1,69,0,716,134,293,0.457,25,62,0.403,109,231,0.472,59,69,0.855,11,30,41,100,42,3,43,53,352
393,9,1997,31,1,1,38,0,251,19,39,0.487,5,12,0.417,14,27,0.519,14,15,0.933,6,12,18,29,21,0,17,35,57
393,10,1998,32,1,1,43,0,312,28,66,0.424,5,11,0.455,23,55,0.418,18,20,0.9,6,24,30,49,18,3,12,25,79
394,1,2007,25,1,4,38,0,271,42,74,0.568,0,1,0,42,73,0.575,9,15,0.6,26,48,74,2,6,4,29,26,93
394,2,2008,26,1,4,33,1,286,39,78,0.5,0,0,-1,39,78,0.5,22,49,0.449,37,55,92,8,7,4,14,38,100
396,1,2009,24,1,1,21,1,256,47,113,0.416,14,36,0.389,33,77,0.429,8,9,0.889,6,10,16,30,6,2,16,21,116
396,1,2009,24,1,2,47,1,675,94,247,0.381,31,94,0.33,63,153,0.412,26,34,0.765,8,28,36,87,15,1,47,74,245
396,1,2009,24,1,2,68,2,931,141,360,0.392,45,130,0.346,96,230,0.417,34,43,0.791,14,38,52,117,21,3,63,95,361
396,2,2010,25,1,1,23,0,191,28,85,0.329,9,32,0.281,19,53,0.358,5,7,0.714,8,12,20,42,6,0,22,14,70
396,2,2010,25,1,1,22,0,328,60,152,0.395,17,66,0.258,43,86,0.5,8,8,1,1,17,18,46,9,1,24,28,145
396,2,2010,25,1,1,45,0,519,88,237,0.371,26,98,0.265,62,139,0.446,13,15,0.867,9,29,38,88,15,1,46,42,215
397,1,1990,21,1,3,75,35,1339,210,447,0.47,0,7,0,210,440,0.477,125,164,0.762,83,148,231,50,33,26,69,148,545
397,2,1991,22,1,3,74,51,1485,263,502,0.524,0,4,0,263,498,0.528,101,144,0.701,78,135,213,80,26,24,94,130,627
397,3,1992,23,1,3,36,2,381,55,118,0.466,0,3,0,55,115,0.478,25,41,0.61,29,47,76,23,9,7,27,41,135
397,3,1992,23,1,3,42,2,431,60,128,0.469,0,3,0,60,125,0.48,30,49,0.612,31,51,82,26,12,7,29,48,150
397,4,1993,24,1,3,77,20,1186,160,331,0.483,0,5,0,160,326,0.491,71,98,0.724,88,144,232,51,20,24,56,112,391
397,5,1995,26,1,3,41,14,814,105,174,0.603,1,3,0.333,104,171,0.608,38,62,0.613,64,125,189,30,11,14,29,105,249
397,6,1996,27,1,4,82,82,2019,300,555,0.541,1,8,0.125,299,547,0.547,104,150,0.693,134,307,441,89,47,38,94,163,705
397,7,1997,28,1,3,60,1,674,65,128,0.508,1,6,0.167,64,122,0.525,39,59,0.661,38,94,132,24,9,20,15,86,170
397,7,1997,28,1,3,70,1,757,78,154,0.506,1,6,0.167,77,148,0.52,47,70,0.671,41,107,148,28,9,22,19,100,204
397,8,1998,29,1,3,77,8,1202,161,372,0.433,2,8,0.25,159,364,0.437,63,87,0.724,57,126,183,55,23,13,51,100,387
397,9,1999,30,1,4,48,21,1192,176,373,0.472,15,40,0.375,161,333,0.483,40,59,0.678,36,138,174,57,16,19,38,106,407
397,10,2000,31,1,4,33,2,494,66,152,0.434,1,7,0.143,65,145,0.448,11,21,0.524,24,66,90,25,12,8,17,61,144
397,10,2000,31,1,4,30,27,602,82,176,0.466,1,3,0.333,81,173,0.468,25,31,0.806,11,66,77,41,8,10,28,53,190
397,10,2000,31,1,4,63,29,1096,148,328,0.451,2,10,0.2,146,318,0.459,36,52,0.692,35,132,167,66,20,18,45,114,334
397,11,2001,32,1,3,20,2,265,31,75,0.413,0,1,0,31,74,0.419,16,24,0.667,5,31,36,6,6,6,6,27,78
397,11,2001,32,1,3,26,2,339,40,95,0.421,0,3,0,40,92,0.435,22,34,0.647,8,46,54,11,9,7,8,37,102
398,1,2003,23,1,4,5,3,115,11,35,0.314,0,2,0,11,33,0.333,6,8,0.75,3,12,15,3,1,0,6,14,28
398,2,2005,25,1,3,14,0,152,23,62,0.371,4,11,0.364,19,51,0.373,4,9,0.444,10,18,28,14,1,6,15,17,54
400,1,1991,22,1,1,82,5,1945,284,612,0.464,7,34,0.206,277,578,0.479,137,157,0.873,41,141,182,344,83,14,137,161,712
400,2,1992,23,1,1,31,20,883,149,350,0.426,5,22,0.227,144,328,0.439,60,78,0.769,15,64,79,164,33,7,59,74,363
400,3,1993,24,1,1,80,48,2254,328,701,0.468,26,82,0.317,302,619,0.488,192,242,0.793,45,201,246,461,138,32,136,203,874
400,4,1994,25,1,2,77,76,2867,490,1021,0.48,30,96,0.313,460,925,0.497,182,219,0.831,63,237,300,347,156,47,126,207,1192
400,5,1995,26,1,2,79,69,2792,437,977,0.447,126,327,0.385,311,650,0.478,236,277,0.852,63,186,249,301,110,49,146,181,1236
400,6,1996,27,1,1,65,23,1591,246,616,0.399,68,220,0.309,178,396,0.449,135,158,0.854,36,100,136,146,80,12,74,119,695
400,7,1997,28,1,1,21,2,522,61,166,0.367,20,65,0.308,41,101,0.406,18,22,0.818,8,40,48,67,31,7,24,45,160
400,8,1998,29,1,2,41,10,811,109,255,0.427,43,113,0.381,66,142,0.465,19,28,0.679,10,52,62,53,44,6,32,76,280
400,8,1998,29,1,2,31,2,908,137,307,0.446,65,158,0.411,72,149,0.483,39,43,0.907,14,76,90,101,38,17,41,47,378
400,8,1998,29,1,2,72,12,1719,246,562,0.438,108,271,0.399,138,291,0.474,58,71,0.817,24,128,152,154,82,23,73,123,658
400,9,1999,30,1,1,49,0,1377,187,495,0.378,135,349,0.387,52,146,0.356,40,55,0.727,15,88,103,143,56,8,80,75,549
400,10,2000,31,1,1,38,12,673,93,258,0.36,67,187,0.358,26,71,0.366,11,16,0.688,9,45,54,86,24,5,39,62,264
400,11,2001,32,1,1,7,0,155,16,44,0.364,12,32,0.375,4,12,0.333,4,5,0.8,0,11,11,12,4,0,7,10,48
401,1,2010,22,1,3,57,0,535,68,147,0.463,2,7,0.286,66,140,0.471,48,72,0.667,31,47,78,19,21,10,19,53,186
401,2,2011,23,1,3,41,1,488,62,113,0.549,2,6,0.333,60,107,0.561,25,47,0.532,32,52,84,29,16,8,28,48,151
401,2,2011,23,1,3,49,1,576,74,131,0.565,5,10,0.5,69,121,0.57,32,60,0.533,41,58,99,33,20,10,35,59,185
401,3,2012,24,1,3,65,17,1443,212,409,0.518,6,24,0.25,206,385,0.535,94,141,0.667,95,141,236,67,48,12,55,96,524
402,1,2004,25,1,2,58,0,627,85,196,0.434,4,14,0.286,81,182,0.445,60,74,0.811,38,92,130,33,15,4,38,61,234
402,2,2005,26,1,2,67,0,1238,173,409,0.423,45,121,0.372,128,288,0.444,103,130,0.792,37,139,176,92,39,12,53,83,494
402,3,2006,27,1,2,81,14,1711,207,527,0.393,39,118,0.331,168,409,0.411,158,212,0.745,73,134,207,104,44,14,99,153,611
402,4,2007,28,1,2,58,49,1662,233,555,0.42,81,227,0.357,152,328,0.463,123,155,0.794,55,196,251,149,44,9,91,139,670
402,5,2008,29,1,2,78,20,1762,217,531,0.409,45,146,0.308,172,385,0.447,107,142,0.754,65,198,263,175,52,7,99,144,586
402,6,2009,30,1,2,63,5,869,111,313,0.355,28,97,0.289,83,216,0.384,78,100,0.78,31,88,119,54,32,5,54,81,328
402,7,2010,31,1,2,39,37,967,128,325,0.394,54,147,0.367,74,178,0.416,69,86,0.802,27,82,109,58,30,5,57,62,379
402,7,2010,31,1,2,50,37,1060,136,361,0.377,58,164,0.354,78,197,0.396,69,86,0.802,29,95,124,65,33,6,62,72,399
407,1,2002,20,1,3,29,5,245,23,70,0.329,5,27,0.185,18,43,0.419,12,20,0.6,11,39,50,15,18,7,7,18,63
407,2,2003,21,1,3,51,5,666,61,171,0.357,3,39,0.077,58,132,0.439,20,32,0.625,45,95,140,20,34,13,23,68,145
407,3,2004,22,1,3,21,10,408,45,99,0.455,12,32,0.375,33,67,0.493,8,13,0.615,18,50,68,25,17,2,12,38,110
407,3,2004,22,1,3,34,16,561,72,155,0.465,26,67,0.388,46,88,0.523,9,14,0.643,23,55,78,39,13,5,17,42,179
407,3,2004,22,1,3,55,26,969,117,254,0.461,38,99,0.384,79,155,0.51,17,27,0.63,41,105,146,64,30,7,29,80,289
409,1,1999,23,1,2,33,0,236,33,89,0.371,3,10,0.3,30,79,0.38,11,14,0.786,5,17,22,31,5,1,22,21,80
410,1,1980,28,1,3,28,-1,361,37,98,0.378,0,0,-1,37,98,0.378,34,44,0.773,21,41,62,14,3,4,24,66,108
410,1,1980,28,1,3,32,-1,385,37,105,0.352,0,0,-1,37,105,0.352,38,48,0.792,26,45,71,18,3,4,29,70,112
411,1,1987,23,1,5,62,3,818,106,201,0.527,0,0,-1,106,201,0.527,46,72,0.639,71,143,214,24,20,7,59,129,258
411,2,1988,24,1,5,46,27,591,78,174,0.448,0,1,0,78,173,0.451,41,71,0.577,66,93,159,28,11,4,38,85,197
411,3,1989,25,1,5,66,16,1051,104,248,0.419,0,0,-1,104,248,0.419,92,130,0.708,92,166,258,41,25,17,77,133,300
411,4,1990,26,1,5,82,0,1397,177,344,0.515,1,2,0.5,176,342,0.515,157,199,0.789,111,262,373,47,32,28,88,187,512
411,5,1991,27,1,5,82,2,1391,129,284,0.454,0,0,-1,129,284,0.454,132,178,0.742,109,228,337,49,29,24,82,166,390
411,6,1992,28,1,5,82,1,1783,221,488,0.453,0,1,0,221,487,0.454,190,285,0.667,187,289,476,81,42,34,105,196,632
411,7,1993,29,1,5,82,21,1551,176,409,0.43,0,1,0,176,408,0.431,113,164,0.689,147,244,391,64,32,23,95,190,465
411,8,1994,30,1,5,82,40,1921,111,260,0.427,0,2,0,111,258,0.43,77,118,0.653,119,328,447,72,51,29,75,218,299
411,9,1995,31,1,5,27,0,213,10,40,0.25,0,1,0,10,39,0.256,15,27,0.556,9,36,45,10,7,0,16,35,35
411,10,1996,32,1,5,9,1,162,9,16,0.563,0,0,-1,9,16,0.563,8,17,0.471,14,23,37,3,3,2,6,24,26
412,1,1980,31,1,2,80,-1,1701,404,843,0.479,39,88,0.443,365,755,0.483,113,135,0.837,35,120,155,174,65,17,105,117,960
412,2,1981,32,1,2,78,-1,1986,505,1035,0.488,23,64,0.359,482,971,0.496,173,208,0.832,53,122,175,233,88,13,131,141,1206
412,3,1982,33,1,2,82,2,1785,393,863,0.455,25,77,0.325,368,786,0.468,111,129,0.86,42,98,140,238,69,4,96,111,922
412,4,1983,34,1,1,80,1,1432,371,714,0.52,14,32,0.438,357,682,0.523,58,72,0.806,32,65,97,242,59,13,110,98,814
412,5,1984,35,1,2,71,1,1129,258,506,0.51,9,34,0.265,249,472,0.528,77,86,0.895,14,48,62,194,49,2,70,84,602
415,1,1994,24,1,5,79,54,1950,167,402,0.415,1,6,0.167,166,396,0.419,115,152,0.757,188,305,493,93,71,93,72,177,450
415,2,1995,25,1,5,80,63,2466,254,570,0.446,4,24,0.167,250,546,0.458,139,207,0.671,178,309,487,135,69,135,80,262,651
415,3,1996,26,1,5,81,81,2942,354,798,0.444,3,15,0.2,351,783,0.448,204,265,0.77,215,345,560,165,79,100,133,249,915
415,4,1997,27,1,4,80,71,2592,300,656,0.457,0,2,0,300,654,0.459,161,220,0.732,239,431,670,92,85,98,113,283,761
415,5,1998,28,1,4,74,74,2362,278,590,0.471,0,0,-1,278,590,0.471,151,197,0.766,235,400,635,103,66,98,97,264,707
415,6,1999,29,1,4,50,50,1611,229,477,0.48,0,0,-1,229,477,0.48,113,146,0.774,115,231,346,66,46,48,69,166,571
415,7,2000,30,1,4,80,80,2302,322,671,0.48,0,1,0,322,670,0.481,120,159,0.755,216,384,600,145,65,61,100,264,764
415,8,2001,31,1,5,80,79,2811,249,561,0.444,0,4,0,249,557,0.447,178,209,0.852,257,485,742,127,78,92,108,260,676
415,9,2002,32,1,5,80,80,2563,250,527,0.474,0,0,-1,250,527,0.474,169,197,0.858,273,513,786,107,59,78,85,222,669
415,10,2003,33,1,4,78,78,2609,319,601,0.531,0,3,0,319,598,0.533,194,232,0.836,243,458,701,147,67,80,98,203,832
415,11,2004,34,1,4,80,80,2753,339,712,0.476,0,1,0,339,711,0.477,158,185,0.854,237,453,690,155,78,73,101,203,836
415,12,2005,35,1,4,82,78,2817,338,758,0.446,0,0,-1,338,758,0.446,210,243,0.864,266,471,737,178,74,50,101,233,886
415,13,2006,36,1,5,75,73,2380,269,583,0.461,0,0,-1,269,583,0.461,139,168,0.827,182,365,547,90,46,50,90,216,677
415,14,2007,37,1,4,72,49,1456,170,418,0.407,0,2,0,170,416,0.409,96,122,0.787,129,218,347,48,24,52,85,187,436
415,15,2008,38,1,4,18,0,209,14,41,0.341,0,1,0,14,40,0.35,11,16,0.688,29,39,68,10,5,8,10,29,39
416,1,1992,23,1,1,56,0,535,77,169,0.456,0,6,0,77,163,0.472,38,58,0.655,26,43,69,59,35,12,42,68,192
416,2,1993,24,1,1,75,34,1726,225,486,0.463,2,6,0.333,223,480,0.465,115,157,0.732,75,137,212,196,108,34,120,206,567
416,3,1994,25,1,1,61,2,1041,110,251,0.438,0,4,0,110,247,0.445,53,87,0.609,40,72,112,133,63,14,75,132,273
416,4,1995,26,1,1,67,2,1086,124,287,0.432,14,47,0.298,110,240,0.458,55,82,0.671,24,84,108,133,99,19,78,153,317
416,5,1996,27,1,1,68,0,671,78,192,0.406,1,11,0.091,77,181,0.425,28,46,0.609,17,49,66,73,57,12,31,88,185
416,6,1997,28,1,1,72,3,1057,140,333,0.42,4,22,0.182,136,311,0.437,57,84,0.679,34,77,111,133,81,17,58,116,341
416,7,1998,29,1,1,71,6,1147,116,302,0.384,0,5,0,116,297,0.391,56,78,0.718,34,60,94,151,71,12,63,118,288
416,8,1999,30,1,1,39,32,1139,132,319,0.414,0,10,0,132,309,0.427,78,103,0.757,27,105,132,149,68,8,80,93,342
416,9,2000,31,1,1,59,55,1625,157,435,0.361,3,6,0.5,154,429,0.359,62,84,0.738,23,121,144,202,61,15,105,120,379
416,10,2001,32,1,1,54,35,1238,100,237,0.422,0,3,0,100,234,0.427,23,40,0.575,23,76,99,154,62,10,56,132,223
416,11,2003,34,1,1,32,0,262,16,43,0.372,0,0,-1,16,43,0.372,9,12,0.75,3,23,26,35,17,2,17,36,41
418,1,1981,22,1,5,45,-1,580,83,162,0.512,0,0,-1,83,162,0.512,16,21,0.762,52,114,166,21,9,14,31,103,182
418,2,1982,23,1,5,82,11,1260,192,418,0.459,0,0,-1,192,418,0.459,86,122,0.705,136,228,364,19,36,29,84,243,470
418,3,1983,24,1,5,26,0,305,49,104,0.471,0,1,0,49,103,0.476,25,40,0.625,35,53,88,9,5,5,22,46,123
418,3,1983,24,1,5,50,7,743,118,245,0.482,0,2,0,118,243,0.486,40,65,0.615,56,122,178,16,8,21,60,126,276
418,3,1983,24,1,5,76,7,1048,167,349,0.479,0,3,0,167,346,0.483,65,105,0.619,91,175,266,25,13,26,82,172,399
418,4,1984,25,1,5,68,3,785,94,201,0.468,0,0,-1,94,201,0.468,48,65,0.738,67,114,181,29,18,23,53,161,236
418,5,1985,26,1,5,69,5,814,78,192,0.406,0,0,-1,78,192,0.406,39,68,0.574,76,147,223,25,19,22,51,117,195
420,1,2002,22,1,2,40,1,403,49,115,0.426,4,12,0.333,45,103,0.437,21,28,0.75,12,30,42,70,19,3,40,26,123
420,2,2003,23,1,1,15,0,168,27,59,0.458,0,1,0,27,58,0.466,11,14,0.786,8,22,30,39,13,0,22,9,65
420,3,2005,25,1,1,76,0,1066,124,348,0.356,26,72,0.361,98,276,0.355,59,75,0.787,21,72,93,155,32,1,74,59,333
424,1,1990,22,1,3,16,0,128,15,30,0.5,0,0,-1,15,30,0.5,7,18,0.389,15,11,26,3,6,5,6,24,37
425,1,1980,25,1,4,81,-1,2328,294,682,0.431,5,34,0.147,289,648,0.446,161,217,0.742,171,345,516,144,102,39,170,258,754
425,2,1981,26,1,4,82,-1,2359,379,791,0.479,2,15,0.133,377,776,0.486,193,244,0.791,146,294,440,189,72,34,176,264,953
425,3,1982,27,1,3,75,49,1988,341,701,0.486,8,30,0.267,333,671,0.496,194,247,0.785,79,195,274,189,78,29,183,250,884
425,4,1983,28,1,3,81,56,2055,344,768,0.448,8,36,0.222,336,732,0.459,116,165,0.703,88,189,277,186,82,30,177,258,812
426,1,1984,24,1,5,29,0,317,52,133,0.391,0,0,-1,52,133,0.391,14,33,0.424,37,43,80,13,9,11,16,48,118
426,2,1985,25,1,5,56,35,860,67,148,0.453,0,0,-1,67,148,0.453,30,44,0.682,74,167,241,84,21,24,46,110,164
426,3,1986,26,1,5,9,8,154,11,30,0.367,0,0,-1,11,30,0.367,6,11,0.545,9,24,33,11,3,2,7,26,28
426,3,1986,26,1,5,17,8,218,15,48,0.313,0,0,-1,15,48,0.313,11,19,0.579,17,36,53,15,5,5,9,38,41
428,1,1989,23,1,4,56,32,803,120,247,0.486,0,0,-1,120,247,0.486,40,69,0.58,65,114,179,33,20,7,41,144,280
428,2,1990,24,1,4,58,0,562,70,153,0.458,0,0,-1,70,153,0.458,28,50,0.56,54,92,146,13,18,9,25,93,168
428,3,1991,25,1,4,53,0,781,99,203,0.488,0,1,0,99,202,0.49,74,101,0.733,65,125,190,27,15,12,33,120,272
428,4,1992,26,1,4,56,0,800,95,198,0.48,0,3,0,95,195,0.487,40,60,0.667,87,114,201,41,26,8,30,105,230
428,5,1993,27,1,5,80,24,1396,186,370,0.503,0,1,0,186,369,0.504,104,148,0.703,132,192,324,41,37,23,65,226,476
428,6,1994,28,1,5,79,10,1441,185,384,0.482,0,1,0,185,383,0.483,72,104,0.692,117,198,315,37,32,29,66,187,442
428,7,1995,29,1,4,49,0,658,101,192,0.526,1,2,0.5,100,190,0.526,41,63,0.651,55,106,161,28,19,16,39,109,244
428,8,1996,30,1,4,71,9,1587,242,446,0.543,0,2,0,242,444,0.545,127,177,0.718,131,220,351,52,31,19,85,234,611
428,9,1997,31,1,4,41,18,1018,152,275,0.553,0,0,-1,152,275,0.553,76,108,0.704,67,145,212,47,22,5,46,136,380
428,10,1998,32,1,5,70,22,1110,109,225,0.484,0,1,0,109,224,0.487,73,95,0.768,92,152,244,46,36,15,58,180,291
428,11,1999,33,1,4,45,29,1204,168,348,0.483,0,1,0,168,347,0.484,71,110,0.645,92,140,232,48,34,16,68,149,407
428,12,2000,34,1,4,75,50,1712,174,346,0.503,0,0,-1,174,346,0.503,76,94,0.809,126,226,352,61,31,31,87,250,424
428,13,2001,35,1,4,18,1,101,8,20,0.4,0,0,-1,8,20,0.4,3,5,0.6,4,17,21,3,1,2,5,29,19
428,14,2002,36,1,4,30,3,206,25,55,0.455,0,0,-1,25,55,0.455,6,8,0.75,25,19,44,10,7,2,6,38,56
428,15,2003,37,1,4,16,0,100,5,19,0.263,0,0,-1,5,19,0.263,3,4,0.75,8,12,20,4,1,1,7,18,13
431,1,1998,25,1,1,38,10,622,49,141,0.348,22,61,0.361,27,80,0.338,42,62,0.677,14,42,56,100,25,3,52,55,162
431,2,2000,27,1,1,37,0,289,29,70,0.414,2,13,0.154,27,57,0.474,11,18,0.611,3,24,27,49,9,1,31,35,71
431,3,2001,28,1,1,7,0,142,10,35,0.286,2,11,0.182,8,24,0.333,4,9,0.444,2,7,9,24,7,1,9,16,26
431,3,2001,28,1,1,22,0,208,18,54,0.333,2,14,0.143,16,40,0.4,8,15,0.533,5,16,21,31,8,1,17,21,46
431,4,2002,29,1,1,59,2,520,45,113,0.398,6,11,0.545,39,102,0.382,29,41,0.707,23,45,68,114,25,2,47,51,125
431,5,2003,30,1,1,17,0,196,23,50,0.46,4,6,0.667,19,44,0.432,10,12,0.833,4,15,19,36,10,3,17,20,60
431,6,2004,31,1,1,37,0,402,38,101,0.376,11,23,0.478,27,78,0.346,27,31,0.871,9,28,37,80,25,3,33,44,114
431,6,2004,31,1,1,40,0,412,40,105,0.381,11,23,0.478,29,82,0.354,27,31,0.871,9,28,37,82,25,3,33,44,118
431,7,2005,32,1,1,80,39,1945,166,442,0.376,48,130,0.369,118,312,0.378,57,74,0.77,23,164,187,410,82,7,125,106,437
431,8,2006,33,1,1,23,0,215,16,46,0.348,5,12,0.417,11,34,0.324,7,12,0.583,1,19,20,33,8,1,19,21,44
431,8,2006,33,1,1,27,0,246,21,54,0.389,5,13,0.385,16,41,0.39,7,12,0.583,1,21,22,35,8,1,22,22,54
435,1,2000,23,1,2,48,1,923,111,233,0.476,10,26,0.385,101,207,0.488,43,63,0.683,56,118,174,55,38,20,36,148,275
435,2,2001,24,1,2,37,9,820,84,192,0.438,2,7,0.286,82,185,0.443,59,81,0.728,60,97,157,49,33,9,27,118,229
435,3,2002,25,1,2,44,16,885,104,198,0.525,5,16,0.313,99,182,0.544,40,58,0.69,67,106,173,48,31,19,27,124,253
435,4,2003,26,1,2,75,5,1514,185,398,0.465,15,55,0.273,170,343,0.496,65,81,0.802,72,144,216,96,72,16,62,203,450
435,5,2004,27,1,2,53,3,703,66,175,0.377,12,44,0.273,54,131,0.412,20,27,0.741,28,75,103,45,21,4,34,77,164
435,6,2005,28,1,2,70,41,1522,160,303,0.528,49,121,0.405,111,182,0.61,63,81,0.778,66,142,208,133,75,6,49,169,432
435,7,2006,29,1,2,73,27,1758,181,417,0.434,86,243,0.354,95,174,0.546,43,55,0.782,31,178,209,127,87,20,52,180,491
435,8,2007,30,1,2,76,11,1372,123,299,0.411,32,103,0.311,91,196,0.464,27,34,0.794,35,123,158,70,47,7,40,152,305
435,9,2008,31,1,2,31,4,520,45,117,0.385,15,50,0.3,30,67,0.448,19,22,0.864,10,55,65,39,21,2,29,63,124
435,10,2009,32,1,3,63,0,878,61,159,0.384,13,51,0.255,48,108,0.444,20,25,0.8,32,98,130,57,29,8,38,108,155
436,1,1980,25,1,1,67,-1,1690,306,655,0.467,2,5,0.4,304,650,0.468,105,143,0.734,69,169,238,383,135,4,149,202,719
436,2,1981,26,1,1,82,-1,2384,471,956,0.493,1,6,0.167,470,950,0.495,149,203,0.734,88,210,298,384,197,3,236,271,1092
436,3,1982,27,1,1,70,70,2156,396,822,0.482,4,15,0.267,392,807,0.486,110,168,0.655,77,173,250,328,174,3,180,218,906
436,4,1983,28,1,2,72,56,1565,248,561,0.442,0,4,0,248,557,0.445,74,117,0.632,62,125,187,275,108,5,159,195,570
436,5,1984,29,1,1,79,0,1249,138,323,0.427,0,6,0,138,317,0.435,48,74,0.649,41,96,137,214,84,3,100,187,324
436,6,1985,30,1,1,75,6,858,74,193,0.383,0,1,0,74,192,0.385,32,50,0.64,26,61,87,148,63,2,67,142,180
436,7,1986,31,1,1,32,3,419,49,104,0.471,0,1,0,49,103,0.476,19,27,0.704,9,42,51,86,40,3,55,80,117
439,1,1991,22,1,3,74,10,859,94,226,0.416,1,4,0.25,93,222,0.419,43,66,0.652,61,80,141,51,33,15,26,79,232
439,2,1992,23,1,3,15,0,121,10,33,0.303,0,1,0,10,32,0.313,9,12,0.75,10,18,28,10,9,3,7,11,29
439,2,1992,23,1,3,11,0,140,15,30,0.5,0,0,-1,15,30,0.5,3,9,0.333,6,16,22,11,8,3,5,18,33
439,2,1992,23,1,3,28,0,290,29,71,0.408,0,1,0,29,70,0.414,12,21,0.571,18,34,52,23,19,7,13,31,70
439,3,1993,24,1,3,70,9,1287,176,403,0.437,20,59,0.339,156,344,0.453,65,87,0.747,81,114,195,94,47,19,55,98,437
439,4,1994,25,1,3,36,0,218,42,84,0.5,12,29,0.414,30,55,0.545,10,20,0.5,13,19,32,16,8,1,12,24,106
439,5,1995,26,1,3,57,0,605,90,183,0.492,15,48,0.313,75,135,0.556,22,39,0.564,36,62,98,50,24,12,30,64,217
439,6,1996,27,1,3,74,0,740,112,242,0.463,40,90,0.444,72,152,0.474,14,22,0.636,45,66,111,56,34,7,39,70,278
439,7,1997,28,1,3,76,0,703,58,158,0.367,18,54,0.333,40,104,0.385,5,14,0.357,45,81,126,60,23,21,27,50,139
439,8,1998,29,1,3,74,0,608,85,176,0.483,25,65,0.385,60,111,0.541,3,6,0.5,24,53,77,49,22,15,21,47,198
439,9,1999,30,1,3,50,0,1056,100,240,0.417,61,148,0.412,39,92,0.424,13,18,0.722,29,104,133,57,37,13,21,83,274
439,10,2000,31,1,3,58,5,657,55,156,0.353,18,83,0.217,37,73,0.507,2,7,0.286,30,61,91,33,25,16,13,50,130
439,11,2001,32,1,3,57,3,737,76,164,0.463,32,77,0.416,44,87,0.506,9,12,0.75,20,74,94,39,21,10,25,83,193
439,12,2002,33,1,3,60,2,630,42,112,0.375,19,54,0.352,23,58,0.397,2,4,0.5,27,81,108,29,20,8,14,46,105
439,12,2002,33,1,3,66,2,684,44,118,0.373,21,60,0.35,23,58,0.397,2,4,0.5,29,87,116,32,21,8,15,53,111
447,1,2006,26,1,1,39,1,340,22,88,0.25,10,54,0.185,12,34,0.353,16,17,0.941,4,22,26,48,26,2,25,63,70
448,1,2005,24,1,1,24,0,219,28,60,0.467,3,11,0.273,25,49,0.51,14,19,0.737,1,11,12,28,13,1,12,25,73
448,2,2006,25,1,1,57,1,570,51,144,0.354,1,6,0.167,50,138,0.362,10,23,0.435,4,33,37,76,20,0,36,45,113
449,1,1980,27,1,5,37,-1,272,36,104,0.346,0,3,0,36,101,0.356,23,40,0.575,23,49,72,20,8,13,25,49,95
449,2,1981,28,1,5,31,-1,363,41,99,0.414,0,0,-1,41,99,0.414,20,41,0.488,44,50,94,12,8,19,24,73,102
452,1,1994,22,1,4,23,0,143,22,55,0.4,0,0,-1,22,55,0.4,12,23,0.522,13,17,30,9,6,3,7,33,56
454,1,1994,23,1,3,51,16,767,98,234,0.419,2,6,0.333,96,228,0.421,46,70,0.657,46,86,132,62,37,16,45,88,244
454,2,1995,24,1,3,65,62,2014,277,593,0.467,96,235,0.409,181,358,0.506,100,144,0.694,96,272,368,161,75,40,85,187,750
454,3,1996,25,1,3,20,20,693,92,206,0.447,37,98,0.378,55,108,0.509,42,56,0.75,26,72,98,47,27,13,43,76,263
454,4,1997,26,1,3,29,0,457,53,140,0.379,22,61,0.361,31,79,0.392,15,23,0.652,25,54,79,35,14,8,28,60,143
454,4,1997,26,1,3,28,2,482,45,131,0.344,19,55,0.345,26,76,0.342,42,53,0.792,24,55,79,39,14,11,25,60,151
454,4,1997,26,1,3,57,2,939,98,271,0.362,41,116,0.353,57,155,0.368,57,76,0.75,49,109,158,74,28,19,53,120,294
454,5,1998,27,1,3,80,3,1096,159,375,0.424,51,144,0.354,108,231,0.468,47,64,0.734,80,118,198,65,64,37,50,131,416
454,6,1999,28,1,3,32,10,706,75,208,0.361,28,72,0.389,47,136,0.346,34,42,0.81,32,87,119,45,40,11,23,82,212
454,7,2000,29,1,3,74,9,1336,165,419,0.394,82,232,0.353,83,187,0.444,39,50,0.78,65,191,256,72,67,44,38,173,451
456,1,1996,23,1,4,61,3,495,64,170,0.376,0,0,-1,64,170,0.376,61,93,0.656,45,64,109,15,15,10,40,74,189
459,1,2006,20,1,5,55,0,740,117,215,0.544,0,0,-1,117,215,0.544,58,77,0.753,67,116,183,25,17,31,62,127,292
459,2,2007,21,1,5,11,2,103,16,35,0.457,0,0,-1,16,35,0.457,9,10,0.9,6,16,22,5,2,0,10,16,41
462,1,1980,29,1,1,81,-1,2499,261,589,0.443,19,79,0.241,242,510,0.475,85,128,0.664,70,163,233,320,132,10,91,111,626
462,2,1981,30,1,2,58,-1,1095,114,287,0.397,19,58,0.328,95,229,0.415,50,65,0.769,19,65,84,140,74,8,38,61,297
462,3,1982,31,1,1,82,78,2529,312,685,0.455,73,189,0.386,239,496,0.482,100,123,0.813,46,177,223,407,164,27,95,176,797
462,4,1983,32,1,1,41,1,643,72,182,0.396,9,35,0.257,63,147,0.429,41,46,0.891,19,35,54,115,44,2,25,60,194
462,5,1984,33,1,1,76,10,1327,150,352,0.426,18,59,0.305,132,293,0.451,63,80,0.788,29,87,116,303,86,1,87,62,381
462,6,1985,34,1,1,65,14,939,82,203,0.404,31,87,0.356,51,116,0.44,23,30,0.767,21,40,61,203,38,1,45,75,218
463,1,1989,22,1,5,33,0,140,20,48,0.417,0,3,0,20,45,0.444,16,20,0.8,9,19,28,2,1,2,17,28,56
473,1,2008,22,1,4,22,0,260,44,77,0.571,0,2,0,44,75,0.587,15,22,0.682,33,53,86,11,8,11,13,25,103
473,1,2008,22,1,4,26,0,269,46,82,0.561,0,2,0,46,80,0.575,15,22,0.682,34,55,89,11,8,11,13,25,107
475,1,1997,22,1,4,38,0,614,54,153,0.353,4,13,0.308,50,140,0.357,34,65,0.523,81,130,211,26,16,13,31,75,146
475,1,1997,22,1,4,41,0,624,56,157,0.357,5,14,0.357,51,143,0.357,34,67,0.507,82,132,214,26,16,14,31,78,151
475,2,1998,23,1,4,45,2,450,39,90,0.433,4,13,0.308,35,77,0.455,20,41,0.488,45,79,124,16,25,17,21,67,102
475,3,1999,24,1,4,26,16,849,67,133,0.504,0,0,-1,67,133,0.504,43,60,0.717,112,174,286,24,25,18,34,73,177
475,3,1999,24,1,4,28,16,852,67,134,0.5,0,0,-1,67,134,0.5,43,60,0.717,112,176,288,24,25,18,34,73,177
475,4,2000,25,1,5,81,17,2241,181,423,0.428,3,3,1,178,420,0.424,94,133,0.707,264,491,755,68,43,38,59,206,459
475,5,2001,26,1,5,6,0,149,8,23,0.348,0,0,-1,8,23,0.348,6,12,0.5,12,44,56,5,8,3,7,15,22
482,1,2009,23,1,2,78,4,1993,268,630,0.425,159,398,0.399,109,232,0.47,120,143,0.839,47,160,207,159,69,12,86,111,815
482,2,2010,24,1,2,62,2,1441,160,423,0.378,98,266,0.368,62,157,0.395,85,98,0.867,35,129,164,127,62,11,72,87,503
482,3,2011,25,1,2,78,3,1821,213,575,0.37,116,361,0.321,97,214,0.453,126,146,0.863,37,135,172,193,87,14,88,134,668
482,4,2012,26,1,2,31,1,710,99,225,0.44,40,122,0.328,59,103,0.573,30,43,0.698,9,56,65,75,31,3,40,37,268
485,1,1991,24,1,4,81,2,1661,275,643,0.428,23,77,0.299,252,566,0.445,124,152,0.816,99,187,286,142,43,25,120,230,697
485,2,1992,25,1,4,68,1,937,134,328,0.409,17,48,0.354,117,280,0.418,61,73,0.836,53,160,213,75,22,15,46,135,346
485,3,1993,26,1,4,76,1,1461,220,459,0.479,34,82,0.415,186,377,0.493,99,113,0.876,81,198,279,137,29,49,83,171,573
485,4,1994,27,1,4,70,1,965,149,334,0.446,14,51,0.275,135,283,0.477,38,43,0.884,47,94,141,74,28,22,41,113,350
485,5,1995,28,1,4,82,6,1290,223,500,0.446,94,233,0.403,129,267,0.483,74,84,0.881,30,113,143,96,27,22,59,131,614
485,6,1996,29,1,4,82,79,2680,422,919,0.459,143,363,0.394,279,556,0.502,103,134,0.769,71,238,309,191,57,37,122,233,1090
485,7,1997,30,1,4,82,48,2633,341,794,0.429,114,284,0.401,227,510,0.445,74,87,0.851,82,255,337,151,56,32,94,245,870
485,8,1998,31,1,4,69,3,1034,113,286,0.395,33,99,0.333,80,187,0.428,32,40,0.8,23,91,114,59,26,17,53,118,291
485,9,1999,32,1,4,50,10,1058,141,296,0.476,38,97,0.392,103,199,0.518,29,33,0.879,16,86,102,53,23,10,39,113,349
485,10,2000,33,1,4,63,3,1326,189,380,0.497,33,75,0.44,156,305,0.511,52,57,0.912,55,183,238,67,22,24,55,181,463
485,11,2001,34,1,3,80,29,1688,178,375,0.475,70,156,0.449,108,219,0.493,22,30,0.733,55,168,223,71,28,21,50,169,448
485,12,2002,35,1,3,50,2,799,76,177,0.429,43,99,0.434,33,78,0.423,34,36,0.944,15,75,90,48,16,9,22,70,229
485,13,2003,36,1,3,64,1,601,44,124,0.355,21,60,0.35,23,64,0.359,10,13,0.769,20,55,75,21,7,9,27,55,119
486,1,1989,23,1,3,41,0,231,35,83,0.422,0,0,-1,35,83,0.422,30,44,0.682,19,22,41,10,7,6,12,33,100
486,2,1991,25,1,3,78,2,1165,174,356,0.489,2,3,0.667,172,353,0.487,125,156,0.801,97,82,179,55,33,27,78,151,475
486,3,1992,26,1,3,66,12,1598,331,632,0.524,11,33,0.333,320,599,0.534,166,218,0.761,105,105,210,92,49,17,99,134,839
486,4,1993,27,1,3,82,15,1736,327,696,0.47,9,36,0.25,318,660,0.482,176,226,0.779,97,94,191,132,59,17,103,160,839
486,5,1994,28,1,3,72,13,1155,184,379,0.485,1,9,0.111,183,370,0.495,144,184,0.783,62,67,129,65,44,16,64,85,513
486,6,1995,29,1,3,56,1,607,83,173,0.48,1,6,0.167,82,167,0.491,64,85,0.753,50,38,88,31,26,6,43,79,231
486,7,1996,30,1,3,54,6,591,80,166,0.482,0,8,0,80,158,0.506,42,57,0.737,32,61,93,30,23,3,34,83,202
486,8,1997,31,1,3,62,18,1115,159,337,0.472,18,44,0.409,141,293,0.481,58,94,0.617,57,84,141,66,38,6,55,120,394
486,9,1998,32,1,3,50,5,461,41,111,0.369,0,6,0,41,105,0.39,12,22,0.545,25,22,47,26,21,6,18,50,94
488,1,2009,22,1,5,21,1,156,21,36,0.583,0,0,-1,21,36,0.583,7,21,0.333,14,23,37,4,7,15,9,35,49
488,2,2010,23,1,5,49,5,408,52,95,0.547,0,1,0,52,94,0.553,24,57,0.421,33,57,90,15,6,19,24,78,128
488,3,2011,24,1,5,53,1,456,44,100,0.44,0,1,0,44,99,0.444,18,46,0.391,34,74,108,18,4,16,25,90,106
490,1,1985,22,1,3,51,1,535,84,191,0.44,0,0,-1,84,191,0.44,27,36,0.75,41,43,84,38,9,10,32,84,195
490,2,1986,23,1,3,78,3,1120,204,398,0.513,0,4,0,204,394,0.518,91,132,0.689,59,144,203,79,51,15,77,170,499
490,3,1987,24,1,3,44,17,861,153,344,0.445,3,12,0.25,150,332,0.452,72,89,0.809,63,83,146,60,31,11,52,120,381
490,3,1987,24,1,3,48,17,883,159,352,0.452,3,12,0.25,156,340,0.459,73,94,0.777,63,85,148,61,32,11,53,123,394
490,4,1988,25,1,3,7,0,154,16,36,0.444,0,0,-1,16,36,0.444,20,26,0.769,13,16,29,10,5,2,19,17,52
495,1,1996,22,1,3,82,72,3212,465,976,0.476,61,186,0.328,404,790,0.511,242,323,0.749,139,235,374,289,85,31,133,199,1233
495,2,1997,23,1,3,27,18,796,141,297,0.475,14,55,0.255,127,242,0.525,56,69,0.812,34,86,120,68,18,4,44,42,352
495,2,1997,23,1,3,56,36,1994,334,774,0.432,87,225,0.387,247,549,0.45,142,176,0.807,54,198,252,156,50,20,120,96,897
495,2,1997,23,1,3,83,54,2790,475,1071,0.444,101,280,0.361,374,791,0.473,198,245,0.808,88,284,372,224,68,24,164,138,1249
495,3,1998,24,1,3,82,82,3394,675,1505,0.449,87,244,0.357,588,1261,0.466,326,416,0.784,150,288,438,405,132,30,219,163,1763
495,4,1999,25,1,3,50,50,2051,389,876,0.444,45,136,0.331,344,740,0.465,186,226,0.823,69,194,263,218,66,15,107,96,1009
495,5,2000,26,1,3,82,82,3464,748,1636,0.457,99,247,0.401,649,1389,0.467,260,317,0.82,122,396,518,438,109,32,196,171,1855
495,6,2001,27,1,3,82,82,3443,711,1552,0.458,91,263,0.346,620,1289,0.481,252,325,0.775,109,316,425,360,118,32,190,174,1765
495,7,2002,28,1,3,69,69,2754,569,1228,0.463,76,224,0.339,493,1004,0.491,210,251,0.837,90,270,360,230,65,25,117,144,1424
495,8,2003,29,1,3,69,69,2642,507,1193,0.425,119,322,0.37,388,871,0.445,198,230,0.861,107,295,402,205,76,21,114,105,1331
495,9,2004,30,1,2,72,72,2778,514,1159,0.443,150,370,0.405,364,789,0.461,164,193,0.85,78,247,325,212,84,39,83,118,1342
495,10,2005,31,1,2,64,64,2358,387,907,0.427,116,285,0.407,271,622,0.436,113,136,0.831,45,217,262,169,48,18,60,123,1003
495,11,2006,32,1,2,77,18,2038,286,695,0.412,110,279,0.394,176,416,0.423,98,115,0.852,31,216,247,116,37,7,62,97,780
495,12,2007,33,1,3,82,16,1823,273,663,0.412,104,286,0.364,169,377,0.448,90,98,0.918,34,189,223,108,32,16,46,76,740
495,13,2008,34,1,2,82,61,2204,315,761,0.414,132,357,0.37,183,404,0.453,64,80,0.8,27,227,254,114,29,10,56,93,826
495,14,2009,35,1,3,81,77,2336,301,689,0.437,131,319,0.411,170,370,0.459,51,62,0.823,26,244,270,114,37,17,61,82,784
495,15,2010,36,1,3,21,1,314,44,87,0.506,19,41,0.463,25,46,0.543,2,6,0.333,1,32,33,24,4,2,8,21,109
495,15,2010,36,1,3,25,6,395,37,97,0.381,13,41,0.317,24,56,0.429,6,9,0.667,5,33,38,19,6,4,13,12,93
495,15,2010,36,1,3,46,7,709,81,184,0.44,32,82,0.39,49,102,0.48,8,15,0.533,6,65,71,43,10,6,21,33,202
497,1,1995,25,1,5,26,8,370,49,103,0.476,0,1,0,49,102,0.48,25,37,0.676,32,52,84,17,16,7,28,70,123
497,2,1996,26,1,5,16,0,117,15,26,0.577,0,0,-1,15,26,0.577,10,18,0.556,7,11,18,7,3,6,3,16,40
497,2,1996,26,1,5,18,1,134,21,36,0.583,0,0,-1,21,36,0.583,10,19,0.526,10,11,21,8,3,7,3,19,52
499,1,2006,23,1,1,18,1,239,30,89,0.337,7,26,0.269,23,63,0.365,17,23,0.739,7,23,30,33,7,5,15,28,84
503,1,1983,25,1,4,53,5,699,110,206,0.534,0,2,0,110,204,0.539,41,53,0.774,71,109,180,47,19,12,43,99,261
504,1,1985,22,1,1,80,65,2486,433,922,0.47,0,4,0,433,918,0.472,260,339,0.767,148,175,323,247,99,8,197,232,1126
504,2,1986,23,1,1,80,77,2870,436,862,0.506,1,6,0.167,435,856,0.508,263,353,0.745,102,284,386,505,131,5,208,230,1136
504,3,1987,24,1,1,82,82,2549,370,727,0.509,2,10,0.2,368,717,0.513,238,302,0.788,109,225,334,473,109,18,167,222,980
504,4,1988,25,1,1,80,80,2733,442,845,0.523,0,13,0,442,832,0.531,227,283,0.802,106,258,364,568,115,11,175,225,1111
504,5,1989,26,1,1,76,69,2552,419,814,0.515,3,23,0.13,416,791,0.526,243,304,0.799,85,225,310,494,77,12,192,212,1084
504,6,1990,27,1,1,82,82,2876,467,919,0.508,12,34,0.353,455,885,0.514,230,294,0.782,118,204,322,610,92,10,206,213,1176
504,7,1991,28,1,1,69,45,1929,356,671,0.531,4,18,0.222,352,653,0.539,161,221,0.729,83,131,214,369,76,13,137,116,877
504,8,1992,29,1,1,82,6,1737,294,610,0.482,6,27,0.222,288,583,0.494,132,179,0.737,69,140,209,266,56,7,140,134,726
504,9,1993,30,1,1,75,8,1503,280,554,0.505,7,36,0.194,273,518,0.527,143,197,0.726,63,106,169,224,63,9,121,126,710
504,10,1994,31,1,1,55,5,1053,147,318,0.462,0,4,0,147,314,0.468,64,87,0.736,27,96,123,173,40,6,87,98,358
504,11,1995,32,1,1,55,1,686,93,188,0.495,0,7,0,93,181,0.514,65,90,0.722,20,68,88,109,27,1,43,80,251
504,12,1996,33,1,1,77,3,1747,227,524,0.433,3,28,0.107,224,496,0.452,133,177,0.751,49,121,170,255,41,5,122,115,590
506,1,2001,22,1,4,72,13,1580,278,646,0.43,10,39,0.256,268,607,0.442,117,161,0.727,76,237,313,76,30,19,124,175,683
506,2,2002,23,1,4,76,20,1963,371,848,0.438,7,41,0.171,364,807,0.451,189,283,0.668,128,299,427,120,49,24,131,186,938
506,3,2003,24,1,4,38,0,809,178,383,0.465,1,6,0.167,177,377,0.469,88,134,0.657,80,136,216,48,14,17,57,89,445
506,4,2004,25,1,3,46,2,738,134,350,0.383,2,17,0.118,132,333,0.396,90,120,0.75,61,141,202,43,16,8,51,97,360
506,5,2005,26,1,4,54,0,903,133,292,0.455,0,6,0,133,286,0.465,70,103,0.68,29,146,175,64,25,13,63,96,336
507,1,1983,22,1,1,43,6,494,92,216,0.426,4,14,0.286,88,202,0.436,38,45,0.844,16,26,42,67,19,9,40,56,226
507,1,1983,22,1,1,33,11,754,134,311,0.431,6,11,0.545,128,300,0.427,112,135,0.83,40,55,95,71,39,8,66,78,386
507,1,1983,22,1,1,76,17,1248,226,527,0.429,10,25,0.4,216,502,0.43,150,180,0.833,56,81,137,138,58,17,106,134,612
507,2,1984,23,1,1,77,73,2555,484,1045,0.463,8,45,0.178,476,1000,0.476,315,386,0.816,87,184,271,269,103,31,196,216,1291
507,3,1985,24,1,2,82,82,2873,610,1372,0.445,42,143,0.294,568,1229,0.462,336,415,0.81,62,140,202,406,134,41,251,226,1598
507,4,1986,25,1,1,82,82,2764,510,1007,0.506,39,119,0.328,471,888,0.53,351,441,0.796,76,221,297,746,157,16,290,199,1410
507,5,1987,26,1,1,82,82,3064,503,1030,0.488,73,190,0.384,430,840,0.512,462,537,0.86,56,212,268,848,146,18,280,199,1541
507,6,1988,27,1,1,18,18,680,132,301,0.439,1,20,0.05,131,281,0.466,116,139,0.835,26,65,91,178,27,2,67,46,381
507,6,1988,27,1,1,59,55,1834,288,668,0.431,13,52,0.25,275,616,0.446,185,215,0.86,51,154,205,366,68,10,156,144,774
507,6,1988,27,1,1,77,73,2514,420,969,0.433,14,72,0.194,406,897,0.453,301,354,0.85,77,219,296,544,95,12,223,190,1155
507,7,1989,28,1,1,82,82,2788,396,893,0.443,109,292,0.373,287,601,0.478,261,309,0.845,48,258,306,709,124,11,253,196,1162
507,8,1990,29,1,1,82,73,2630,362,803,0.451,89,234,0.38,273,569,0.48,187,232,0.806,46,152,198,600,94,11,204,159,1000
507,9,1991,30,1,1,82,4,1850,386,939,0.411,48,176,0.273,338,763,0.443,185,246,0.752,52,107,159,317,95,17,140,122,1005
507,10,1992,31,1,1,82,3,1662,286,704,0.406,37,123,0.301,249,581,0.429,135,170,0.794,34,116,150,239,57,21,128,128,744
507,11,1993,32,1,1,52,10,867,124,305,0.407,16,56,0.286,108,249,0.434,81,102,0.794,14,72,86,132,32,6,68,59,345
507,12,1994,33,1,1,53,2,737,70,209,0.335,8,36,0.222,62,173,0.358,52,78,0.667,10,60,70,101,12,8,61,71,200
507,13,1995,34,1,2,48,1,831,71,212,0.335,25,88,0.284,46,124,0.371,30,43,0.698,8,46,54,126,13,6,51,73,197
508,1,2010,20,1,1,81,81,2339,397,952,0.417,77,215,0.358,320,737,0.434,223,270,0.826,24,167,191,356,82,2,233,98,1094
508,2,2011,21,1,1,53,8,983,108,296,0.365,31,100,0.31,77,196,0.393,32,42,0.762,12,65,77,182,34,3,113,58,279
508,3,2012,22,1,1,11,0,135,12,41,0.293,2,9,0.222,10,32,0.313,11,14,0.786,1,7,8,28,3,1,9,8,37
508,3,2012,22,1,1,18,1,281,34,90,0.378,8,25,0.32,26,65,0.4,18,25,0.72,7,24,31,68,3,1,27,15,94
508,3,2012,22,1,1,29,1,416,46,131,0.351,10,34,0.294,36,97,0.371,29,39,0.744,8,31,39,96,6,2,36,23,131
516,1,2002,20,1,4,53,0,452,61,118,0.517,0,0,-1,61,118,0.517,42,57,0.737,32,75,107,7,6,7,32,99,164
520,1,1980,31,1,2,73,73,2115,330,709,0.465,70,164,0.427,260,545,0.477,86,114,0.754,77,104,181,215,111,27,105,178,816
520,2,1981,32,1,2,82,75,2723,314,707,0.444,36,109,0.33,278,598,0.465,64,87,0.736,72,91,163,295,100,23,127,212,728
520,3,1982,33,1,2,76,53,1591,188,450,0.418,20,63,0.317,168,387,0.434,39,56,0.696,52,56,108,142,42,10,52,143,435
521,1,1980,27,1,3,21,-1,419,65,144,0.451,1,2,0.5,64,142,0.451,22,25,0.88,21,66,87,29,11,6,21,45,153
521,1,1980,27,1,3,52,-1,580,66,130,0.508,0,1,0,66,129,0.512,23,28,0.821,23,75,98,36,11,15,30,86,155
521,1,1980,27,1,3,73,-1,999,131,274,0.478,1,3,0.333,130,271,0.48,45,53,0.849,44,141,185,65,22,21,51,131,308
521,2,1981,28,1,3,64,-1,996,100,224,0.446,0,3,0,100,221,0.452,22,24,0.917,74,90,164,84,15,12,49,100,222
521,3,1982,29,1,3,21,1,201,9,24,0.375,0,1,0,9,23,0.391,5,6,0.833,14,21,35,11,8,0,15,30,23
523,1,1980,23,1,1,82,-1,2621,489,1058,0.462,4,23,0.174,485,1035,0.469,346,423,0.818,29,143,172,610,136,4,282,208,1328
523,2,1981,24,1,1,66,-1,2287,424,887,0.478,11,36,0.306,413,851,0.485,294,354,0.831,26,102,128,580,99,6,241,190,1153
523,3,1982,25,1,1,72,65,1952,285,649,0.439,7,32,0.219,278,617,0.451,136,166,0.819,24,81,105,451,63,1,194,160,713
523,4,1983,26,1,1,7,7,163,20,35,0.571,0,1,0,20,34,0.588,7,10,0.7,0,7,7,38,6,0,21,22,47
523,4,1983,26,1,1,70,56,1447,193,410,0.471,1,8,0.125,192,402,0.478,90,113,0.796,18,78,96,252,46,3,113,168,477
523,4,1983,26,1,1,77,63,1610,213,445,0.479,1,9,0.111,212,436,0.486,97,123,0.789,18,85,103,290,52,3,134,190,524
523,5,1984,27,1,1,81,55,2020,236,470,0.502,2,15,0.133,234,455,0.514,98,117,0.838,28,109,137,410,59,8,135,243,572
523,6,1985,28,1,1,25,1,290,14,47,0.298,0,4,0,14,43,0.326,16,18,0.889,3,24,27,61,6,1,17,33,44
525,1,1996,23,1,3,28,1,139,30,80,0.375,4,25,0.16,26,55,0.473,26,34,0.765,12,12,24,5,8,1,6,27,90
528,1,1984,23,1,1,80,34,1424,260,580,0.448,22,84,0.262,238,496,0.48,122,155,0.787,39,81,120,172,54,9,108,193,664
528,2,1985,24,1,1,79,1,1318,286,636,0.45,41,126,0.325,245,510,0.48,83,110,0.755,27,53,80,186,61,0,117,171,696
528,3,1986,25,1,1,48,0,704,85,218,0.39,9,32,0.281,76,186,0.409,23,32,0.719,9,49,58,121,22,1,61,77,202
530,1,2002,20,1,4,28,1,320,42,104,0.404,7,23,0.304,35,81,0.432,17,20,0.85,25,37,62,10,9,11,21,22,108
532,1,1998,21,1,4,80,23,1811,276,611,0.452,1,3,0.333,275,608,0.452,263,339,0.776,182,266,448,76,44,30,157,314,816
532,2,1999,22,1,4,50,38,1417,191,386,0.495,0,3,0,191,383,0.499,168,231,0.727,210,371,581,32,31,22,77,212,550
532,3,2000,23,1,4,55,5,856,140,265,0.528,0,0,-1,140,265,0.528,139,189,0.735,141,225,366,29,20,5,67,180,419
532,4,2001,24,1,4,6,6,203,29,50,0.58,0,0,-1,29,50,0.58,42,54,0.778,29,69,98,5,2,0,10,22,100
532,5,2002,25,1,4,77,76,2216,309,722,0.428,1,4,0.25,308,718,0.429,245,308,0.795,290,609,899,127,44,17,160,255,864
532,6,2003,26,1,4,17,0,223,20,54,0.37,0,1,0,20,53,0.377,19,29,0.655,28,45,73,12,9,0,15,43,59
532,7,2004,27,1,5,56,20,625,71,139,0.511,0,0,-1,71,139,0.511,75,92,0.815,114,136,250,9,12,11,37,148,217
532,8,2005,28,1,5,62,0,1047,118,226,0.522,0,0,-1,118,226,0.522,227,258,0.88,157,191,348,8,15,7,91,265,463
532,9,2006,29,1,5,23,1,276,27,51,0.529,0,0,-1,27,51,0.529,33,43,0.767,31,47,78,2,4,2,26,76,87
532,10,2007,30,1,5,14,6,158,15,30,0.5,0,1,0,15,29,0.517,10,13,0.769,13,30,43,1,1,0,15,38,40
533,1,1991,22,1,4,54,3,606,97,211,0.46,0,5,0,97,206,0.471,42,61,0.689,52,99,151,37,12,22,45,112,236
533,2,1992,23,1,4,49,3,548,89,193,0.461,0,1,0,89,192,0.464,35,49,0.714,43,102,145,35,6,12,36,83,213
533,3,1993,24,1,4,33,0,205,44,95,0.463,0,4,0,44,91,0.484,13,18,0.722,24,32,56,10,3,9,16,41,101
533,3,1993,24,1,4,43,0,298,55,120,0.458,0,4,0,55,116,0.474,15,21,0.714,32,51,83,21,3,14,25,58,125
533,4,1995,26,1,4,17,3,299,41,86,0.477,0,0,-1,41,86,0.477,22,31,0.71,18,36,54,16,2,8,17,54,104
533,4,1995,26,1,4,61,0,845,109,232,0.47,7,23,0.304,102,209,0.488,56,80,0.7,67,138,205,23,13,20,54,129,281
533,4,1995,26,1,4,78,3,1144,150,318,0.472,7,23,0.304,143,295,0.485,78,111,0.703,85,174,259,39,15,28,71,183,385
533,5,1996,27,1,5,73,2,803,107,244,0.439,1,8,0.125,106,236,0.449,61,72,0.847,53,125,178,25,7,22,58,120,276
533,6,1997,28,1,5,79,12,920,111,245,0.453,2,3,0.667,109,242,0.45,54,65,0.831,56,131,187,31,10,20,54,145,278
533,7,1998,29,1,5,78,49,1446,186,418,0.445,2,9,0.222,184,409,0.45,67,87,0.77,85,188,273,51,15,28,68,187,441
533,8,1999,30,1,4,42,1,458,52,138,0.377,1,4,0.25,51,134,0.381,13,21,0.619,28,55,83,25,6,8,24,63,118
533,9,2000,31,1,4,60,5,718,91,224,0.406,3,15,0.2,88,209,0.421,18,28,0.643,16,91,107,41,10,18,28,105,203
533,10,2001,32,1,5,62,8,451,56,133,0.421,3,9,0.333,53,124,0.427,10,14,0.714,29,83,112,32,9,12,25,76,125
533,11,2003,34,1,5,29,9,539,47,122,0.385,1,4,0.25,46,118,0.39,26,32,0.813,30,72,102,13,1,9,30,82,121
534,1,2001,24,1,5,71,9,1152,100,213,0.469,2,7,0.286,98,206,0.476,47,91,0.516,144,245,389,33,39,28,52,152,249
534,2,2002,25,1,5,82,48,1786,177,394,0.449,2,15,0.133,175,379,0.462,111,182,0.61,206,350,556,70,71,38,79,232,467
534,3,2003,26,1,5,77,2,802,64,178,0.36,0,2,0,64,176,0.364,34,63,0.54,118,161,279,51,28,21,34,103,162
534,4,2004,27,1,5,82,79,1961,197,362,0.544,0,4,0,197,358,0.55,103,154,0.669,248,362,610,64,71,27,60,189,497
534,5,2005,28,1,5,61,43,1594,168,324,0.519,0,5,0,168,319,0.527,90,142,0.634,205,345,550,43,46,12,55,186,426
534,6,2006,29,1,5,63,37,1581,138,250,0.552,0,4,0,138,246,0.561,96,159,0.604,224,350,574,50,41,27,64,191,372
534,7,2007,30,1,5,75,43,1740,122,260,0.469,0,1,0,122,259,0.471,78,122,0.639,253,356,609,57,62,37,70,202,322
534,8,2008,31,1,5,77,52,1884,205,373,0.55,0,3,0,205,370,0.554,86,145,0.593,264,404,668,129,56,32,62,221,496
534,9,2009,32,1,5,74,26,1828,177,353,0.501,2,7,0.286,175,346,0.506,96,146,0.658,215,293,508,130,53,49,88,229,452
534,10,2010,33,1,5,16,3,255,22,46,0.478,0,1,0,22,45,0.489,5,9,0.556,34,47,81,21,3,4,14,45,49
534,11,2011,34,1,5,56,3,940,80,167,0.479,0,3,0,80,164,0.488,27,48,0.563,160,190,350,46,24,31,26,127,187
534,12,2012,35,1,5,11,0,141,9,18,0.5,1,1,1,8,17,0.471,6,9,0.667,18,24,42,4,8,1,7,26,25
537,1,2002,25,1,3,22,17,343,25,64,0.391,0,0,-1,25,64,0.391,24,31,0.774,32,32,64,17,11,1,13,39,74
537,2,2003,26,1,3,37,10,573,56,128,0.438,2,9,0.222,54,119,0.454,50,59,0.847,41,62,103,23,25,2,20,63,164
537,3,2004,27,1,3,36,0,261,15,48,0.313,1,8,0.125,14,40,0.35,13,18,0.722,18,35,53,14,9,3,12,37,44
541,1,1992,22,1,3,81,5,1535,241,525,0.459,23,70,0.329,218,455,0.479,139,184,0.755,73,147,220,126,78,30,123,230,644
541,2,1993,23,1,3,71,14,1082,184,380,0.484,4,23,0.174,180,357,0.504,81,101,0.802,55,104,159,113,61,21,77,133,453
541,3,1994,24,1,3,82,53,2096,340,728,0.467,33,100,0.33,307,628,0.489,174,230,0.757,105,250,355,217,81,52,158,244,887
541,4,1995,25,1,3,53,7,1039,169,351,0.481,31,75,0.413,138,276,0.5,95,123,0.772,61,94,155,139,52,19,78,154,464
541,5,1996,26,1,3,81,81,2588,421,928,0.454,99,272,0.364,322,656,0.491,196,254,0.772,158,292,450,369,113,41,216,290,1137
541,6,1997,27,1,3,76,75,2650,433,950,0.456,101,278,0.363,332,672,0.494,207,263,0.787,114,280,394,286,167,40,178,279,1174
541,7,1998,28,1,3,82,82,2709,363,771,0.471,86,265,0.325,277,506,0.547,171,230,0.743,78,280,358,276,100,48,201,309,983
541,8,1999,29,1,3,44,1,944,148,330,0.448,32,95,0.337,116,235,0.494,66,89,0.742,26,63,89,89,28,10,56,114,394
541,9,2000,30,1,3,82,1,1473,206,498,0.414,59,181,0.326,147,317,0.464,63,78,0.808,63,135,198,138,52,26,87,203,534
541,10,2001,31,1,3,82,77,2291,287,646,0.444,118,300,0.393,169,346,0.488,95,122,0.779,80,245,325,262,70,29,136,225,787
541,11,2002,32,1,3,82,82,2289,255,605,0.421,65,208,0.313,190,397,0.479,70,85,0.824,90,299,389,283,67,21,132,244,645
541,12,2003,33,1,3,76,75,2181,262,621,0.422,105,280,0.375,157,341,0.46,52,69,0.754,64,259,323,253,69,14,121,215,681
541,13,2004,34,1,3,38,34,846,73,186,0.392,15,61,0.246,58,125,0.464,22,30,0.733,29,73,102,98,29,4,48,99,183
542,1,1998,22,1,5,55,1,656,69,170,0.406,0,1,0,69,169,0.408,27,62,0.435,73,111,184,14,13,52,50,94,165
542,2,1999,23,1,5,44,0,614,52,121,0.43,0,0,-1,52,121,0.43,25,51,0.49,79,115,194,18,15,43,31,90,129
542,3,2000,24,1,5,76,59,1654,193,380,0.508,0,0,-1,193,380,0.508,34,90,0.378,174,250,424,42,26,136,71,218,420
542,4,2001,25,1,5,58,37,1457,156,375,0.416,0,0,-1,156,375,0.416,30,68,0.441,156,249,405,48,31,156,79,136,342
542,5,2002,26,1,5,79,36,1485,171,385,0.444,0,0,-1,171,385,0.444,37,93,0.398,150,234,384,41,36,168,76,179,379
542,6,2003,27,1,5,82,0,1787,185,345,0.536,0,1,0,185,344,0.538,70,104,0.673,176,314,490,37,40,205,73,214,440
542,7,2004,28,1,5,44,8,572,59,130,0.454,0,0,-1,59,130,0.454,19,35,0.543,54,113,167,17,6,46,21,68,137
542,8,2005,29,1,5,78,50,1700,156,311,0.502,0,0,-1,156,311,0.502,40,72,0.556,165,264,429,56,26,159,58,201,352
542,9,2006,30,1,5,77,72,1824,152,300,0.507,0,0,-1,152,300,0.507,41,67,0.612,143,281,424,33,44,125,80,215,345
542,10,2007,31,1,5,48,6,475,48,85,0.565,0,0,-1,48,85,0.565,11,25,0.44,51,75,126,19,11,50,23,61,107
542,11,2008,32,1,5,82,0,774,70,153,0.458,0,0,-1,70,153,0.458,16,34,0.471,71,137,208,18,16,45,32,94,156
543,1,2000,22,1,1,77,77,2776,497,1117,0.445,107,310,0.345,390,807,0.483,287,365,0.786,152,257,409,507,118,29,306,231,1388
543,2,2001,23,1,1,80,79,3194,550,1219,0.451,133,336,0.396,417,883,0.472,358,438,0.817,190,363,553,517,141,31,265,274,1591
543,3,2002,24,1,1,57,56,2343,420,1007,0.417,68,210,0.324,352,797,0.442,326,422,0.773,102,299,401,362,71,25,221,172,1234
543,4,2003,25,1,1,81,81,3318,571,1312,0.435,85,240,0.354,486,1072,0.453,476,595,0.8,159,340,499,502,141,41,299,251,1703
543,5,2004,26,1,1,79,79,3194,450,1117,0.403,73,250,0.292,377,867,0.435,337,435,0.775,116,317,433,493,139,35,294,257,1310
543,6,2005,27,1,1,78,78,2978,563,1330,0.423,38,127,0.299,525,1203,0.436,499,606,0.823,126,324,450,547,112,28,317,273,1663
543,7,2006,28,1,2,24,15,659,84,190,0.442,7,13,0.538,77,177,0.435,83,109,0.761,14,57,71,83,23,6,58,62,258
543,7,2006,28,1,1,46,45,1734,249,575,0.433,18,70,0.257,231,505,0.457,231,290,0.797,60,159,219,262,51,11,156,142,747
543,7,2006,28,1,1,70,60,2393,333,765,0.435,25,83,0.301,308,682,0.452,314,399,0.787,74,216,290,345,74,17,214,204,1005
543,8,2007,29,1,2,44,30,1237,140,343,0.408,42,111,0.378,98,232,0.422,175,211,0.829,33,124,157,170,41,12,100,126,497
543,9,2008,30,1,1,10,3,199,19,57,0.333,4,17,0.235,15,40,0.375,13,23,0.565,8,15,23,30,9,5,14,25,55
548,1,1980,26,1,2,68,-1,2585,737,1556,0.474,9,25,0.36,728,1531,0.476,572,760,0.753,129,109,238,283,81,32,228,195,2055
548,2,1981,27,1,2,65,-1,2370,516,1157,0.446,5,31,0.161,511,1126,0.454,528,649,0.814,48,111,159,361,85,11,195,183,1565
548,3,1982,28,1,2,78,78,2796,650,1452,0.448,10,56,0.179,640,1396,0.458,479,647,0.74,118,130,248,419,71,8,208,222,1789
548,4,1983,29,1,2,19,18,700,164,364,0.451,0,3,0,164,361,0.454,106,149,0.711,22,22,44,89,15,3,50,66,434
548,4,1983,29,1,2,54,51,1938,485,1059,0.458,15,42,0.357,470,1017,0.462,324,434,0.747,70,87,157,201,82,12,159,175,1309
548,4,1983,29,1,2,73,69,2638,649,1423,0.456,15,45,0.333,634,1378,0.46,430,583,0.738,92,109,201,290,97,15,209,241,1743
548,5,1984,30,1,2,75,71,2375,626,1407,0.445,22,69,0.319,604,1338,0.451,395,504,0.784,89,128,217,226,94,8,154,214,1669
548,6,1985,31,1,2,71,50,2249,609,1328,0.459,71,193,0.368,538,1135,0.474,308,411,0.749,61,150,211,320,75,16,139,163,1597
548,7,1986,32,1,2,75,75,2535,652,1433,0.455,71,169,0.42,581,1264,0.46,379,486,0.78,72,146,218,314,91,19,172,186,1754
548,8,1987,33,1,2,20,2,285,39,123,0.317,2,9,0.222,37,114,0.325,36,47,0.766,5,14,19,30,5,4,18,26,116
548,9,1988,34,1,2,58,0,682,143,350,0.409,8,35,0.229,135,315,0.429,80,100,0.8,14,30,44,60,20,3,49,74,374
560,1,1997,22,1,5,75,18,949,114,266,0.429,0,0,-1,114,266,0.429,76,110,0.691,108,141,249,24,10,20,52,146,304
560,2,1998,23,1,5,57,1,613,86,205,0.42,0,4,0,86,201,0.428,55,80,0.688,61,135,196,10,6,16,37,89,227
560,3,1999,24,1,5,42,2,462,56,124,0.452,0,0,-1,56,124,0.452,30,50,0.6,28,73,101,6,6,14,27,60,142
560,4,2000,25,1,5,41,2,399,51,122,0.418,0,0,-1,51,122,0.418,32,53,0.604,36,74,110,5,9,8,27,46,134
561,1,1981,22,1,2,15,-1,248,24,66,0.364,0,1,0,24,65,0.369,12,16,0.75,13,29,42,28,10,1,23,25,60
564,1,1980,25,1,2,21,-1,404,66,161,0.41,1,9,0.111,65,152,0.428,44,51,0.863,23,19,42,72,19,9,34,19,177
564,1,1980,25,1,2,55,-1,1718,364,765,0.476,23,73,0.315,341,692,0.493,127,145,0.876,47,105,152,221,54,14,129,79,878
564,1,1980,25,1,2,76,-1,2122,430,926,0.464,24,82,0.293,406,844,0.481,171,196,0.872,70,124,194,293,73,23,163,98,1055
566,1,1983,22,1,2,76,32,2081,470,1008,0.466,5,25,0.2,465,983,0.473,206,282,0.73,87,173,260,280,72,10,205,248,1151
566,2,1984,23,1,2,82,42,2449,583,1229,0.474,4,32,0.125,579,1197,0.484,321,396,0.811,61,174,235,254,109,11,220,218,1491
566,3,1985,24,1,2,79,0,2101,525,1111,0.473,7,30,0.233,518,1081,0.479,205,251,0.817,57,151,208,191,71,5,154,192,1262
566,4,1986,25,1,2,35,0,723,203,470,0.432,0,8,0,203,462,0.439,163,198,0.823,20,48,68,67,22,5,67,86,569
566,5,1987,26,1,2,49,5,924,200,491,0.407,1,10,0.1,199,481,0.414,119,155,0.768,34,49,83,79,43,8,71,113,520
566,6,1988,27,1,2,67,7,1282,328,755,0.434,2,12,0.167,326,743,0.439,243,313,0.776,62,92,154,109,69,4,123,128,901
566,7,1989,28,1,2,69,51,1722,448,964,0.465,1,9,0.111,447,955,0.468,217,286,0.759,69,135,204,154,90,6,122,152,1114
566,8,1990,29,1,2,30,2,491,97,240,0.404,1,5,0.2,96,235,0.409,52,66,0.788,18,33,51,34,12,0,34,63,247
566,9,1991,30,1,2,30,0,299,73,155,0.471,0,1,0,73,154,0.474,38,62,0.613,11,21,32,16,7,1,19,25,184
568,1,1997,21,1,5,72,21,1052,131,336,0.39,1,1,1,130,335,0.388,107,168,0.637,96,198,294,43,19,73,84,153,370
568,2,1998,22,1,5,82,82,2656,352,791,0.445,0,2,0,352,789,0.446,267,399,0.669,272,443,715,94,39,139,175,281,971
568,3,1999,23,1,5,50,50,1414,161,414,0.389,0,0,-1,161,414,0.389,120,204,0.588,164,218,382,54,26,58,92,165,442
568,4,2000,24,1,5,21,12,495,70,173,0.405,0,0,-1,70,173,0.405,27,51,0.529,48,86,134,19,8,15,29,75,167
568,5,2001,25,1,5,43,26,1038,126,314,0.401,0,2,0,126,312,0.404,67,126,0.532,97,153,250,59,17,58,82,123,319
568,6,2002,26,1,5,73,46,1740,209,480,0.435,0,0,-1,209,480,0.435,136,211,0.645,167,220,387,87,17,167,156,235,554
568,7,2003,27,1,5,82,82,1978,259,522,0.496,0,2,0,259,520,0.498,155,222,0.698,248,295,543,58,27,154,112,242,673
568,8,2004,28,1,5,74,74,2403,348,650,0.535,0,2,0,348,648,0.537,217,332,0.654,344,543,887,60,33,137,131,227,913
568,9,2005,29,1,5,59,56,1609,202,367,0.55,0,3,0,202,364,0.555,138,228,0.605,183,318,501,51,15,80,102,205,542
568,10,2006,30,1,5,82,36,1934,171,347,0.493,0,0,-1,171,347,0.493,127,215,0.591,273,367,640,51,27,106,115,263,469
568,11,2007,31,1,5,76,73,1915,209,334,0.626,0,0,-1,209,334,0.626,119,191,0.623,217,349,566,44,24,82,107,239,537
568,12,2008,32,1,5,72,64,1755,178,277,0.643,0,0,-1,178,277,0.643,84,146,0.575,207,332,539,63,24,106,80,226,440
568,13,2009,33,1,5,80,80,1836,182,280,0.65,0,0,-1,182,280,0.65,90,141,0.638,216,349,565,77,24,95,74,191,454
568,14,2010,34,1,5,55,47,1280,133,213,0.624,1,3,0.333,132,210,0.629,61,101,0.604,128,272,400,31,15,77,61,153,328
568,15,2011,35,1,5,51,22,815,52,89,0.584,0,1,0,52,88,0.591,24,44,0.545,53,124,177,22,14,47,32,82,128
569,1,1980,32,1,3,45,-1,1457,329,729,0.451,2,11,0.182,327,718,0.455,123,152,0.809,63,183,246,178,29,36,123,112,783
569,2,1981,33,1,3,23,-1,545,101,237,0.426,0,1,0,101,236,0.428,28,39,0.718,19,64,83,60,16,9,33,54,230
569,3,1982,34,1,3,11,0,174,21,55,0.382,0,0,-1,21,55,0.382,10,17,0.588,4,13,17,13,5,2,11,25,52
572,1,1996,25,1,2,19,18,542,83,184,0.451,34,78,0.436,49,106,0.462,55,72,0.764,12,34,46,47,15,3,37,49,255
572,2,1997,26,1,2,13,9,438,73,174,0.42,22,60,0.367,51,114,0.447,48,57,0.842,8,26,34,25,15,1,22,37,216
572,2,1997,26,1,2,43,33,1351,175,396,0.442,63,176,0.358,112,220,0.509,73,94,0.777,21,81,102,77,39,8,94,123,486
572,2,1997,26,1,2,56,42,1789,248,570,0.435,85,236,0.36,163,334,0.488,121,151,0.801,29,107,136,102,54,9,116,160,702
573,1,1980,23,1,3,68,-1,2674,730,1267,0.576,0,2,0,730,1265,0.577,443,526,0.842,183,333,516,191,96,14,233,211,1903
573,2,1981,24,1,3,80,-1,3417,909,1627,0.559,2,7,0.286,907,1620,0.56,632,784,0.806,192,317,509,322,109,18,282,245,2452
573,3,1982,25,1,3,81,81,3222,904,1586,0.57,1,3,0.333,903,1583,0.57,648,818,0.792,231,283,514,324,95,14,299,252,2457
573,4,1983,26,1,3,22,22,887,233,402,0.58,0,0,-1,233,402,0.58,210,248,0.847,58,82,140,105,20,0,81,62,676
573,5,1984,27,1,3,79,79,2984,802,1438,0.558,1,4,0.25,801,1434,0.559,813,946,0.859,179,269,448,310,61,4,263,201,2418
573,6,1985,28,1,3,55,46,1971,512,964,0.531,0,0,-1,512,964,0.531,438,545,0.804,148,175,323,186,57,8,171,133,1462
573,7,1986,29,1,3,76,75,2744,818,1453,0.563,1,11,0.091,817,1442,0.567,630,796,0.791,178,217,395,264,64,4,231,206,2267
573,8,1987,30,1,3,81,81,2736,601,1126,0.534,1,6,0.167,600,1120,0.536,539,664,0.812,104,228,332,162,63,7,181,193,1742
573,9,1988,31,1,3,69,50,2144,444,863,0.514,0,2,0,444,861,0.516,492,572,0.86,84,143,227,171,39,10,135,144,1380
573,10,1989,32,1,3,31,25,1081,212,459,0.462,0,1,0,212,458,0.463,204,263,0.776,64,89,153,78,20,7,82,87,628
573,10,1989,32,1,3,42,42,1341,258,495,0.521,0,0,-1,258,495,0.521,256,305,0.839,53,111,164,93,23,6,81,99,772
573,10,1989,32,1,3,73,67,2422,470,954,0.493,0,1,0,470,953,0.493,460,568,0.81,117,200,317,171,43,13,163,186,1400
573,11,1990,33,1,3,45,45,1300,231,484,0.477,0,2,0,231,482,0.479,200,254,0.787,78,94,172,80,20,7,75,99,662
573,12,1991,34,1,3,10,0,126,19,50,0.38,1,3,0.333,18,47,0.383,18,26,0.692,8,5,13,9,5,0,6,8,57
577,1,1996,23,1,5,58,23,626,63,144,0.438,0,0,-1,63,144,0.438,38,62,0.613,56,125,181,0,8,40,72,117,164
577,2,1997,24,1,5,41,2,313,19,54,0.352,0,0,-1,19,54,0.352,19,37,0.514,35,47,82,3,4,28,21,51,57
582,1,1987,21,1,5,80,80,2695,487,905,0.538,0,0,-1,487,905,0.538,279,401,0.696,152,495,647,304,49,63,248,248,1253
582,2,1988,22,1,5,79,78,2957,551,1081,0.51,0,2,0,551,1079,0.511,378,528,0.716,151,514,665,333,48,56,267,235,1480
582,3,1989,23,1,5,78,78,2821,544,1012,0.538,1,3,0.333,543,1009,0.538,386,524,0.737,167,551,718,285,63,40,230,175,1475
582,4,1990,24,1,5,41,40,1438,244,509,0.479,0,2,0,244,507,0.481,202,287,0.704,77,296,373,130,29,22,110,108,690
582,5,1991,25,1,5,76,76,2946,605,1155,0.524,0,3,0,605,1152,0.525,435,579,0.751,177,653,830,253,74,46,211,191,1645
582,6,1992,26,1,5,73,73,2643,576,1010,0.57,0,2,0,576,1008,0.571,414,533,0.777,191,569,760,262,65,78,185,190,1566
582,7,1993,27,1,5,71,71,2691,520,911,0.571,1,2,0.5,519,909,0.571,391,492,0.795,164,562,726,312,53,56,150,174,1432
582,8,1994,28,1,5,50,50,1838,296,606,0.488,0,0,-1,296,606,0.488,256,326,0.785,128,380,508,149,41,36,110,145,848
583,1,2008,23,1,3,38,2,322,51,125,0.408,0,0,-1,51,125,0.408,18,28,0.643,21,41,62,13,7,15,17,46,120
583,2,2009,24,1,3,14,0,111,17,35,0.486,0,0,-1,17,35,0.486,8,17,0.471,10,24,34,1,2,3,5,12,42
585,1,1999,27,1,3,50,6,902,109,243,0.449,0,1,0,109,242,0.45,90,111,0.811,70,103,173,40,23,17,48,88,308
585,2,2000,28,1,3,26,5,443,63,148,0.426,0,3,0,63,145,0.434,42,52,0.808,22,51,73,16,13,2,31,49,168
585,2,2000,28,1,3,32,5,474,67,157,0.427,0,3,0,67,154,0.435,45,56,0.804,26,55,81,17,17,3,33,56,179
585,3,2001,29,1,3,17,0,140,15,29,0.517,0,0,-1,15,29,0.517,12,13,0.923,9,24,33,4,2,3,7,20,42
585,3,2001,29,1,3,27,0,209,25,51,0.49,0,0,-1,25,51,0.49,12,13,0.923,15,37,52,7,6,4,11,28,62
587,1,1994,25,1,4,81,4,1732,216,425,0.508,0,1,0,216,424,0.509,194,302,0.642,190,315,505,55,45,84,107,189,626
587,2,1995,26,1,4,44,1,1030,109,245,0.445,0,0,-1,109,245,0.445,117,174,0.672,105,175,280,25,19,29,64,134,335
587,3,1996,27,1,4,82,14,2092,236,482,0.49,1,2,0.5,235,480,0.49,246,345,0.713,188,313,501,43,33,66,87,248,719
587,4,1997,28,1,4,82,28,2335,308,641,0.48,1,14,0.071,307,627,0.49,241,362,0.666,190,408,598,65,42,84,141,260,858
587,5,1998,29,1,4,82,12,2191,254,528,0.481,0,3,0,254,525,0.484,277,398,0.696,192,368,560,61,45,72,103,234,785
587,6,1999,30,1,4,49,1,1271,164,348,0.471,0,0,-1,164,348,0.471,135,192,0.703,116,228,344,33,22,42,50,136,463
587,7,2000,31,1,5,79,78,2479,313,712,0.44,0,0,-1,313,712,0.44,284,371,0.765,235,461,696,105,38,100,121,267,910
587,8,2001,32,1,5,78,77,2729,375,866,0.433,0,1,0,375,865,0.434,319,423,0.754,274,513,787,106,22,151,135,230,1069
587,9,2002,33,1,4,77,77,2978,410,963,0.426,0,1,0,410,962,0.426,293,358,0.818,254,486,740,155,54,83,159,225,1113
587,10,2003,34,1,5,53,52,1894,261,641,0.407,0,0,-1,261,641,0.407,216,280,0.771,130,307,437,131,23,62,118,150,738
587,11,2004,35,1,5,15,15,538,46,120,0.383,0,0,-1,46,120,0.383,37,49,0.755,49,94,143,14,8,8,21,45,129
587,11,2004,35,1,5,65,64,2032,220,540,0.407,0,0,-1,220,540,0.407,139,181,0.768,158,370,528,123,29,57,93,161,579
587,11,2004,35,1,5,80,79,2570,266,660,0.403,0,0,-1,266,660,0.403,176,230,0.765,207,464,671,137,37,65,114,206,708
587,12,2005,36,1,4,72,62,1843,193,419,0.461,0,0,-1,193,419,0.461,115,152,0.757,152,276,428,80,27,41,96,147,501
587,13,2006,37,1,5,8,8,191,14,31,0.452,0,0,-1,14,31,0.452,7,20,0.35,15,21,36,7,3,1,8,26,35
587,13,2006,37,1,4,36,31,749,68,159,0.428,0,1,0,68,158,0.43,45,61,0.738,75,97,172,14,20,9,43,99,181
587,13,2006,37,1,4,44,39,940,82,190,0.432,0,1,0,82,189,0.434,52,81,0.642,90,118,208,21,23,10,51,125,216
589,1,2000,20,1,1,82,0,1523,182,433,0.42,25,111,0.225,157,322,0.488,97,153,0.634,48,117,165,309,97,19,140,201,486
589,2,2001,21,1,1,82,82,3192,409,957,0.427,85,274,0.31,324,683,0.474,228,337,0.677,129,279,408,598,170,36,226,267,1131
589,3,2002,22,1,1,82,82,3318,559,1341,0.417,170,478,0.356,389,863,0.451,196,338,0.58,93,256,349,698,172,47,246,241,1484
589,4,2003,23,1,1,50,47,1889,332,798,0.416,99,283,0.35,233,515,0.452,93,131,0.71,56,130,186,320,91,22,140,148,856
589,5,2004,24,1,1,67,66,2686,554,1402,0.395,187,582,0.321,367,820,0.448,237,352,0.673,66,221,287,501,158,27,215,178,1532
589,6,2005,25,1,1,18,13,593,111,303,0.366,44,137,0.321,67,166,0.404,74,96,0.771,16,51,67,129,31,4,38,52,340
589,6,2005,25,1,1,28,19,988,180,449,0.401,74,217,0.341,106,232,0.457,111,147,0.755,16,92,108,233,50,10,93,74,545
589,6,2005,25,1,1,46,32,1581,291,752,0.387,118,354,0.333,173,398,0.435,185,243,0.761,32,143,175,362,81,14,131,126,885
589,7,2006,26,1,1,54,48,1971,335,861,0.389,102,324,0.315,233,537,0.434,195,289,0.675,45,191,236,480,89,14,159,165,967
589,8,2007,27,1,1,63,62,2221,452,1030,0.439,85,280,0.304,367,750,0.489,275,369,0.745,51,225,276,509,135,29,193,181,1264
589,9,2008,28,1,1,82,82,3196,650,1526,0.426,173,525,0.33,477,1001,0.477,318,424,0.75,96,289,385,623,191,43,232,247,1791
589,10,2009,29,1,1,65,60,2248,355,959,0.37,99,328,0.302,256,631,0.406,159,210,0.757,46,192,238,501,108,35,193,193,968
589,11,2010,30,1,1,75,73,2523,412,1015,0.406,82,296,0.277,330,719,0.459,239,291,0.821,52,214,266,598,126,43,211,210,1145
589,12,2011,31,1,1,15,9,380,75,178,0.421,36,87,0.414,39,91,0.429,22,27,0.815,6,30,36,92,16,6,39,29,208
589,12,2011,31,1,1,43,35,1269,214,515,0.416,45,152,0.296,169,363,0.466,79,104,0.76,29,91,120,299,62,22,107,114,552
589,12,2011,31,1,1,58,44,1649,289,693,0.417,81,239,0.339,208,454,0.458,101,131,0.771,35,121,156,391,78,28,146,143,760
589,13,2012,32,1,1,29,14,595,68,184,0.37,26,85,0.306,42,99,0.424,16,24,0.667,13,43,56,135,34,3,76,61,178
592,1,1980,24,1,1,13,-1,225,33,56,0.589,0,1,0,33,55,0.6,10,12,0.833,4,11,15,45,10,1,11,21,76
592,1,1980,24,1,1,18,-1,268,35,63,0.556,0,1,0,35,62,0.565,13,16,0.813,4,13,17,50,13,1,14,28,83
592,2,1981,25,1,1,56,-1,1686,230,410,0.561,3,17,0.176,227,393,0.578,163,204,0.799,29,122,151,385,52,11,123,156,626
592,3,1982,26,1,1,82,82,2614,397,771,0.515,14,49,0.286,383,722,0.53,185,230,0.804,35,191,226,509,73,6,159,218,993
592,4,1983,27,1,1,79,78,2323,359,628,0.572,11,43,0.256,348,585,0.595,186,220,0.845,34,164,198,565,80,11,143,176,915
592,5,1984,28,1,1,81,81,2665,345,651,0.53,7,38,0.184,338,613,0.551,199,238,0.836,41,146,187,561,94,13,166,218,896
592,6,1985,29,1,1,82,82,2539,310,614,0.505,47,115,0.409,263,499,0.527,158,178,0.888,39,154,193,581,91,10,123,219,825
592,7,1986,30,1,1,82,43,1971,267,502,0.532,32,89,0.36,235,413,0.569,198,228,0.868,26,120,146,467,57,15,110,174,764
592,8,1987,31,1,1,82,6,1582,199,436,0.456,32,106,0.302,167,330,0.506,147,171,0.86,27,87,114,373,63,10,114,159,577
592,9,1988,32,1,1,75,12,1480,208,415,0.501,30,74,0.405,178,341,0.522,91,108,0.843,18,84,102,303,51,18,91,149,537
592,10,1989,33,1,1,78,4,1395,183,379,0.483,32,102,0.314,151,277,0.545,99,123,0.805,14,94,108,242,48,18,92,151,497
592,11,1990,34,1,1,73,2,1292,179,365,0.49,35,104,0.337,144,261,0.552,77,100,0.77,12,81,93,242,47,9,86,151,470
592,12,1991,35,1,1,80,6,1426,159,373,0.426,22,85,0.259,137,288,0.476,91,118,0.771,13,105,118,230,45,17,77,212,431
592,13,1992,36,1,1,33,0,429,38,86,0.442,5,18,0.278,33,68,0.485,11,15,0.733,4,29,33,66,11,3,27,57,92
593,1,1994,23,1,3,68,3,374,40,126,0.317,1,3,0.333,39,123,0.317,50,68,0.735,21,34,55,22,16,4,19,34,131
595,1,1992,22,1,4,64,23,1301,154,279,0.552,0,1,0,154,278,0.554,87,152,0.572,158,252,410,30,27,74,49,191,395
595,2,1993,23,1,4,82,82,2264,304,535,0.568,0,0,-1,304,535,0.568,119,225,0.529,291,432,723,69,63,148,79,274,727
595,3,1994,24,1,4,66,64,2292,308,582,0.529,0,1,0,308,581,0.53,155,294,0.527,280,438,718,100,48,106,102,214,771
595,4,1995,25,1,4,74,70,2346,324,576,0.563,0,1,0,324,575,0.563,138,259,0.533,259,437,696,58,72,116,124,222,786
595,5,1996,26,1,4,78,77,2617,334,599,0.558,0,0,-1,334,599,0.558,135,289,0.467,252,457,709,76,56,112,119,238,803
595,6,1997,27,1,4,80,76,2589,370,688,0.538,0,0,-1,370,688,0.538,92,215,0.428,301,471,772,59,60,77,108,233,832
595,7,1998,28,1,5,78,78,2174,273,498,0.548,0,0,-1,273,498,0.548,80,172,0.465,233,378,611,70,51,87,73,209,626
595,8,1999,29,1,4,50,50,1374,161,302,0.533,0,0,-1,161,302,0.533,76,123,0.618,155,261,416,22,20,57,43,115,398
595,9,2000,30,1,5,74,72,2127,302,602,0.502,0,0,-1,302,602,0.502,139,203,0.685,256,473,729,64,52,94,91,203,743
595,10,2001,31,1,5,81,43,2162,242,487,0.497,0,4,0,242,483,0.501,96,152,0.632,233,373,606,103,44,76,67,199,580
595,11,2002,32,1,5,78,77,2447,296,580,0.51,0,0,-1,296,580,0.51,150,212,0.708,262,426,688,96,62,83,62,193,742
595,12,2003,33,1,5,78,78,2282,237,438,0.541,0,0,-1,237,438,0.541,105,166,0.633,233,331,564,94,51,70,71,189,579
595,13,2004,34,1,5,76,37,1682,133,281,0.473,0,0,-1,133,281,0.473,65,106,0.613,158,240,398,72,43,62,40,154,331
595,14,2005,35,1,5,36,3,577,45,109,0.413,0,0,-1,45,109,0.413,22,38,0.579,61,92,153,23,13,32,20,79,112
595,14,2005,35,1,5,25,25,730,67,125,0.536,0,0,-1,67,125,0.536,38,61,0.623,91,131,222,24,19,33,23,83,172
595,14,2005,35,1,5,61,28,1307,112,234,0.479,0,0,-1,112,234,0.479,60,99,0.606,152,223,375,47,32,65,43,162,284
595,15,2006,36,1,5,28,2,178,9,24,0.375,0,1,0,9,23,0.391,8,15,0.533,21,32,53,6,0,9,4,23,26
595,16,2007,37,1,5,46,6,464,33,74,0.446,0,0,-1,33,74,0.446,17,26,0.654,59,78,137,12,10,34,15,59,83
598,1,1996,22,1,3,57,0,571,55,149,0.369,4,13,0.308,51,136,0.375,74,116,0.638,56,69,125,47,40,22,68,92,188
598,2,1997,23,1,3,75,17,1705,251,535,0.469,24,93,0.258,227,442,0.514,113,168,0.673,138,185,323,135,85,31,118,230,639
598,3,1998,24,1,3,71,12,906,109,244,0.447,0,6,0,109,238,0.458,64,101,0.634,64,94,158,73,49,18,91,95,282
598,4,2000,26,1,3,23,7,464,56,137,0.409,0,2,0,56,135,0.415,31,47,0.66,31,53,84,38,25,4,40,52,143
599,1,1993,22,1,2,50,2,815,110,251,0.438,6,19,0.316,104,232,0.448,43,54,0.796,13,43,56,83,22,4,45,71,269
599,2,1994,23,1,2,56,27,1333,238,505,0.471,53,132,0.402,185,373,0.496,85,103,0.825,23,44,67,165,40,4,76,118,614
599,3,1995,24,1,2,82,4,1697,296,617,0.48,131,288,0.455,165,329,0.502,97,120,0.808,30,80,110,150,35,11,87,146,820
599,4,1996,25,1,2,74,14,1773,275,566,0.486,127,267,0.476,148,299,0.495,112,129,0.868,35,88,123,103,31,8,63,120,789
599,5,1997,26,1,2,36,0,623,74,184,0.402,16,70,0.229,58,114,0.509,17,23,0.739,11,29,40,34,11,2,21,40,181
599,6,1998,27,1,2,81,30,2378,350,767,0.456,101,230,0.439,249,537,0.464,97,116,0.836,34,135,169,157,43,5,88,117,898
599,7,1999,28,1,2,50,21,1378,174,397,0.438,65,144,0.451,109,253,0.431,44,50,0.88,3,83,86,89,21,3,57,76,457
599,8,2000,29,1,1,79,15,1817,217,464,0.468,82,167,0.491,135,297,0.455,67,77,0.87,17,117,134,141,24,3,70,109,583
599,9,2001,30,1,1,15,11,431,57,119,0.479,20,38,0.526,37,81,0.457,19,21,0.905,10,20,30,49,6,0,25,29,153
599,9,2001,30,1,1,51,7,1261,139,314,0.443,58,133,0.436,81,181,0.448,35,41,0.854,18,91,109,61,29,1,56,92,371
599,9,2001,30,1,1,66,18,1692,196,433,0.453,78,171,0.456,118,262,0.45,54,62,0.871,28,111,139,110,35,1,81,121,524
599,10,2002,31,1,2,51,17,1231,146,326,0.448,57,126,0.452,89,200,0.445,16,21,0.762,7,70,77,107,28,3,44,58,365
599,11,2003,32,1,2,43,1,328,31,79,0.392,12,36,0.333,19,43,0.442,5,6,0.833,6,30,36,29,5,0,11,23,79
601,1,1989,25,1,3,31,0,251,48,97,0.495,1,9,0.111,47,88,0.534,26,32,0.813,15,21,36,14,13,5,12,38,123
601,1,1989,25,1,3,33,0,258,49,102,0.48,1,10,0.1,48,92,0.522,28,34,0.824,16,21,37,14,13,5,12,39,127
603,1,1980,24,1,1,82,-1,2912,496,1159,0.428,4,42,0.095,492,1117,0.44,304,352,0.864,102,124,226,440,110,23,202,178,1300
603,2,1981,25,1,1,76,-1,2536,426,917,0.465,4,33,0.121,422,884,0.477,238,299,0.796,56,114,170,480,95,14,167,179,1094
603,3,1982,26,1,2,82,70,2664,538,1153,0.467,5,27,0.185,533,1126,0.473,315,394,0.799,72,106,178,346,76,11,186,176,1396
603,4,1983,27,1,2,53,33,1465,258,567,0.455,5,18,0.278,253,549,0.461,164,206,0.796,37,91,128,315,43,7,114,100,685
603,5,1984,28,1,1,75,72,2079,354,800,0.443,0,8,0,354,792,0.447,217,256,0.848,53,86,139,326,62,6,134,146,925
603,6,1985,29,1,1,76,30,1920,337,791,0.426,12,46,0.261,325,745,0.436,255,300,0.85,35,84,119,426,43,4,152,136,941
603,7,1986,30,1,2,27,7,402,46,107,0.43,1,2,0.5,45,105,0.429,51,59,0.864,2,17,19,112,13,0,38,32,144
603,7,1986,30,1,2,39,0,612,102,237,0.43,2,11,0.182,100,226,0.442,67,79,0.848,6,30,36,105,24,4,40,44,273
603,7,1986,30,1,2,66,7,1014,148,344,0.43,3,13,0.231,145,331,0.438,118,138,0.855,8,47,55,217,37,4,78,76,417
609,1,2007,22,1,5,31,0,180,22,52,0.423,0,0,-1,22,52,0.423,7,10,0.7,21,23,44,7,6,5,8,28,51
609,2,2008,23,1,4,22,1,194,24,65,0.369,0,0,-1,24,65,0.369,6,10,0.6,25,22,47,10,6,6,9,33,54
609,3,2009,24,1,4,27,1,320,40,98,0.408,0,1,0,40,97,0.412,27,34,0.794,28,39,67,12,10,3,13,44,107
612,1,1999,19,1,2,46,1,557,81,200,0.405,2,12,0.167,79,188,0.42,45,59,0.763,40,44,84,58,30,7,54,46,209
612,2,2000,20,1,2,48,4,570,94,187,0.503,0,4,0,94,183,0.514,39,51,0.765,29,54,83,62,30,8,46,39,227
612,3,2002,22,1,3,82,8,1954,376,781,0.481,11,35,0.314,365,746,0.489,196,248,0.79,63,180,243,178,69,23,148,145,959
612,4,2003,23,1,2,79,76,3131,602,1470,0.41,74,204,0.363,528,1266,0.417,348,465,0.748,97,293,390,436,125,36,277,180,1626
612,5,2004,24,1,2,22,22,796,134,311,0.431,17,48,0.354,117,263,0.445,51,75,0.68,18,103,121,111,25,8,68,51,336
612,5,2004,24,1,3,57,5,1678,312,639,0.488,35,92,0.38,277,547,0.506,145,198,0.732,59,178,237,148,71,14,121,120,804
612,5,2004,24,1,3,79,27,2474,446,950,0.469,52,140,0.371,394,810,0.486,196,273,0.718,77,281,358,259,96,22,189,171,1140
612,6,2005,25,1,2,82,11,2696,481,1041,0.462,61,180,0.339,420,861,0.488,286,351,0.815,66,183,249,246,89,27,205,174,1309
612,7,2006,26,1,3,36,36,1460,255,595,0.429,33,117,0.282,222,478,0.464,146,181,0.807,25,139,164,173,42,8,98,99,689
612,7,2006,26,1,2,42,42,1747,329,709,0.464,40,125,0.32,289,584,0.495,129,164,0.787,40,147,187,221,49,9,115,91,827
612,7,2006,26,1,2,78,78,3207,584,1304,0.448,73,242,0.302,511,1062,0.481,275,345,0.797,65,286,351,394,91,17,213,190,1516
612,8,2007,27,1,3,81,81,3021,506,1089,0.465,123,310,0.397,383,779,0.492,239,285,0.839,54,261,315,385,80,23,210,189,1374
612,9,2008,28,1,3,82,47,2963,420,971,0.433,135,333,0.405,285,638,0.447,155,197,0.787,55,298,353,276,87,14,191,187,1130
612,10,2009,29,1,2,36,9,785,83,245,0.339,35,111,0.315,48,134,0.358,31,36,0.861,9,51,60,82,19,5,39,63,232
612,11,2010,30,1,3,36,2,499,62,143,0.434,16,42,0.381,46,101,0.455,18,31,0.581,10,47,57,39,11,3,29,39,158
614,1,1980,25,1,3,75,-1,2309,657,1166,0.563,0,4,0,657,1162,0.565,299,365,0.819,75,197,272,337,114,19,242,202,1613
614,2,1981,26,1,2,78,-1,2182,593,1101,0.539,7,17,0.412,586,1084,0.541,209,250,0.836,63,137,200,302,97,12,222,192,1402
614,3,1982,27,1,3,55,12,1182,350,669,0.523,3,16,0.188,347,653,0.531,91,111,0.82,21,82,103,162,46,3,112,104,794
614,4,1983,28,1,2,80,79,2491,665,1289,0.516,7,23,0.304,658,1266,0.52,184,225,0.818,63,134,197,397,117,12,188,186,1521
614,5,1984,29,1,2,78,70,2546,652,1274,0.512,20,87,0.23,632,1187,0.532,233,270,0.863,38,164,202,429,107,12,213,202,1557
614,6,1985,30,1,2,23,9,570,139,309,0.45,3,10,0.3,136,299,0.455,64,73,0.877,6,29,35,98,18,0,50,42,345
614,7,1986,31,1,2,70,62,2239,624,1287,0.485,18,76,0.237,606,1211,0.5,257,305,0.843,54,149,203,361,99,3,219,153,1523
614,8,1987,32,1,2,79,79,2646,779,1515,0.514,21,81,0.259,758,1434,0.529,288,334,0.862,90,154,244,364,96,5,226,184,1867
614,9,1988,33,1,3,68,48,1951,488,1031,0.473,36,96,0.375,452,935,0.483,205,231,0.887,32,127,159,278,86,3,126,131,1217
614,10,1989,34,1,2,81,0,1857,536,1076,0.498,20,69,0.29,516,1007,0.512,175,199,0.879,41,110,151,190,72,5,132,187,1267
614,11,1990,35,1,2,69,0,1635,497,1033,0.481,6,46,0.13,491,987,0.497,207,227,0.912,46,133,179,155,59,9,102,160,1207
614,12,1991,36,1,2,32,1,439,87,195,0.446,1,3,0.333,86,192,0.448,21,23,0.913,19,39,58,41,18,0,25,42,196
614,12,1991,36,1,2,39,13,1044,316,667,0.474,10,33,0.303,306,634,0.483,86,94,0.915,52,71,123,84,62,3,63,108,728
614,12,1991,36,1,2,71,14,1483,403,862,0.468,11,36,0.306,392,826,0.475,107,117,0.915,71,110,181,125,80,3,88,150,924
614,13,1992,37,1,3,46,0,741,185,403,0.459,5,16,0.313,180,387,0.465,82,94,0.872,20,50,70,68,29,1,45,69,457
615,1,1980,22,1,3,57,-1,776,141,300,0.47,1,5,0.2,140,295,0.475,33,48,0.688,42,83,125,77,33,9,76,112,316
619,1,1980,23,1,5,80,-1,2541,494,946,0.522,0,6,0,494,940,0.526,190,291,0.653,197,496,693,149,49,142,230,328,1178
619,2,1981,24,1,5,76,-1,2088,423,697,0.607,0,0,-1,423,697,0.607,219,304,0.72,106,439,545,109,38,112,220,316,1065
619,3,1982,25,1,5,48,36,1124,207,367,0.564,0,2,0,207,365,0.567,114,164,0.695,68,237,305,55,19,55,96,193,528
619,4,1983,26,1,5,81,81,2093,401,669,0.599,0,0,-1,401,669,0.599,166,257,0.646,127,293,420,114,67,152,281,379,968
619,5,1984,27,1,5,81,80,2417,507,855,0.593,2,5,0.4,505,850,0.594,341,464,0.735,159,382,541,123,60,136,231,386,1357
619,6,1985,28,1,5,39,30,972,192,339,0.566,0,1,0,192,338,0.568,143,201,0.711,55,126,181,45,14,35,93,171,527
619,7,1986,29,1,5,51,3,1207,284,441,0.644,0,1,0,284,440,0.645,210,297,0.707,85,166,251,77,16,59,124,227,778
619,8,1987,30,1,5,6,2,106,20,32,0.625,0,0,-1,20,32,0.625,17,24,0.708,9,10,19,2,2,3,15,25,57
620,1,1987,23,1,1,81,14,1682,334,764,0.437,14,47,0.298,320,717,0.446,153,191,0.801,56,113,169,290,67,3,120,118,835
620,2,1988,24,1,1,65,61,2179,405,835,0.485,19,61,0.311,386,774,0.499,198,221,0.896,66,138,204,480,88,2,154,95,1027
620,3,1989,25,1,1,32,30,1083,177,400,0.443,0,4,0,177,396,0.447,100,112,0.893,32,69,101,224,55,0,111,64,454
620,4,1990,26,1,1,81,81,2865,465,950,0.489,22,66,0.333,443,884,0.501,210,244,0.861,48,199,247,601,121,9,214,159,1162
620,5,1991,27,1,1,4,4,124,26,41,0.634,1,4,0.25,25,37,0.676,10,11,0.909,0,16,16,28,3,0,8,4,63
620,6,1992,28,1,1,82,82,2815,394,902,0.437,36,101,0.356,358,801,0.447,164,186,0.882,42,185,227,567,89,5,183,158,988
620,7,1993,29,1,1,74,10,1598,258,590,0.437,26,84,0.31,232,506,0.458,113,142,0.796,33,103,136,339,80,4,121,91,655
620,8,1994,30,1,1,72,12,1343,177,423,0.418,37,105,0.352,140,318,0.44,84,100,0.84,28,95,123,263,63,5,111,74,475
620,9,1995,31,1,1,50,9,1170,125,270,0.463,25,73,0.342,100,197,0.508,50,55,0.909,28,85,113,205,52,1,86,74,325
621,1,1984,23,1,3,75,0,1174,180,408,0.441,0,6,0,180,402,0.448,95,133,0.714,90,98,188,176,38,12,96,154,455
621,2,1985,24,1,3,80,8,1573,258,504,0.512,1,7,0.143,257,497,0.517,178,249,0.715,93,179,272,240,53,19,134,164,695
621,3,1986,25,1,3,64,4,1075,198,399,0.496,1,3,0.333,197,396,0.497,159,237,0.671,71,112,183,109,46,11,98,121,556
621,4,1987,26,1,3,61,2,724,101,202,0.5,0,0,-1,101,202,0.5,34,65,0.523,37,87,124,75,25,7,56,98,236
621,4,1987,26,1,3,62,2,731,101,202,0.5,0,0,-1,101,202,0.5,34,65,0.523,37,88,125,76,25,7,57,100,236
621,5,1988,27,1,3,47,8,655,112,217,0.516,0,1,0,112,216,0.519,59,87,0.678,30,46,76,71,29,4,44,68,283
627,1,1996,22,1,5,22,1,203,24,50,0.48,0,1,0,24,49,0.49,11,19,0.579,18,21,39,9,7,5,4,30,59
627,2,1997,23,1,5,71,1,1065,142,273,0.52,0,0,-1,142,273,0.52,91,151,0.603,122,176,298,32,33,27,76,229,375
627,3,1998,24,1,5,81,49,1523,169,340,0.497,0,1,0,169,339,0.499,101,168,0.601,180,212,392,59,85,49,84,277,439
627,4,1999,25,1,5,14,1,258,28,57,0.491,0,0,-1,28,57,0.491,19,29,0.655,33,30,63,10,13,9,22,51,75
627,4,1999,25,1,5,33,31,844,110,219,0.502,0,0,-1,110,219,0.502,76,112,0.679,71,121,192,21,37,20,32,110,296
627,4,1999,25,1,5,47,32,1102,138,276,0.5,0,0,-1,138,276,0.5,95,141,0.674,104,151,255,31,50,29,54,161,371
627,5,2000,26,1,5,82,31,1831,225,443,0.508,0,0,-1,225,443,0.508,94,160,0.588,156,283,439,58,63,66,108,275,544
627,6,2001,27,1,5,67,51,903,107,193,0.554,0,0,-1,107,193,0.554,47,82,0.573,91,145,236,32,41,33,51,198,261
627,7,2002,28,1,5,61,14,633,67,149,0.45,0,0,-1,67,149,0.45,28,50,0.56,74,89,163,22,23,24,34,130,162
627,8,2003,29,1,5,77,21,1327,149,279,0.534,0,0,-1,149,279,0.534,67,104,0.644,142,197,339,52,39,36,84,258,365
627,9,2004,30,1,5,71,53,1211,93,195,0.477,0,0,-1,93,195,0.477,44,54,0.815,131,186,317,44,47,32,54,217,230
628,1,1994,22,1,1,64,6,759,129,342,0.377,23,57,0.404,106,285,0.372,61,81,0.753,25,43,68,78,28,3,61,69,342
628,2,1995,23,1,1,80,28,1774,279,685,0.407,48,163,0.294,231,522,0.443,229,292,0.784,35,117,152,225,45,7,157,200,835
628,3,1996,24,1,1,82,10,2018,315,686,0.459,139,316,0.44,176,370,0.476,247,327,0.755,41,102,143,350,54,16,191,239,1016
628,4,1997,25,1,1,73,3,1053,148,383,0.386,52,160,0.325,96,223,0.43,122,148,0.824,15,80,95,158,27,3,96,142,470
628,5,1998,26,1,1,77,18,1410,180,451,0.399,50,132,0.379,130,319,0.408,79,99,0.798,21,85,106,196,52,4,96,150,489
628,6,1999,27,1,2,22,0,271,27,74,0.365,15,34,0.441,12,40,0.3,5,7,0.714,5,17,22,26,5,3,14,28,74
628,6,1999,27,1,2,26,0,291,31,85,0.365,16,39,0.41,15,46,0.326,5,7,0.714,7,17,24,27,7,3,16,30,83
630,1,1992,22,1,4,48,2,905,171,324,0.528,0,0,-1,171,324,0.528,95,142,0.669,115,157,272,33,41,53,86,139,437
630,2,1993,23,1,4,21,0,240,40,78,0.513,0,1,0,40,77,0.519,16,20,0.8,24,32,56,5,14,17,25,48,96
630,3,1994,24,1,5,80,1,1507,251,464,0.541,0,3,0,251,461,0.544,137,211,0.649,138,308,446,50,49,87,104,221,639
630,4,1995,25,1,5,63,10,1261,196,333,0.589,0,0,-1,196,333,0.589,106,162,0.654,98,200,298,53,38,43,114,210,498
630,5,1996,26,1,5,65,65,2157,416,766,0.543,1,6,0.167,415,760,0.546,196,267,0.734,149,343,492,122,70,55,190,226,1029
630,6,1997,27,1,5,9,0,138,26,63,0.413,0,0,-1,26,63,0.413,11,15,0.733,14,19,33,12,3,5,11,20,63
630,7,1998,28,1,5,78,78,2619,531,1040,0.511,1,3,0.333,530,1037,0.511,198,280,0.707,223,472,695,94,67,55,181,252,1261
630,8,1999,29,1,5,49,48,1177,216,431,0.501,0,1,0,216,430,0.502,81,118,0.686,92,180,272,71,38,40,111,181,513
632,1,1982,23,1,4,30,3,607,62,121,0.512,0,0,-1,62,121,0.512,26,40,0.65,47,86,133,42,35,8,35,81,150
632,2,1983,24,1,4,22,0,224,11,34,0.324,0,0,-1,11,34,0.324,6,9,0.667,20,32,52,6,16,1,5,27,28
632,3,1984,25,1,4,43,0,413,36,99,0.364,3,10,0.3,33,89,0.371,15,24,0.625,37,64,101,45,23,8,29,83,90
633,1,1980,22,1,4,82,-1,1872,230,528,0.436,0,0,-1,230,528,0.436,110,183,0.601,195,288,483,64,56,30,168,306,570
633,2,1981,23,1,4,76,-1,964,128,254,0.504,0,2,0,128,252,0.508,58,92,0.63,114,129,243,28,12,13,58,153,314
633,3,1982,24,1,4,48,0,356,39,83,0.47,0,1,0,39,82,0.476,14,39,0.359,29,50,79,14,4,6,26,65,92
637,1,1997,23,1,1,61,1,867,119,256,0.465,52,112,0.464,67,144,0.465,42,51,0.824,31,68,99,99,36,6,68,71,332
637,2,1998,24,1,1,74,9,1647,311,794,0.392,41,156,0.263,270,638,0.423,110,149,0.738,38,132,170,169,73,12,105,88,773
637,2,1998,24,1,1,77,9,1681,314,798,0.393,42,157,0.268,272,641,0.424,111,151,0.735,38,134,172,172,73,12,109,96,781
637,3,1999,25,1,1,36,13,630,92,253,0.364,16,66,0.242,76,187,0.406,46,71,0.648,11,43,54,95,16,6,45,47,246
637,4,2000,26,1,1,46,1,682,120,279,0.43,9,40,0.225,111,239,0.464,47,59,0.797,36,52,88,55,35,5,32,58,296
637,5,2001,27,1,2,82,11,2288,383,923,0.415,54,168,0.321,329,755,0.436,185,235,0.787,76,185,261,160,75,17,101,171,1005
637,6,2002,28,1,2,22,16,570,60,172,0.349,20,67,0.299,40,105,0.381,22,30,0.733,20,59,79,51,22,6,19,38,162
637,6,2002,28,1,2,41,1,877,166,416,0.399,47,147,0.32,119,269,0.442,56,67,0.836,38,86,124,81,31,4,40,60,435
637,6,2002,28,1,2,63,17,1447,226,588,0.384,67,214,0.313,159,374,0.425,78,97,0.804,58,145,203,132,53,10,59,98,597
637,7,2003,29,1,1,67,39,1873,233,560,0.416,120,304,0.395,113,256,0.441,68,87,0.782,41,191,232,146,72,10,69,124,654
637,8,2004,30,1,2,33,11,509,70,184,0.38,20,66,0.303,50,118,0.424,37,44,0.841,16,43,59,28,27,7,17,46,197
637,9,2005,31,1,2,56,1,1340,246,591,0.416,72,202,0.356,174,389,0.447,103,136,0.757,28,102,130,104,47,3,54,123,667
637,10,2006,32,1,1,23,0,378,71,160,0.444,20,47,0.426,51,113,0.451,18,25,0.72,13,38,51,33,13,1,19,28,180
637,10,2006,32,1,1,24,0,385,71,161,0.441,20,47,0.426,51,114,0.447,20,27,0.741,14,39,53,33,13,1,19,28,182
646,1,2003,24,1,1,50,0,515,70,170,0.412,22,61,0.361,48,109,0.44,21,26,0.808,9,34,43,85,14,2,53,66,183
646,2,2004,25,1,1,23,0,143,21,49,0.429,3,10,0.3,18,39,0.462,4,6,0.667,4,12,16,18,9,0,13,22,49
646,2,2004,25,1,1,20,0,151,16,49,0.327,7,20,0.35,9,29,0.31,7,8,0.875,3,7,10,20,8,0,13,22,46
646,2,2004,25,1,1,43,0,294,37,98,0.378,10,30,0.333,27,68,0.397,11,14,0.786,7,19,26,38,17,0,26,44,95
646,3,2005,26,1,1,67,46,2074,305,748,0.408,84,242,0.347,221,506,0.437,188,225,0.836,34,145,179,346,76,4,144,200,882
646,3,2005,26,1,1,71,46,2090,306,756,0.405,85,245,0.347,221,511,0.432,190,228,0.833,34,146,180,347,76,4,145,201,887
646,4,2006,27,1,1,19,0,234,17,46,0.37,10,20,0.5,7,26,0.269,18,18,1,5,11,16,40,11,1,18,40,62
646,5,2007,28,1,1,50,3,444,54,151,0.358,16,61,0.262,38,90,0.422,42,53,0.792,7,36,43,70,14,1,27,55,166
646,6,2008,29,1,1,67,8,1040,124,296,0.419,36,108,0.333,88,188,0.468,68,82,0.829,13,84,97,172,32,3,55,108,352
648,1,1999,23,1,2,50,50,1558,215,462,0.465,71,164,0.433,144,298,0.483,46,72,0.639,26,57,83,95,27,11,66,90,547
648,2,2000,24,1,2,82,82,3103,554,1270,0.436,119,291,0.409,435,979,0.444,269,324,0.83,78,201,279,208,116,45,165,226,1496
648,3,2001,25,1,2,70,69,2618,425,1020,0.417,86,230,0.374,339,790,0.429,206,270,0.763,70,159,229,233,62,27,162,207,1142
648,4,2002,26,1,2,4,4,124,15,48,0.313,8,21,0.381,7,27,0.259,5,6,0.833,3,9,12,9,3,1,8,12,43
649,1,2007,24,1,2,64,19,1177,100,292,0.342,49,170,0.288,51,122,0.418,35,53,0.66,27,83,110,55,30,7,37,132,284
649,2,2008,25,1,2,54,14,542,55,134,0.41,21,66,0.318,34,68,0.5,22,31,0.71,23,39,62,37,8,3,16,61,153
649,3,2009,26,1,3,63,21,851,76,217,0.35,51,163,0.313,25,54,0.463,10,19,0.526,26,56,82,27,13,6,16,75,213
657,1,1982,23,1,1,33,0,221,29,79,0.367,0,4,0,29,75,0.387,15,23,0.652,6,9,15,34,8,2,17,40,73
658,1,2006,23,1,1,23,0,246,29,69,0.42,25,57,0.439,4,12,0.333,5,6,0.833,4,17,21,16,7,0,10,22,88
658,2,2007,24,1,1,26,0,288,34,80,0.425,18,50,0.36,16,30,0.533,12,15,0.8,3,15,18,35,4,0,13,27,98
658,3,2008,25,1,1,66,21,1356,159,430,0.37,74,233,0.318,85,197,0.431,64,71,0.901,26,89,115,251,35,4,55,107,456
658,4,2009,26,1,1,55,0,719,74,179,0.413,46,118,0.39,28,61,0.459,12,15,0.8,6,80,86,122,26,5,21,42,206
659,1,1980,31,1,5,79,-1,1830,227,500,0.454,1,9,0.111,226,491,0.46,90,118,0.763,101,262,363,216,89,51,112,230,545
659,2,1981,32,1,5,82,-1,1243,146,320,0.456,2,6,0.333,144,314,0.459,77,111,0.694,79,186,265,118,48,53,88,176,371
659,3,1982,33,1,5,74,0,999,92,200,0.46,0,1,0,92,199,0.462,38,54,0.704,63,125,188,87,49,30,44,131,222
662,1,1990,22,1,1,33,0,362,44,109,0.404,1,9,0.111,43,100,0.43,26,30,0.867,13,27,40,75,19,2,37,30,115
662,2,1991,23,1,1,10,0,144,13,33,0.394,0,0,-1,13,33,0.394,8,9,0.889,0,11,11,19,2,0,13,12,34
662,2,1991,23,1,1,12,0,149,14,34,0.412,0,0,-1,14,34,0.412,8,9,0.889,0,12,12,19,2,0,13,15,36
666,1,2003,24,1,1,42,3,647,104,271,0.384,25,84,0.298,79,187,0.422,37,46,0.804,13,59,72,40,26,3,42,54,270
666,2,2004,25,1,2,71,16,1478,247,637,0.388,59,198,0.298,188,439,0.428,111,139,0.799,30,118,148,137,82,4,104,111,664
666,3,2005,26,1,2,63,4,1054,186,447,0.416,48,147,0.327,138,300,0.46,87,97,0.897,32,87,119,111,43,4,68,98,507
666,4,2006,27,1,2,76,42,1920,357,821,0.435,65,170,0.382,292,651,0.449,156,194,0.804,30,147,177,149,58,6,113,157,935
666,5,2007,28,1,2,26,5,683,110,259,0.425,27,83,0.325,83,176,0.472,41,44,0.932,11,62,73,41,27,2,24,65,288
666,5,2007,28,1,2,55,1,1243,189,444,0.426,52,143,0.364,137,301,0.455,60,72,0.833,16,69,85,82,49,7,77,112,490
666,5,2007,28,1,2,81,6,1926,299,703,0.425,79,226,0.35,220,477,0.461,101,116,0.871,27,131,158,123,76,9,101,177,778
666,6,2008,29,1,1,17,0,244,47,98,0.48,13,33,0.394,34,65,0.523,3,7,0.429,6,22,28,32,0,0,19,24,110
666,6,2008,29,1,1,36,0,424,59,160,0.369,17,39,0.436,42,121,0.347,18,19,0.947,9,38,47,65,21,2,35,38,153
666,6,2008,29,1,1,53,0,668,106,258,0.411,30,72,0.417,76,186,0.409,21,26,0.808,15,60,75,97,21,2,54,62,263
666,7,2009,30,1,1,50,6,816,101,256,0.395,25,75,0.333,76,181,0.42,34,39,0.872,8,59,67,118,35,6,70,74,261
668,1,1990,21,1,5,82,5,1611,274,549,0.499,0,5,0,274,544,0.504,153,216,0.708,167,345,512,75,79,114,110,240,701
668,2,1991,22,1,5,82,81,2310,360,637,0.565,5,14,0.357,355,623,0.57,196,279,0.703,205,461,666,92,106,127,146,247,921
668,3,1992,23,1,5,36,18,979,157,317,0.495,5,19,0.263,152,298,0.51,86,112,0.768,87,160,247,60,55,35,88,114,405
668,4,1993,24,1,5,82,69,2525,397,819,0.485,21,75,0.28,376,744,0.505,235,341,0.689,220,509,729,232,128,140,214,311,1050
668,5,1994,25,1,5,79,73,2685,453,895,0.506,9,47,0.191,444,848,0.524,208,303,0.686,282,569,851,307,92,112,191,288,1123
668,6,1995,26,1,5,80,80,2807,485,957,0.507,10,53,0.189,475,904,0.525,297,382,0.777,261,568,829,329,109,174,205,305,1277
668,7,1996,27,1,5,79,79,2470,414,807,0.513,3,18,0.167,411,789,0.521,189,295,0.641,198,481,679,261,76,131,199,274,1020
668,8,1997,28,1,5,81,80,2840,418,847,0.494,11,47,0.234,407,800,0.509,177,259,0.683,241,484,725,301,103,180,193,277,1024
668,9,1998,29,1,5,64,41,1805,267,536,0.498,3,14,0.214,264,522,0.506,130,188,0.691,183,335,518,172,83,94,114,179,667
668,10,1999,30,1,5,50,50,1761,262,557,0.47,11,43,0.256,251,514,0.488,179,255,0.702,140,361,501,215,44,51,131,166,714
668,11,2000,31,1,5,82,81,2374,384,764,0.503,7,26,0.269,377,738,0.511,230,333,0.691,174,482,656,244,103,103,190,251,1005
668,12,2001,32,1,5,81,81,2420,364,755,0.482,4,14,0.286,360,741,0.486,242,350,0.691,207,466,673,231,87,93,192,242,974
668,13,2002,33,1,5,80,80,2420,338,716,0.472,3,13,0.231,335,703,0.477,209,340,0.615,205,466,671,297,79,94,158,229,888
668,14,2003,34,1,5,80,80,2384,305,655,0.466,6,25,0.24,299,630,0.475,179,251,0.713,157,417,574,274,83,105,152,239,795
668,15,2004,35,1,5,81,81,2317,314,668,0.47,2,13,0.154,312,655,0.476,170,260,0.654,136,327,463,432,57,77,173,222,800
668,16,2005,36,1,5,15,0,130,13,31,0.419,0,0,-1,13,31,0.419,8,12,0.667,18,14,32,19,4,1,14,25,34
670,1,1999,21,1,5,49,0,780,125,267,0.468,0,0,-1,125,267,0.468,54,80,0.675,66,82,148,20,19,17,26,117,304
670,2,2000,22,1,5,81,29,1335,242,535,0.452,1,2,0.5,241,533,0.452,80,95,0.842,89,245,334,63,29,34,65,224,565
670,3,2001,23,1,5,77,21,1398,220,527,0.417,0,3,0,220,524,0.42,50,59,0.847,70,203,273,65,37,41,59,239,490
670,4,2002,24,1,5,42,15,705,78,187,0.417,0,0,-1,78,187,0.417,38,46,0.826,47,121,168,25,15,11,37,98,194
670,5,2003,25,1,5,75,0,1041,146,343,0.426,0,0,-1,146,343,0.426,36,46,0.783,65,154,219,42,16,16,49,150,328
670,6,2004,26,1,5,26,0,344,40,97,0.412,0,0,-1,40,97,0.412,14,16,0.875,28,48,76,14,6,6,11,58,94
670,6,2004,26,1,5,46,0,685,100,225,0.444,0,0,-1,100,225,0.444,31,36,0.861,60,129,189,30,17,30,37,84,231
670,6,2004,26,1,5,72,0,1029,140,322,0.435,0,0,-1,140,322,0.435,45,52,0.865,88,177,265,44,23,36,48,142,325
670,7,2005,27,1,5,80,8,1175,148,331,0.447,0,2,0,148,329,0.45,25,41,0.61,74,185,259,47,23,22,36,160,321
670,8,2006,28,1,5,31,3,371,37,88,0.42,0,0,-1,37,88,0.42,24,30,0.8,23,62,85,8,10,7,14,45,98
670,9,2007,29,1,5,56,0,698,82,175,0.469,0,1,0,82,174,0.471,36,41,0.878,44,111,155,22,18,15,30,96,200
670,10,2008,30,1,5,24,8,257,28,63,0.444,0,0,-1,28,63,0.444,1,2,0.5,16,33,49,7,10,10,12,44,57
674,1,1988,22,1,1,44,0,364,44,109,0.404,0,7,0,44,102,0.431,17,21,0.81,5,20,25,87,16,1,42,33,105
678,1,2007,22,1,1,42,0,359,48,126,0.381,12,50,0.24,36,76,0.474,11,15,0.733,11,26,37,15,15,4,15,21,119
678,2,2008,23,1,1,74,0,876,132,335,0.394,42,122,0.344,90,213,0.423,48,52,0.923,17,66,83,53,30,12,59,80,354
678,3,2009,24,1,1,20,0,227,30,88,0.341,10,37,0.27,20,51,0.392,14,15,0.933,3,22,25,13,2,5,6,23,84
678,3,2009,24,1,1,27,0,300,42,110,0.382,14,46,0.304,28,64,0.438,17,19,0.895,6,26,32,25,5,5,13,27,115
680,1,1990,23,1,1,81,66,2470,463,938,0.494,5,31,0.161,458,907,0.505,224,326,0.687,70,136,206,619,145,10,246,187,1155
680,2,1991,24,1,1,73,73,2562,532,1055,0.504,4,31,0.129,528,1024,0.516,284,414,0.686,78,131,209,624,121,5,270,178,1352
680,3,1992,25,1,1,37,0,654,101,222,0.455,1,9,0.111,100,213,0.469,68,100,0.68,12,45,57,153,21,9,60,68,271
680,3,1992,25,1,1,42,2,752,117,253,0.462,1,10,0.1,116,243,0.477,73,107,0.682,13,50,63,172,25,9,68,78,308
680,4,1993,26,1,1,79,36,1932,264,530,0.498,6,29,0.207,258,501,0.515,84,150,0.56,65,97,162,508,49,10,161,166,618
680,5,1994,27,1,1,78,78,2789,425,919,0.462,13,56,0.232,412,863,0.477,177,276,0.641,70,123,193,683,89,11,233,171,1040
680,6,1995,28,1,1,65,43,2048,365,769,0.475,20,82,0.244,345,687,0.502,204,296,0.689,48,122,170,446,80,2,162,152,954
680,7,1996,29,1,1,10,4,234,36,84,0.429,1,7,0.143,35,77,0.455,25,40,0.625,6,17,23,39,2,0,29,16,98
680,7,1996,29,1,1,69,62,2101,309,601,0.514,39,103,0.379,270,498,0.542,135,179,0.754,49,108,157,397,61,5,165,147,792
680,7,1996,29,1,1,79,66,2335,345,685,0.504,40,110,0.364,305,575,0.53,160,219,0.731,55,125,180,436,63,5,194,163,890
680,8,1997,30,1,1,79,79,2316,306,610,0.502,38,114,0.333,268,496,0.54,114,171,0.667,57,136,193,427,78,10,153,191,764
680,9,1998,31,1,1,80,11,1699,255,515,0.495,14,46,0.304,241,469,0.514,115,172,0.669,52,83,135,319,55,7,110,156,639
680,10,1999,32,1,1,30,19,842,96,219,0.438,0,11,0,96,208,0.462,55,87,0.632,16,42,58,124,27,3,61,54,247
680,11,2000,33,1,1,20,2,309,45,90,0.5,5,16,0.313,40,74,0.541,25,28,0.893,13,16,29,34,17,0,24,26,120
680,12,2001,34,1,1,59,7,1094,122,303,0.403,8,40,0.2,114,263,0.433,86,115,0.748,21,53,74,144,36,4,79,93,338
682,1,2011,26,1,1,24,0,292,51,125,0.408,3,10,0.3,48,115,0.417,16,17,0.941,5,15,20,51,20,2,29,30,121
683,1,1982,25,1,2,64,9,1031,181,389,0.465,18,59,0.305,163,330,0.494,67,102,0.657,27,63,90,146,48,9,92,147,447
684,1,1980,25,1,5,70,-1,1782,221,455,0.486,0,1,0,221,454,0.487,125,185,0.676,171,330,501,121,30,62,127,249,567
684,2,1981,26,1,5,79,-1,1356,185,323,0.573,0,3,0,185,320,0.578,102,186,0.548,150,234,384,69,25,38,90,251,472
684,3,1982,27,1,5,63,17,1093,70,140,0.5,0,0,-1,70,140,0.5,32,80,0.4,111,179,290,35,15,38,55,210,172
689,1,1999,24,1,1,34,0,441,47,129,0.364,16,49,0.327,31,80,0.388,8,8,1,3,29,32,52,12,4,31,61,118
689,2,2000,25,1,1,72,5,1293,158,413,0.383,59,163,0.362,99,250,0.396,45,53,0.849,23,80,103,162,41,1,66,79,420
689,3,2001,26,1,1,48,41,1305,124,327,0.379,40,105,0.381,84,222,0.378,14,19,0.737,12,57,69,185,32,3,68,99,302
689,4,2002,27,1,1,61,0,774,78,182,0.429,31,73,0.425,47,109,0.431,23,29,0.793,14,58,72,101,32,2,33,49,210
690,1,1980,25,1,3,80,-1,2306,535,1182,0.453,0,7,0,535,1175,0.455,489,646,0.757,203,268,471,101,91,23,240,313,1559
690,2,1981,26,1,3,67,-1,2075,500,1096,0.456,0,7,0,500,1089,0.459,454,577,0.787,145,238,383,79,98,15,194,264,1454
690,3,1982,27,1,3,70,51,2040,465,957,0.486,4,12,0.333,461,945,0.488,364,491,0.741,169,206,375,96,64,3,178,250,1298
690,4,1983,28,1,3,44,33,1206,318,671,0.474,0,5,0,318,666,0.477,296,392,0.755,98,137,235,97,35,7,135,152,932
690,5,1984,29,1,3,81,4,1797,511,1067,0.479,6,22,0.273,505,1045,0.483,402,517,0.778,146,192,338,135,88,2,192,208,1430
690,6,1985,30,1,3,19,16,463,107,260,0.412,0,4,0,107,256,0.418,94,122,0.77,36,46,82,35,22,2,42,65,308
692,1,1997,23,1,2,15,0,132,13,43,0.302,0,9,0,13,34,0.382,10,14,0.714,12,10,22,6,3,2,6,10,36
693,1,2002,26,1,5,64,12,1174,191,414,0.461,0,2,0,191,412,0.464,55,73,0.753,75,144,219,51,20,31,51,109,437
693,2,2003,27,1,5,82,69,1984,325,789,0.412,30,85,0.353,295,704,0.419,91,115,0.791,111,209,320,86,48,38,65,180,771
693,3,2004,28,1,5,61,14,949,149,379,0.393,11,36,0.306,138,343,0.402,73,86,0.849,54,142,196,39,22,24,48,85,382
693,4,2005,29,1,5,71,1,1435,238,543,0.438,25,71,0.352,213,472,0.451,96,120,0.8,73,165,238,49,42,24,78,138,597
694,1,1984,21,1,2,82,3,1408,252,559,0.451,1,4,0.25,251,555,0.452,123,169,0.728,112,123,235,153,107,29,123,209,628
694,2,1985,22,1,2,80,43,2555,573,1161,0.494,8,37,0.216,565,1124,0.503,223,294,0.759,217,259,476,441,177,68,223,265,1377
694,3,1986,23,1,2,75,58,2576,542,1142,0.475,12,60,0.2,530,1082,0.49,293,381,0.769,171,250,421,600,197,46,282,270,1389
694,4,1987,24,1,2,82,82,3114,707,1408,0.502,11,47,0.234,696,1361,0.511,357,470,0.76,227,291,518,566,204,71,253,281,1782
694,5,1988,25,1,2,81,80,3060,849,1679,0.506,11,52,0.212,838,1627,0.515,476,587,0.811,261,272,533,467,203,52,236,250,2185
694,6,1989,26,1,2,78,78,3064,829,1672,0.496,27,104,0.26,802,1568,0.511,438,548,0.799,289,326,615,450,213,54,250,269,2123
694,7,1990,27,1,2,73,73,2683,670,1357,0.494,30,106,0.283,640,1251,0.512,333,430,0.774,208,299,507,432,145,51,191,222,1703
694,8,1991,28,1,2,82,82,2852,645,1338,0.482,61,191,0.319,584,1147,0.509,416,524,0.794,212,334,546,493,144,60,232,226,1767
694,9,1992,29,1,2,76,76,2751,694,1476,0.47,114,338,0.337,580,1138,0.51,401,505,0.794,166,334,500,512,138,70,240,229,1903
694,10,1993,30,1,3,49,49,1671,350,816,0.429,31,133,0.233,319,683,0.467,245,292,0.839,126,183,309,278,95,37,115,159,976
694,11,1994,31,1,2,68,68,2334,473,1105,0.428,71,219,0.324,402,886,0.454,286,368,0.777,154,291,445,333,98,34,167,202,1303
694,12,1995,32,1,2,35,34,1300,266,526,0.506,60,168,0.357,206,358,0.575,157,194,0.809,68,178,246,154,62,23,89,89,749
694,12,1995,32,1,2,41,41,1428,305,712,0.428,87,240,0.363,218,472,0.462,207,248,0.835,84,150,234,208,74,22,97,117,904
694,12,1995,32,1,2,76,75,2728,571,1238,0.461,147,408,0.36,424,830,0.511,364,442,0.824,152,328,480,362,136,45,186,206,1653
694,13,1996,33,1,2,52,51,1997,331,764,0.433,78,235,0.332,253,529,0.478,265,338,0.784,97,276,373,302,105,24,134,153,1005
694,14,1997,34,1,2,62,62,2271,397,899,0.442,119,335,0.355,278,564,0.493,201,268,0.75,118,255,373,354,119,36,156,151,1114
694,15,1998,35,1,2,70,70,2473,452,1059,0.427,106,334,0.317,346,725,0.477,277,346,0.801,105,241,346,382,126,42,189,193,1287
698,1,1980,23,1,2,67,-1,1331,282,598,0.472,15,53,0.283,267,545,0.49,45,66,0.682,29,69,98,117,41,11,79,102,624
698,2,1981,24,1,2,32,0,114,30,73,0.411,6,10,0.6,24,63,0.381,13,14,0.929,2,3,5,6,5,0,10,8,79
698,2,1981,24,1,3,18,-1,337,74,161,0.46,2,6,0.333,72,155,0.465,18,27,0.667,15,24,39,30,12,4,25,19,168
698,2,1981,24,1,2,50,0,451,104,234,0.444,8,16,0.5,96,218,0.44,31,41,0.756,17,27,44,36,17,4,35,27,247
698,3,1982,25,1,2,21,0,146,34,77,0.442,0,1,0,34,76,0.447,4,12,0.333,6,9,15,12,3,1,2,9,72
699,1,1987,22,1,5,14,1,122,18,45,0.4,0,0,-1,18,45,0.4,9,14,0.643,13,18,31,6,5,3,4,27,45
699,1,1987,22,1,5,51,0,753,112,228,0.491,0,1,0,112,227,0.493,83,120,0.692,63,129,192,23,16,18,74,165,307
699,1,1987,22,1,5,65,1,875,130,273,0.476,0,1,0,130,272,0.478,92,134,0.687,76,147,223,29,21,21,78,192,352
699,2,1988,23,1,5,78,50,2223,450,907,0.496,0,0,-1,450,907,0.496,331,430,0.77,224,352,576,66,31,32,177,280,1231
699,3,1989,24,1,5,79,79,2662,554,1161,0.477,0,2,0,554,1159,0.478,324,428,0.757,246,389,635,60,56,49,200,300,1432
699,4,1990,25,1,5,82,82,2462,548,1146,0.478,0,0,-1,548,1146,0.478,231,312,0.74,184,325,509,91,36,34,171,271,1327
699,5,1991,26,1,5,81,81,2511,521,1084,0.481,0,2,0,521,1082,0.482,240,311,0.772,177,354,531,89,33,34,186,251,1282
699,6,1992,27,1,5,82,82,2222,362,786,0.461,0,3,0,362,783,0.462,156,226,0.69,151,346,497,99,38,37,143,264,880
699,7,1993,28,1,5,74,55,1762,301,688,0.438,0,2,0,301,686,0.439,127,174,0.73,118,269,387,70,45,39,87,222,729
699,8,1994,29,1,5,69,52,1485,184,441,0.417,0,0,-1,184,441,0.417,88,132,0.667,103,222,325,56,37,35,101,223,456
699,9,1995,30,1,5,40,22,818,118,267,0.442,2,10,0.2,116,257,0.451,45,70,0.643,65,130,195,20,21,24,59,110,283
699,10,1997,32,1,5,26,22,384,45,103,0.437,3,4,0.75,42,99,0.424,11,16,0.688,23,37,60,16,9,11,33,63,104
701,1,1988,22,1,5,55,1,513,65,137,0.474,0,0,-1,65,137,0.474,40,71,0.563,74,70,144,23,13,19,31,87,170
701,2,1989,23,1,5,61,2,544,73,168,0.435,0,1,0,73,167,0.437,39,107,0.364,72,85,157,21,9,23,44,82,185
701,3,1990,24,1,4,27,8,672,67,152,0.441,0,0,-1,67,152,0.441,32,105,0.305,86,134,220,19,22,31,36,81,166
701,3,1990,24,1,4,37,22,684,79,203,0.389,0,0,-1,79,203,0.389,26,77,0.338,88,115,203,20,19,41,48,83,184
701,3,1990,24,1,4,64,30,1356,146,355,0.411,0,0,-1,146,355,0.411,58,182,0.319,174,249,423,39,41,72,84,164,350
701,4,1991,25,1,5,61,25,1560,170,417,0.408,0,0,-1,170,417,0.408,94,176,0.534,229,282,511,37,39,153,80,217,434
701,5,1992,26,1,5,82,21,1902,190,472,0.403,0,0,-1,190,472,0.403,80,171,0.468,343,396,739,58,38,179,79,275,460
701,6,1993,27,1,5,71,16,1398,94,266,0.353,0,0,-1,94,266,0.353,57,110,0.518,215,298,513,16,17,103,54,195,245
701,7,1995,29,1,5,82,82,2245,181,446,0.406,0,1,0,181,445,0.407,85,183,0.464,325,439,764,34,43,126,81,286,447
701,8,1996,30,1,5,80,61,1924,162,358,0.453,0,1,0,162,357,0.454,80,157,0.51,239,481,720,37,41,100,79,251,404
701,9,1997,31,1,5,81,14,1840,126,293,0.43,0,0,-1,126,293,0.43,65,137,0.474,204,389,593,41,39,96,80,247,317
701,10,1998,32,1,5,51,22,858,58,143,0.406,0,0,-1,58,143,0.406,41,92,0.446,108,167,275,21,13,51,44,139,157
701,11,1999,33,1,5,46,16,685,48,109,0.44,0,0,-1,48,109,0.44,19,40,0.475,79,114,193,7,13,38,24,116,115
701,12,2000,34,1,5,47,3,459,23,67,0.343,0,0,-1,23,67,0.343,9,27,0.333,63,73,136,5,7,21,18,95,55
701,13,2001,35,1,5,53,33,613,29,73,0.397,0,0,-1,29,73,0.397,14,36,0.389,64,119,183,18,14,29,26,111,72
701,14,2002,36,1,5,43,2,327,20,50,0.4,0,2,0,20,48,0.417,8,15,0.533,27,53,80,13,3,14,14,42,48
702,1,2005,22,1,1,82,73,2177,172,488,0.352,94,265,0.355,78,223,0.35,49,67,0.731,23,190,213,398,82,3,119,205,487
702,2,2006,23,1,1,74,38,2155,215,538,0.4,100,278,0.36,115,260,0.442,117,143,0.818,28,192,220,373,70,3,117,152,647
702,3,2007,24,1,1,78,30,1906,197,483,0.408,88,245,0.359,109,238,0.458,76,101,0.752,23,146,169,310,69,6,105,150,558
702,4,2008,25,1,1,66,18,1490,133,344,0.387,54,155,0.348,79,189,0.418,65,80,0.813,19,97,116,263,48,2,71,92,385
702,5,2009,26,1,1,79,78,2906,287,681,0.421,127,325,0.391,160,356,0.449,179,209,0.856,45,201,246,566,72,7,221,126,880
702,6,2010,27,1,1,67,59,2072,168,451,0.373,90,258,0.349,78,193,0.404,68,95,0.716,28,150,178,378,59,3,110,83,494
702,7,2011,28,1,1,51,5,774,49,129,0.38,13,52,0.25,36,77,0.468,14,25,0.56,9,43,52,118,16,2,61,30,125
702,8,2012,29,1,1,63,9,1226,85,203,0.419,50,119,0.42,35,84,0.417,17,21,0.81,14,88,102,151,35,9,81,71,237
702,9,2013,30,1,1,46,9,820,47,123,0.382,33,91,0.363,14,32,0.438,6,13,0.462,11,57,68,133,20,1,40,56,133
704,1,1986,22,1,2,82,45,1957,287,597,0.481,5,16,0.313,282,581,0.485,190,238,0.798,60,59,119,390,66,11,158,200,769
704,2,1987,23,1,2,79,75,2439,369,749,0.493,9,22,0.409,360,727,0.495,184,246,0.748,50,117,167,352,83,5,171,194,931
704,3,1988,24,1,2,82,82,2732,453,960,0.472,4,19,0.211,449,941,0.477,251,308,0.815,63,137,200,387,87,15,172,155,1161
704,4,1989,25,1,2,69,67,2408,456,903,0.505,14,29,0.483,442,874,0.506,260,306,0.85,57,115,172,390,63,5,178,103,1186
704,5,1990,26,1,2,75,71,2578,508,1058,0.48,22,55,0.4,486,1003,0.485,297,330,0.9,60,152,212,368,63,2,145,129,1335
704,6,1991,27,1,2,80,80,3046,622,1292,0.481,14,45,0.311,608,1247,0.488,371,417,0.89,62,125,187,443,89,7,189,135,1629
704,7,1992,28,1,2,82,82,3192,587,1311,0.448,49,120,0.408,538,1191,0.452,412,475,0.867,82,106,188,375,71,12,193,145,1635
704,8,1993,29,1,2,77,77,3094,677,1454,0.466,112,299,0.375,565,1155,0.489,343,397,0.864,63,85,148,308,78,7,138,141,1809
704,9,1994,30,1,2,69,69,2591,505,1118,0.452,124,320,0.388,381,798,0.477,276,330,0.836,35,116,151,261,63,4,159,118,1410
704,10,1995,31,1,2,67,67,2544,417,970,0.43,103,338,0.305,314,632,0.497,277,344,0.805,47,111,158,368,72,7,219,153,1214
704,11,1996,32,1,1,67,40,2193,255,598,0.426,121,298,0.406,134,300,0.447,162,197,0.822,28,110,138,265,43,3,97,106,793
704,12,1997,33,1,2,79,79,2923,385,875,0.44,166,384,0.432,219,491,0.446,222,256,0.867,38,153,191,318,57,1,128,97,1158
704,13,1998,34,1,2,72,72,2326,329,791,0.416,158,426,0.371,171,365,0.468,127,154,0.825,14,90,104,253,44,2,84,99,943
704,14,1999,35,1,2,38,38,1116,144,350,0.411,89,221,0.403,55,129,0.426,51,61,0.836,12,56,68,134,23,2,53,51,428
708,1,1981,22,1,1,40,-1,458,33,101,0.327,0,1,0,33,100,0.33,5,9,0.556,8,27,35,54,18,2,37,54,71
708,2,1982,23,1,1,79,9,1056,121,268,0.451,3,11,0.273,118,257,0.459,27,37,0.73,14,70,84,157,20,4,72,143,272
708,3,1983,24,1,1,82,24,1433,163,360,0.453,0,13,0,163,347,0.47,43,54,0.796,38,69,107,200,66,5,96,203,369
710,1,1980,24,1,2,82,-1,1841,240,551,0.436,0,3,0,240,548,0.438,84,111,0.757,132,192,324,147,102,31,91,145,564
710,2,1981,25,1,2,82,-1,1427,146,354,0.412,0,2,0,146,352,0.415,79,121,0.653,133,168,301,81,66,29,56,141,371
710,3,1982,26,1,2,82,80,2519,258,504,0.512,0,1,0,258,503,0.513,153,215,0.712,211,348,559,188,135,36,123,210,669
710,4,1983,27,1,2,82,80,2640,254,527,0.482,0,1,0,254,526,0.483,119,163,0.73,231,384,615,189,147,25,113,218,627
710,5,1984,28,1,2,80,74,2705,174,370,0.47,0,1,0,174,369,0.472,106,145,0.731,195,379,574,228,173,32,97,233,454
710,6,1985,29,1,2,81,81,2290,175,358,0.489,0,2,0,175,356,0.492,84,116,0.724,169,216,385,153,140,14,65,213,434
710,7,1986,30,1,2,82,82,2401,172,379,0.454,0,1,0,172,378,0.455,68,88,0.773,143,234,377,171,155,16,51,228,412
710,8,1987,31,1,2,81,53,1932,118,276,0.428,0,2,0,118,274,0.431,36,55,0.655,91,174,265,147,100,21,33,160,272
710,9,1988,32,1,2,82,1,1534,70,156,0.449,0,1,0,70,155,0.452,40,52,0.769,110,130,240,87,101,11,26,152,180
710,10,1989,33,1,2,34,1,321,12,35,0.343,0,0,-1,12,35,0.343,9,12,0.75,30,30,60,25,12,1,6,35,33
710,11,1990,34,1,3,65,2,657,44,97,0.454,0,2,0,44,95,0.463,26,39,0.667,56,82,138,43,41,4,19,67,114
710,12,1991,35,1,2,17,3,217,21,47,0.447,1,4,0.25,20,43,0.465,9,10,0.9,20,22,42,24,12,1,7,30,52
711,1,1995,22,1,2,58,0,613,96,250,0.384,22,73,0.301,74,177,0.418,50,77,0.649,32,30,62,57,13,4,50,78,264
711,2,1996,23,1,2,67,12,1284,274,655,0.418,74,207,0.357,200,448,0.446,154,257,0.599,58,57,115,99,42,13,77,128,776
711,3,1997,24,1,2,18,0,227,27,77,0.351,3,24,0.125,24,53,0.453,15,23,0.652,3,11,14,22,10,1,15,36,72
711,3,1997,24,1,2,24,1,278,33,96,0.344,4,28,0.143,29,68,0.426,16,25,0.64,3,13,16,25,10,2,16,45,86
712,1,1985,24,1,3,59,8,756,114,274,0.416,0,3,0,114,271,0.421,72,102,0.706,49,75,124,80,19,10,77,106,300
715,1,2012,24,1,1,9,1,180,19,48,0.396,1,8,0.125,18,40,0.45,28,36,0.778,2,17,19,18,11,2,20,19,67
718,1,1982,22,1,3,32,0,103,17,37,0.459,2,4,0.5,15,33,0.455,7,9,0.778,3,9,12,15,2,0,7,19,43
720,1,1994,23,1,5,74,8,1149,151,372,0.406,0,1,0,151,371,0.407,108,160,0.675,85,162,247,12,24,53,72,178,410
720,2,1995,24,1,5,30,3,208,26,68,0.382,0,0,-1,26,68,0.382,14,29,0.483,19,26,45,2,6,8,14,39,66
720,3,1996,25,1,5,42,7,655,117,276,0.424,0,3,0,117,273,0.429,82,114,0.719,51,78,129,27,18,37,49,73,316
720,4,1997,26,1,5,38,0,457,59,157,0.376,0,5,0,59,152,0.388,44,70,0.629,33,52,85,18,12,27,33,54,162
720,4,1997,26,1,5,47,0,500,67,180,0.372,0,5,0,67,175,0.383,54,84,0.643,35,61,96,20,15,28,35,61,188
723,1,1983,26,1,5,81,32,1528,146,353,0.414,0,1,0,146,352,0.415,59,90,0.656,86,376,462,112,24,275,140,257,351
723,2,1984,27,1,5,82,78,2139,194,416,0.466,0,1,0,194,415,0.467,73,123,0.593,148,447,595,113,25,351,98,303,461
723,3,1985,28,1,5,82,82,2813,302,673,0.449,0,0,-1,302,673,0.449,190,267,0.712,207,720,927,124,36,456,206,312,794
723,4,1986,29,1,5,80,80,2551,277,589,0.47,0,0,-1,277,589,0.47,122,202,0.604,172,503,675,101,33,369,157,282,676
723,5,1987,30,1,5,79,79,2505,234,585,0.4,0,0,-1,234,585,0.4,140,213,0.657,211,486,697,105,43,321,142,273,608
723,6,1988,31,1,5,82,82,2731,226,541,0.418,0,0,-1,226,541,0.418,119,191,0.623,230,487,717,55,41,304,131,320,571
723,7,1989,32,1,5,82,82,2914,188,407,0.462,0,0,-1,188,407,0.462,132,200,0.66,227,616,843,83,40,315,142,290,508
723,8,1990,33,1,5,82,82,2281,158,300,0.527,0,0,-1,158,300,0.527,79,118,0.669,171,430,601,39,33,201,75,238,395
723,9,1991,34,1,5,80,80,2580,169,292,0.579,0,0,-1,169,292,0.579,71,112,0.634,182,485,667,51,39,188,99,298,409
723,10,1992,35,1,5,81,81,2023,107,240,0.446,0,0,-1,107,240,0.446,52,87,0.598,150,341,491,40,36,205,60,239,266
723,11,1993,36,1,5,64,57,1104,71,130,0.546,0,0,-1,71,130,0.546,35,50,0.7,73,191,264,17,18,79,43,143,177
730,1,1985,22,1,3,10,1,143,4,13,0.308,0,0,-1,4,13,0.308,3,8,0.375,8,18,26,10,5,4,3,39,11
732,1,1983,22,1,2,32,2,309,48,139,0.345,0,2,0,48,137,0.35,16,27,0.593,20,19,39,22,11,6,20,41,112
732,2,1984,23,1,2,15,0,101,23,47,0.489,0,0,-1,23,47,0.489,18,25,0.72,6,12,18,7,4,1,16,16,64
732,2,1984,23,1,2,40,0,521,135,274,0.493,0,0,-1,135,274,0.493,76,101,0.752,40,30,70,27,22,6,45,67,346
732,2,1984,23,1,2,55,0,622,158,321,0.492,0,0,-1,158,321,0.492,94,126,0.746,46,42,88,34,26,7,61,83,410
733,1,1994,23,1,4,16,0,107,17,49,0.347,0,1,0,17,48,0.354,9,16,0.563,7,11,18,8,2,5,6,9,43
733,2,1995,24,1,4,38,0,212,22,48,0.458,0,1,0,22,47,0.468,23,32,0.719,19,29,48,13,5,4,22,30,67
733,3,1996,25,1,4,31,0,519,32,91,0.352,0,4,0,32,87,0.368,29,38,0.763,35,52,87,39,10,18,29,51,93
734,1,1982,22,1,1,42,3,291,65,150,0.433,0,9,0,65,141,0.461,20,27,0.741,10,17,27,45,16,5,24,37,150
734,2,1983,23,1,1,81,3,1266,228,483,0.472,0,8,0,228,475,0.48,86,113,0.761,23,62,85,221,81,6,110,119,542
734,3,1984,24,1,1,60,0,654,84,221,0.38,0,1,0,84,220,0.382,34,48,0.708,12,47,59,90,31,5,46,78,202
734,4,1985,25,1,1,16,0,198,36,66,0.545,0,0,-1,36,66,0.545,19,24,0.792,3,11,14,38,17,0,17,10,91
734,5,1986,26,1,1,73,19,1491,262,577,0.454,1,9,0.111,261,568,0.46,132,151,0.874,24,62,86,259,89,4,137,87,657
734,6,1987,27,1,1,8,0,122,9,32,0.281,0,4,0,9,28,0.321,10,14,0.714,2,8,10,29,5,0,17,7,28
734,7,1988,28,1,1,16,11,414,54,115,0.47,0,2,0,54,113,0.478,24,32,0.75,4,15,19,92,10,1,47,10,132
736,1,1990,24,1,3,82,49,1889,286,564,0.507,9,30,0.3,277,534,0.519,146,203,0.719,69,182,251,145,76,36,152,280,727
736,2,1991,25,1,3,62,56,1611,244,464,0.526,6,24,0.25,238,440,0.541,82,117,0.701,51,150,201,108,57,29,105,203,576
736,3,1992,26,1,3,81,81,2283,433,830,0.522,39,103,0.379,394,727,0.542,113,146,0.774,86,212,298,137,81,46,122,236,1018
736,4,1993,27,1,3,82,81,2729,554,1083,0.512,37,106,0.349,517,977,0.529,237,300,0.79,123,259,382,214,129,45,175,242,1382
736,5,1994,28,1,3,82,64,2322,382,800,0.478,38,106,0.358,344,694,0.496,151,189,0.799,104,225,329,171,83,27,146,235,953
736,6,1995,29,1,3,31,7,507,83,195,0.426,11,43,0.256,72,152,0.474,43,48,0.896,25,40,65,47,19,10,39,64,220
736,6,1995,29,1,3,36,0,605,98,198,0.495,11,32,0.344,87,166,0.524,32,42,0.762,25,40,65,30,24,6,42,79,239
736,6,1995,29,1,3,67,7,1112,181,393,0.461,22,75,0.293,159,318,0.5,75,90,0.833,50,80,130,77,43,16,81,143,459
736,7,1996,30,1,3,82,82,2773,401,956,0.419,84,245,0.343,317,711,0.446,157,208,0.755,98,248,346,212,118,46,170,243,1043
736,8,1997,31,1,3,61,12,1439,182,458,0.397,25,89,0.281,157,369,0.425,89,109,0.817,49,140,189,114,38,20,81,135,478
736,9,1998,32,1,2,81,20,1968,326,742,0.439,40,120,0.333,286,622,0.46,180,215,0.837,61,156,217,201,86,27,134,183,872
736,10,1999,33,1,3,24,0,283,32,72,0.444,4,10,0.4,28,62,0.452,9,13,0.692,7,26,33,30,17,5,21,23,77
737,1,2005,25,1,5,10,0,110,10,31,0.323,0,0,-1,10,31,0.323,7,12,0.583,12,13,25,3,3,4,2,19,27
739,1,1980,24,1,5,82,-1,2314,528,1032,0.512,0,1,0,528,1031,0.512,231,339,0.681,179,399,578,127,55,104,131,324,1287
739,2,1981,25,1,5,81,-1,2375,511,1004,0.509,0,3,0,511,1001,0.51,244,347,0.703,191,380,571,212,32,128,164,304,1266
739,3,1982,26,1,5,77,75,2539,528,1033,0.511,0,4,0,528,1029,0.513,232,339,0.684,189,392,581,123,24,117,162,347,1288
739,4,1983,27,1,5,16,1,285,55,113,0.487,0,0,-1,55,113,0.487,31,47,0.66,19,40,59,27,5,5,19,49,141
739,4,1983,27,1,5,15,8,382,73,150,0.487,0,0,-1,73,150,0.487,38,61,0.623,37,59,96,13,7,14,30,61,184
739,4,1983,27,1,5,31,9,667,128,263,0.487,0,0,-1,128,263,0.487,69,108,0.639,56,99,155,40,12,19,49,110,325
739,5,1984,28,1,5,72,67,1897,438,817,0.536,0,1,0,438,816,0.537,183,254,0.72,108,240,348,184,23,30,140,254,1059
739,6,1985,29,1,5,70,58,1787,384,766,0.501,0,3,0,384,763,0.503,276,370,0.746,95,292,387,153,26,52,162,237,1044
739,7,1986,30,1,5,52,51,1314,318,587,0.542,0,0,-1,318,587,0.542,212,302,0.702,79,222,301,74,23,29,128,200,848
739,8,1987,31,1,5,14,9,304,57,110,0.518,0,0,-1,57,110,0.518,54,70,0.771,20,40,60,19,6,7,15,42,168
739,9,1988,32,1,5,26,2,328,48,101,0.475,0,0,-1,48,101,0.475,45,61,0.738,22,55,77,5,2,5,22,57,141
739,9,1988,32,1,5,43,42,1377,254,542,0.469,0,1,0,254,541,0.47,165,260,0.635,97,238,335,73,14,32,108,159,673
739,9,1988,32,1,5,69,44,1705,302,643,0.47,0,1,0,302,642,0.47,210,321,0.654,119,293,412,78,16,37,130,216,814
739,10,1989,33,1,5,76,1,1254,211,422,0.5,0,2,0,211,420,0.502,133,194,0.686,68,163,231,49,11,31,72,226,555
739,11,1990,34,1,5,82,70,2283,462,928,0.498,0,3,0,462,925,0.499,265,354,0.749,112,233,345,63,23,37,133,295,1189
739,12,1991,35,1,5,72,70,1903,383,792,0.484,1,2,0.5,382,790,0.484,215,295,0.729,91,186,277,65,12,30,126,249,982
739,13,1992,36,1,5,72,11,1437,250,538,0.465,0,1,0,250,537,0.466,198,271,0.731,55,147,202,53,24,33,72,236,698
739,14,1993,37,1,5,52,0,617,122,270,0.452,0,0,-1,122,270,0.452,84,118,0.712,30,70,100,41,10,7,51,122,328
739,15,1994,38,1,5,45,2,469,78,168,0.464,0,0,-1,78,168,0.464,54,79,0.684,11,54,65,22,4,3,30,90,210
739,16,1995,39,1,5,28,0,266,32,83,0.386,0,0,-1,32,83,0.386,11,17,0.647,10,33,43,8,5,8,14,44,75
739,17,1996,40,1,5,28,0,274,41,110,0.373,0,0,-1,41,110,0.373,16,26,0.615,15,25,40,11,1,8,21,61,98
740,1,2005,23,1,5,25,1,139,11,30,0.367,0,0,-1,11,30,0.367,7,14,0.5,8,11,19,3,3,4,8,12,29
740,2,2006,24,1,5,40,4,296,31,64,0.484,0,0,-1,31,64,0.484,8,11,0.727,18,30,48,5,3,15,12,76,70
744,1,1985,23,1,2,45,0,189,34,69,0.493,0,3,0,34,66,0.515,19,30,0.633,8,17,25,26,11,3,22,26,87
744,2,1986,24,1,2,36,0,199,36,84,0.429,3,9,0.333,33,75,0.44,23,29,0.793,17,29,46,29,11,4,15,22,98
744,3,1987,25,1,2,44,15,890,99,239,0.414,5,29,0.172,94,210,0.448,70,99,0.707,55,106,161,92,40,30,61,80,273
744,4,1988,26,1,2,79,27,1709,226,485,0.466,22,64,0.344,204,421,0.485,89,132,0.674,86,188,274,206,82,30,107,182,563
744,5,1989,27,1,2,82,4,1867,249,524,0.475,39,100,0.39,210,424,0.495,71,117,0.607,100,195,295,266,110,19,116,161,608
744,6,1990,28,1,2,81,64,2894,436,940,0.464,104,248,0.419,332,692,0.48,126,185,0.681,147,292,439,371,126,23,161,226,1102
744,7,1991,29,1,2,82,68,2766,344,773,0.445,49,149,0.329,295,624,0.473,95,140,0.679,142,246,388,376,121,34,160,209,832
744,8,1992,30,1,2,63,62,2016,310,684,0.453,69,167,0.413,241,517,0.466,87,123,0.707,94,213,307,238,78,22,104,150,776
744,9,1993,31,1,2,82,73,2559,385,785,0.49,93,244,0.381,292,541,0.54,86,120,0.717,113,290,403,254,104,22,124,170,949
744,10,1994,32,1,2,82,0,2147,316,708,0.446,77,221,0.348,239,487,0.491,112,154,0.727,71,208,279,273,136,26,130,161,821
744,11,1995,33,1,2,49,0,1166,191,422,0.453,51,134,0.381,140,288,0.486,44,71,0.62,55,92,147,113,46,6,73,86,477
744,12,1996,34,1,2,79,8,1758,253,591,0.428,82,221,0.371,171,370,0.462,81,103,0.786,65,191,256,138,85,9,104,138,669
744,13,1997,35,1,2,62,0,848,87,248,0.351,27,95,0.284,60,153,0.392,13,26,0.5,39,71,110,68,36,4,45,71,214
746,1,1995,22,1,1,34,4,496,37,105,0.352,8,32,0.25,29,73,0.397,31,40,0.775,10,32,42,77,18,5,42,78,113
746,1,1995,22,1,1,49,4,552,40,122,0.328,9,37,0.243,31,85,0.365,31,40,0.775,12,36,48,95,18,6,50,81,120
746,2,1996,23,1,1,65,0,961,104,242,0.43,14,62,0.226,90,180,0.5,65,77,0.844,22,56,78,146,29,3,77,130,287
746,3,1997,24,1,1,82,0,1083,139,308,0.451,20,72,0.278,119,236,0.504,70,89,0.787,20,64,84,198,44,10,110,141,368
746,4,1998,25,1,1,82,18,1726,229,519,0.441,48,118,0.407,181,401,0.451,127,149,0.852,25,141,166,346,54,13,160,182,633
746,5,1999,26,1,1,50,0,1038,140,314,0.446,21,50,0.42,119,264,0.451,67,80,0.838,12,82,94,185,30,2,109,122,368
746,6,2000,27,1,1,82,5,2096,282,675,0.418,60,163,0.368,222,512,0.434,84,102,0.824,23,147,170,347,59,9,132,223,708
746,7,2001,28,1,2,82,40,2426,265,675,0.393,107,269,0.398,158,406,0.389,104,126,0.825,23,174,197,295,99,12,102,218,741
746,8,2002,29,1,1,39,0,609,59,175,0.337,14,58,0.241,45,117,0.385,39,49,0.796,9,40,49,100,24,3,53,55,171
746,9,2003,30,1,1,82,76,2243,262,628,0.417,131,337,0.389,131,291,0.45,89,105,0.848,24,162,186,444,71,9,149,222,744
746,10,2004,31,1,1,34,0,727,86,249,0.345,24,78,0.308,62,171,0.363,44,53,0.83,13,50,63,117,26,2,48,52,240
746,10,2004,31,1,1,33,23,730,80,202,0.396,28,85,0.329,52,117,0.444,32,36,0.889,7,59,66,156,30,3,50,85,220
746,10,2004,31,1,1,67,23,1457,166,451,0.368,52,163,0.319,114,288,0.396,76,89,0.854,20,109,129,273,56,5,98,137,460
746,11,2005,32,1,1,74,1,1428,161,405,0.398,27,103,0.262,134,302,0.444,66,83,0.795,15,75,90,250,45,9,111,156,415
746,12,2006,33,1,1,13,0,112,4,17,0.235,1,4,0.25,3,13,0.231,0,0,-1,1,13,14,25,3,0,3,11,9
746,12,2006,33,1,1,19,0,282,30,86,0.349,12,38,0.316,18,48,0.375,20,24,0.833,2,17,19,44,8,2,18,23,92
746,12,2006,33,1,1,32,0,394,34,103,0.33,13,42,0.31,21,61,0.344,20,24,0.833,3,30,33,69,11,2,21,34,101
747,1,2001,21,1,1,50,14,936,115,311,0.37,28,84,0.333,87,227,0.383,56,72,0.778,21,60,81,145,48,2,54,99,314
749,1,1980,24,1,4,54,-1,722,101,228,0.443,1,4,0.25,100,224,0.446,104,152,0.684,67,118,185,53,29,14,88,97,307
749,2,1981,25,1,5,73,-1,1320,214,419,0.511,1,2,0.5,213,417,0.511,121,202,0.599,104,157,261,129,34,16,119,175,550
751,1,1984,23,1,3,67,2,1059,225,493,0.456,12,29,0.414,213,464,0.459,87,121,0.719,106,144,250,56,41,9,78,118,549
751,2,1985,24,1,3,72,4,1314,274,603,0.454,42,109,0.385,232,494,0.47,77,104,0.74,100,138,238,56,46,7,58,131,667
751,3,1986,25,1,3,72,1,1086,193,470,0.411,63,173,0.364,130,297,0.438,59,82,0.72,86,82,168,37,40,9,38,78,508
751,4,1987,26,1,2,82,76,3073,785,1520,0.516,86,240,0.358,699,1280,0.546,385,489,0.787,187,260,447,238,104,32,238,267,2041
751,5,1988,27,1,2,75,73,2790,764,1519,0.503,107,259,0.413,657,1260,0.521,303,395,0.767,167,173,340,197,74,11,172,221,1938
751,6,1989,28,1,2,82,82,3190,857,1710,0.501,162,339,0.478,695,1371,0.507,377,462,0.816,156,186,342,164,108,22,218,197,2253
751,7,1990,29,1,2,55,49,2033,502,1011,0.497,96,256,0.375,406,755,0.538,193,236,0.818,90,148,238,110,59,7,119,124,1293
751,8,1991,30,1,2,21,0,624,159,327,0.486,30,68,0.441,129,259,0.498,58,82,0.707,38,43,81,31,16,5,32,53,406
751,8,1991,30,1,2,30,24,800,181,391,0.463,27,89,0.303,154,302,0.51,62,84,0.738,28,64,92,64,33,3,49,59,451
751,8,1991,30,1,2,51,24,1424,340,718,0.474,57,157,0.363,283,561,0.504,120,166,0.723,66,107,173,95,49,8,81,112,857
751,9,1992,31,1,3,81,11,2191,485,1034,0.469,138,329,0.419,347,705,0.492,164,212,0.774,92,161,253,104,57,18,119,151,1272
751,10,1993,32,1,2,82,76,2731,545,1092,0.499,119,297,0.401,426,795,0.536,157,197,0.797,81,231,312,107,78,18,111,179,1366
751,11,1994,33,1,3,77,75,2590,478,967,0.494,131,332,0.395,347,635,0.546,83,107,0.776,70,185,255,80,66,11,75,141,1170
751,12,1995,34,1,3,81,3,1996,351,774,0.453,106,263,0.403,245,511,0.479,110,127,0.866,56,166,222,57,37,9,81,142,918
751,13,1996,35,1,3,81,52,2626,459,959,0.479,150,364,0.412,309,595,0.519,136,179,0.76,88,227,315,139,57,7,98,191,1204
751,14,1997,36,1,3,82,51,2940,477,1151,0.414,192,528,0.364,285,623,0.457,215,263,0.817,99,194,293,165,60,7,146,178,1361
751,15,1998,37,1,3,79,0,1939,348,700,0.497,127,274,0.464,221,426,0.519,111,142,0.782,51,133,184,89,60,5,74,128,934
751,16,1999,38,1,3,48,5,1232,174,395,0.441,94,217,0.433,80,178,0.449,53,70,0.757,25,90,115,38,25,3,45,77,495
751,17,2000,39,1,2,24,5,240,19,58,0.328,14,35,0.4,5,23,0.217,3,4,0.75,6,16,22,8,7,0,13,22,55
751,17,2000,39,1,2,18,0,324,47,101,0.465,23,65,0.354,24,36,0.667,6,9,0.667,7,27,34,6,6,0,7,23,123
751,17,2000,39,1,2,42,5,564,66,159,0.415,37,100,0.37,29,59,0.492,9,13,0.692,13,43,56,14,13,0,20,45,178
752,1,1980,25,1,4,48,-1,502,61,136,0.449,0,3,0,61,133,0.459,40,53,0.755,51,65,116,30,10,24,24,67,162
753,1,1991,27,1,3,30,0,624,77,152,0.507,3,8,0.375,74,144,0.514,74,87,0.851,46,63,109,44,19,10,27,83,231
753,1,1991,27,1,3,33,0,644,79,159,0.497,4,10,0.4,75,149,0.503,75,89,0.843,46,64,110,45,19,10,30,85,237
753,2,1992,28,1,2,79,32,1677,221,424,0.521,23,70,0.329,198,354,0.559,155,182,0.852,69,158,227,174,68,15,83,159,620
753,3,1993,29,1,3,82,7,1757,240,524,0.458,45,129,0.349,195,395,0.494,183,214,0.855,59,157,216,177,74,20,89,145,708
753,4,1994,30,1,3,67,8,1606,208,466,0.446,56,167,0.335,152,299,0.508,154,179,0.86,28,153,181,208,50,8,109,124,626
753,5,1995,31,1,3,81,13,1896,243,487,0.499,80,201,0.398,163,286,0.57,144,171,0.842,50,146,196,189,65,12,104,158,710
753,6,1996,32,1,3,45,16,1385,180,357,0.504,41,127,0.323,139,230,0.604,98,115,0.852,47,108,155,138,45,11,59,93,499
753,7,1997,33,1,3,78,77,2687,291,585,0.497,120,286,0.42,171,299,0.572,207,231,0.896,60,175,235,310,92,12,135,200,909
753,8,1998,34,1,3,73,59,1988,206,456,0.452,55,189,0.291,151,267,0.566,145,174,0.833,39,117,156,221,81,8,100,115,612
753,9,1999,35,1,2,47,37,1291,156,331,0.471,40,107,0.374,116,224,0.518,103,119,0.866,36,101,137,89,46,12,61,91,455
753,10,2000,36,1,3,79,79,2217,195,457,0.427,74,186,0.398,121,271,0.446,126,149,0.846,48,201,249,193,73,9,130,156,590
753,11,2001,37,1,2,68,67,1506,104,246,0.423,36,100,0.36,68,146,0.466,55,69,0.797,38,117,155,131,58,12,60,112,299
754,1,1990,21,1,3,81,69,2032,311,647,0.481,1,9,0.111,310,638,0.486,187,216,0.866,127,170,297,154,45,14,112,172,810
754,2,1991,22,1,3,82,82,3044,478,976,0.49,20,64,0.313,458,912,0.502,325,402,0.808,142,314,456,238,69,33,147,190,1301
754,3,1992,23,1,3,82,82,3120,514,1040,0.494,25,82,0.305,489,958,0.51,285,331,0.861,143,296,439,214,84,29,152,149,1338
754,4,1993,24,1,3,70,70,2604,451,918,0.491,37,104,0.356,414,814,0.509,268,337,0.795,85,237,322,265,68,28,152,132,1207
754,5,1994,25,1,3,73,73,2409,360,791,0.455,26,87,0.299,334,704,0.474,139,173,0.803,68,195,263,197,54,27,129,174,885
754,6,1995,26,1,3,81,81,2858,502,1072,0.468,136,333,0.408,366,739,0.495,326,404,0.807,63,224,287,206,78,38,151,216,1466
754,7,1996,27,1,3,77,77,2901,525,1127,0.466,161,392,0.411,364,735,0.495,326,423,0.771,69,327,396,211,69,33,198,178,1537
754,8,1997,28,1,3,39,39,1393,196,464,0.422,42,126,0.333,154,338,0.456,148,196,0.755,48,142,190,124,24,24,89,105,582
754,9,1998,29,1,3,36,36,1012,122,303,0.403,34,90,0.378,88,213,0.413,56,78,0.718,16,108,124,62,24,14,57,92,334
754,10,1999,30,1,3,50,50,1509,208,507,0.41,39,119,0.328,169,388,0.436,106,140,0.757,35,178,213,117,26,17,71,104,561
754,11,2000,31,1,3,19,19,391,38,106,0.358,13,37,0.351,25,69,0.362,25,32,0.781,6,41,47,28,12,2,19,34,114
754,12,2001,32,1,3,52,34,1229,147,339,0.434,55,129,0.426,92,210,0.438,60,84,0.714,17,153,170,81,23,25,51,80,409
756,1,1993,22,1,4,82,82,2749,483,958,0.504,2,13,0.154,481,945,0.509,237,317,0.748,274,470,744,151,72,111,153,293,1205
756,2,1994,23,1,4,79,79,2699,483,963,0.502,7,23,0.304,476,940,0.506,242,359,0.674,220,462,682,167,63,80,172,304,1215
756,3,1996,25,1,3,45,28,1269,189,432,0.438,4,22,0.182,185,410,0.451,89,148,0.601,93,229,322,74,36,33,83,163,471
756,4,1997,26,1,4,55,49,2002,445,1014,0.439,95,259,0.367,350,755,0.464,218,282,0.773,107,279,386,131,44,41,117,181,1203
756,5,1998,27,1,3,76,71,2575,410,1007,0.407,57,201,0.284,353,806,0.438,206,256,0.805,146,398,544,213,65,49,173,226,1083
756,6,1999,28,1,4,20,20,539,80,190,0.421,1,5,0.2,79,185,0.427,43,61,0.705,25,84,109,18,8,7,34,48,204
756,7,2000,29,1,4,58,8,1309,209,464,0.45,3,21,0.143,206,443,0.465,66,95,0.695,98,192,290,59,32,25,52,133,487
756,8,2001,30,1,4,82,5,1948,298,642,0.464,7,22,0.318,291,620,0.469,169,214,0.79,199,295,494,93,67,74,108,290,772
756,9,2002,31,1,3,66,14,1684,189,452,0.418,38,124,0.306,151,328,0.46,53,84,0.631,107,180,287,56,30,37,73,196,469
756,10,2003,32,1,4,55,3,784,100,262,0.382,27,107,0.252,73,155,0.471,50,66,0.758,44,113,157,15,15,15,31,88,277
758,1,1980,27,1,5,58,-1,915,104,242,0.43,0,0,-1,104,242,0.43,51,74,0.689,74,183,257,64,41,39,67,154,259
758,2,1981,28,1,5,72,-1,925,76,212,0.358,0,0,-1,76,212,0.358,54,75,0.72,68,140,208,69,37,52,44,178,206
758,3,1982,29,1,5,81,70,2100,300,652,0.46,0,0,-1,300,652,0.46,135,170,0.794,167,274,441,100,92,92,136,280,735
758,4,1983,30,1,5,74,0,975,97,244,0.398,0,1,0,97,243,0.399,54,84,0.643,81,157,238,39,44,38,83,125,248
758,5,1984,31,1,4,65,5,832,64,157,0.408,0,0,-1,64,157,0.408,27,38,0.711,62,103,165,30,29,30,46,153,155
759,1,2004,27,1,5,62,14,875,94,199,0.472,0,1,0,94,198,0.475,30,45,0.667,65,138,203,32,35,39,35,145,218
759,2,2005,28,1,5,67,11,939,101,216,0.468,1,3,0.333,100,213,0.469,45,79,0.57,61,140,201,34,34,41,40,129,248
759,3,2006,29,1,5,72,54,1579,151,284,0.532,1,5,0.2,150,279,0.538,49,74,0.662,99,240,339,47,54,45,65,211,352
759,4,2007,30,1,5,70,41,1332,144,282,0.511,0,2,0,144,280,0.514,62,80,0.775,81,255,336,55,31,59,86,184,350
759,5,2008,31,1,5,22,2,279,30,88,0.341,0,1,0,30,87,0.345,6,13,0.462,17,48,65,8,6,6,17,34,66
759,5,2008,31,1,5,41,3,534,62,148,0.419,0,0,-1,62,148,0.419,20,24,0.833,33,102,135,16,9,14,30,62,144
759,5,2008,31,1,5,63,5,813,92,236,0.39,0,1,0,92,235,0.391,26,37,0.703,50,150,200,24,15,20,47,96,210
759,6,2009,32,1,5,59,23,977,83,169,0.491,1,4,0.25,82,165,0.497,33,39,0.846,100,129,229,32,36,36,48,144,200
759,7,2011,34,1,5,62,1,610,54,113,0.478,0,0,-1,54,113,0.478,26,31,0.839,35,80,115,33,21,14,32,84,134
763,1,1991,23,1,2,70,12,1443,251,572,0.439,3,31,0.097,248,541,0.458,111,157,0.707,66,81,147,177,25,15,114,127,616
763,2,1992,24,1,2,81,6,1665,366,846,0.433,6,34,0.176,360,812,0.443,148,176,0.841,74,94,168,143,32,9,89,160,886
765,1,2011,24,1,5,37,7,531,58,97,0.598,0,0,-1,58,97,0.598,34,54,0.63,31,76,107,19,13,21,32,92,150
765,1,2011,24,1,5,41,8,595,62,111,0.559,0,0,-1,62,111,0.559,39,60,0.65,37,81,118,20,15,24,34,104,163
765,2,2012,25,1,5,28,9,333,39,74,0.527,0,0,-1,39,74,0.527,21,41,0.512,20,52,72,9,10,5,16,60,99
769,1,1980,26,1,3,24,-1,875,207,427,0.485,2,3,0.667,205,424,0.483,96,126,0.762,102,123,225,82,28,29,90,78,512
769,1,1980,26,1,3,54,-1,1526,346,686,0.504,0,3,0,346,683,0.507,114,140,0.814,167,213,380,142,45,33,124,128,806
769,1,1980,26,1,3,78,-1,2401,553,1113,0.497,2,6,0.333,551,1107,0.498,210,266,0.789,269,336,605,224,73,62,214,206,1318
769,2,1981,27,1,3,81,-1,3093,768,1555,0.494,3,5,0.6,765,1550,0.494,390,459,0.85,273,373,646,290,106,100,241,255,1929
769,3,1982,28,1,3,82,82,3015,855,1553,0.551,0,8,0,855,1545,0.553,372,443,0.84,210,348,558,433,87,120,261,261,2082
769,4,1983,29,1,3,82,82,2988,959,1857,0.516,2,12,0.167,957,1845,0.519,406,490,0.829,263,338,601,397,116,126,263,235,2326
769,5,1984,30,1,3,82,77,2870,907,1714,0.529,1,7,0.143,906,1707,0.531,352,427,0.824,216,248,464,406,83,95,222,252,2167
769,6,1985,31,1,3,81,81,2924,939,1812,0.518,1,5,0.2,938,1807,0.519,383,462,0.829,203,255,458,344,101,46,251,259,2262
769,7,1986,32,1,3,81,81,3024,951,1888,0.504,1,5,0.2,950,1883,0.505,511,593,0.862,192,213,405,320,73,29,249,235,2414
769,8,1987,33,1,3,82,82,3085,965,1920,0.503,4,15,0.267,961,1905,0.504,411,487,0.844,146,198,344,422,73,21,214,216,2345
769,9,1988,34,1,3,80,80,2818,843,1704,0.495,0,6,0,843,1698,0.496,314,379,0.828,166,207,373,377,70,23,181,193,2000
769,10,1989,35,1,3,82,82,2990,924,1881,0.491,2,8,0.25,922,1873,0.492,325,379,0.858,148,178,326,383,66,12,198,174,2175
769,11,1990,36,1,3,80,80,2211,635,1293,0.491,2,5,0.4,633,1288,0.491,161,183,0.88,119,167,286,225,51,23,93,130,1433
769,12,1991,37,1,3,79,26,1748,322,734,0.439,0,1,0,322,733,0.439,119,140,0.85,108,146,254,105,40,25,101,141,763
770,1,1994,23,1,2,36,0,419,56,129,0.434,8,17,0.471,48,112,0.429,10,21,0.476,9,36,45,38,8,10,36,61,130
770,2,1995,24,1,2,8,0,127,15,39,0.385,3,12,0.25,12,27,0.444,10,13,0.769,1,2,3,7,7,1,6,19,43
773,1,1980,29,1,3,78,-1,2812,838,1614,0.519,4,20,0.2,834,1594,0.523,420,534,0.787,215,361,576,355,170,140,284,208,2100
773,2,1981,30,1,3,82,-1,2874,794,1524,0.521,4,18,0.222,790,1506,0.525,422,536,0.787,244,413,657,364,173,147,266,233,2014
773,3,1982,31,1,3,81,81,2789,780,1428,0.546,3,11,0.273,777,1417,0.548,411,539,0.763,220,337,557,319,161,141,214,229,1974
773,4,1983,32,1,3,72,72,2421,605,1170,0.517,2,7,0.286,603,1163,0.518,330,435,0.759,173,318,491,263,112,131,196,202,1542
773,5,1984,33,1,3,77,77,2683,678,1324,0.512,7,21,0.333,671,1303,0.515,364,483,0.754,190,342,532,309,141,139,230,217,1727
773,6,1985,34,1,3,78,78,2535,610,1236,0.494,3,14,0.214,607,1222,0.497,338,442,0.765,172,242,414,233,135,109,208,199,1561
773,7,1986,35,1,3,74,74,2474,521,1085,0.48,9,32,0.281,512,1053,0.486,289,368,0.785,169,201,370,248,113,82,214,196,1340
773,8,1987,36,1,3,60,60,1918,400,850,0.471,14,53,0.264,386,797,0.484,191,235,0.813,115,149,264,191,76,94,158,137,1005
774,1,2000,24,1,5,31,5,373,38,72,0.528,0,0,-1,38,72,0.528,15,30,0.5,40,68,108,21,8,21,21,84,91
774,2,2001,25,1,5,74,51,1331,92,200,0.46,0,0,-1,92,200,0.46,67,102,0.657,135,231,366,40,41,58,53,220,251
774,3,2002,26,1,5,31,6,299,21,50,0.42,0,0,-1,21,50,0.42,20,33,0.606,35,63,98,9,10,9,16,60,62
774,4,2003,27,1,5,17,3,135,7,19,0.368,0,0,-1,7,19,0.368,3,4,0.75,10,19,29,6,10,7,6,35,17
776,1,1996,27,1,1,30,0,282,36,100,0.36,13,56,0.232,23,44,0.523,31,39,0.795,4,12,16,23,7,0,39,27,116
779,1,1998,24,1,3,28,1,332,46,106,0.434,17,42,0.405,29,64,0.453,6,9,0.667,18,34,52,24,7,5,14,44,115
779,1,1998,24,1,3,44,0,561,77,206,0.374,12,45,0.267,65,161,0.404,40,48,0.833,31,54,85,31,22,8,24,57,206
779,1,1998,24,1,3,72,1,893,123,312,0.394,29,87,0.333,94,225,0.418,46,57,0.807,49,88,137,55,29,13,38,101,321
779,2,1999,25,1,3,11,0,121,11,34,0.324,4,11,0.364,7,23,0.304,4,4,1,4,13,17,14,3,3,2,7,30
779,2,1999,25,1,3,16,0,145,13,44,0.295,4,13,0.308,9,31,0.29,4,4,1,6,13,19,15,5,3,2,8,34
780,1,1980,24,1,4,36,-1,381,63,140,0.45,7,18,0.389,56,122,0.459,24,42,0.571,26,49,75,37,14,1,36,64,157
781,1,1980,24,1,2,79,-1,1246,208,464,0.448,12,42,0.286,196,422,0.464,58,85,0.682,29,78,107,230,60,9,128,194,486
781,2,1981,25,1,1,71,-1,911,134,291,0.46,2,14,0.143,132,277,0.477,50,64,0.781,22,65,87,167,34,4,72,114,320
781,3,1982,26,1,1,14,0,196,24,51,0.471,0,2,0,24,49,0.49,8,12,0.667,3,9,12,22,9,0,15,26,56
781,3,1982,26,1,1,22,0,270,35,86,0.407,0,6,0,35,80,0.438,13,20,0.65,5,17,22,42,13,0,26,36,83
781,4,1983,27,1,2,42,5,695,115,243,0.473,0,9,0,115,234,0.491,33,41,0.805,4,54,58,113,23,3,71,94,263
781,5,1984,28,1,1,78,5,1687,243,564,0.431,32,89,0.36,211,475,0.444,111,131,0.847,23,115,138,288,61,4,117,175,629
781,6,1985,29,1,2,81,0,1437,323,661,0.489,57,157,0.363,266,504,0.528,113,131,0.863,26,93,119,231,65,12,130,174,816
781,7,1986,30,1,1,81,1,1389,304,715,0.425,39,176,0.222,265,539,0.492,126,149,0.846,30,71,101,177,61,1,124,159,773
781,8,1987,31,1,2,81,4,1567,334,729,0.458,53,169,0.314,281,560,0.502,96,123,0.78,36,92,128,185,79,12,107,149,817
781,9,1988,32,1,1,56,0,656,139,307,0.453,36,91,0.396,103,216,0.477,30,37,0.811,9,39,48,81,34,6,43,78,344
783,1,2006,22,1,2,66,5,971,97,255,0.38,22,78,0.282,75,177,0.424,36,46,0.783,23,62,85,84,37,6,57,86,252
783,2,2007,23,1,1,61,3,712,65,161,0.404,14,44,0.318,51,117,0.436,35,45,0.778,9,64,73,90,32,4,50,62,179
784,1,2009,23,1,5,19,0,120,15,31,0.484,0,0,-1,15,31,0.484,18,30,0.6,16,31,47,8,1,12,9,20,48
784,2,2010,24,1,5,36,0,240,24,62,0.387,0,3,0,24,59,0.407,14,19,0.737,26,49,75,10,1,14,20,57,62
784,3,2011,25,1,5,31,0,168,30,58,0.517,0,1,0,30,57,0.526,15,23,0.652,24,44,68,5,2,13,11,29,75
784,4,2012,26,1,5,35,0,206,26,48,0.542,0,1,0,26,47,0.553,18,26,0.692,28,43,71,8,1,26,21,43,70
784,5,2013,27,1,5,17,0,235,28,61,0.459,0,0,-1,28,61,0.459,13,25,0.52,33,54,87,8,5,21,27,45,69
784,5,2013,27,1,5,30,0,322,35,82,0.427,0,0,-1,35,82,0.427,14,27,0.519,43,68,111,12,6,27,31,60,84
785,1,1986,23,1,5,50,50,1771,386,814,0.474,0,5,0,386,809,0.477,226,306,0.739,124,327,451,102,54,103,172,191,998
785,2,1987,24,1,4,63,63,2206,530,1053,0.503,0,7,0,530,1046,0.507,296,415,0.713,157,398,555,104,89,147,229,248,1356
785,3,1988,25,1,5,82,82,2546,656,1183,0.555,0,3,0,656,1180,0.556,341,476,0.716,245,431,676,125,104,245,287,332,1653
785,4,1989,26,1,5,80,80,2896,727,1282,0.567,0,6,0,727,1276,0.57,361,484,0.746,213,527,740,188,117,281,266,311,1815
785,5,1990,27,1,5,82,82,3165,922,1673,0.551,1,4,0.25,921,1669,0.552,502,648,0.775,235,658,893,182,78,327,278,325,2347
785,6,1991,28,1,5,81,81,3104,845,1645,0.514,0,6,0,845,1639,0.516,464,623,0.745,194,711,905,244,80,258,291,287,2154
785,7,1992,29,1,5,82,82,3150,796,1525,0.522,1,6,0.167,795,1519,0.523,377,511,0.738,228,693,921,156,88,245,209,277,1970
785,8,1993,30,1,5,81,81,3003,779,1550,0.503,1,7,0.143,778,1543,0.504,400,556,0.719,191,789,980,151,74,161,265,286,1959
785,9,1994,31,1,5,79,79,2972,745,1503,0.496,4,14,0.286,741,1489,0.498,445,582,0.765,219,666,885,179,90,217,260,275,1939
785,10,1995,32,1,5,79,79,2920,730,1452,0.503,6,21,0.286,724,1431,0.506,420,560,0.75,157,710,867,212,68,159,256,272,1886
785,11,1996,33,1,5,76,76,2783,678,1456,0.466,4,28,0.143,674,1428,0.472,351,461,0.761,157,649,806,160,68,184,221,247,1711
785,12,1997,34,1,5,78,78,2887,655,1342,0.488,2,9,0.222,653,1333,0.49,439,582,0.754,175,659,834,156,69,189,269,250,1751
785,13,1998,35,1,5,26,26,848,203,403,0.504,0,2,0,203,401,0.506,134,186,0.72,59,206,265,28,16,58,77,74,540
785,14,1999,36,1,5,38,38,1300,247,568,0.435,0,2,0,247,566,0.436,163,231,0.706,74,303,377,43,30,100,99,105,657
785,15,2000,37,1,5,62,62,2035,361,775,0.466,0,2,0,361,773,0.467,207,283,0.731,140,464,604,58,36,84,142,196,929
785,16,2001,38,1,5,79,79,2107,294,684,0.43,0,2,0,294,682,0.431,172,251,0.685,124,461,585,92,53,91,151,229,760
785,17,2002,39,1,5,65,4,901,148,333,0.444,0,1,0,148,332,0.446,94,134,0.701,60,203,263,35,22,45,65,129,390
787,1,2011,21,1,3,44,18,947,130,306,0.425,25,91,0.275,105,215,0.488,18,28,0.643,27,96,123,35,34,28,47,78,303
787,2,2012,22,1,3,7,0,102,6,25,0.24,1,3,0.333,5,22,0.227,4,8,0.5,4,10,14,5,3,5,3,7,17
790,1,1990,23,1,1,43,6,559,88,217,0.406,3,21,0.143,85,196,0.434,17,25,0.68,7,44,51,80,13,2,33,53,196
798,1,2009,21,1,2,15,0,155,24,49,0.49,0,1,0,24,48,0.5,2,7,0.286,11,17,28,13,6,7,12,19,50
798,2,2010,22,1,2,47,0,317,40,76,0.526,2,11,0.182,38,65,0.585,17,30,0.567,13,36,49,16,4,9,11,29,99
805,1,1997,23,1,5,35,3,268,30,57,0.526,0,2,0,30,55,0.545,16,29,0.552,17,43,60,7,2,4,13,39,76
810,1,1980,22,1,1,72,-1,1116,115,287,0.401,0,2,0,115,285,0.404,103,150,0.687,45,62,107,192,48,5,118,82,333
817,1,2004,30,1,5,17,0,172,25,47,0.532,0,0,-1,25,47,0.532,18,27,0.667,22,33,55,6,3,4,10,32,68
817,2,2005,31,1,5,21,5,297,43,83,0.518,0,1,0,43,82,0.524,9,17,0.529,23,42,65,13,7,5,18,55,95
818,1,2002,26,1,4,54,15,848,103,245,0.42,0,0,-1,103,245,0.42,118,181,0.652,110,143,253,14,21,18,60,104,324
818,2,2004,28,1,5,46,0,473,51,95,0.537,0,0,-1,51,95,0.537,67,96,0.698,49,97,146,13,8,8,27,74,169
818,3,2005,29,1,5,16,0,159,11,32,0.344,0,0,-1,11,32,0.344,29,48,0.604,18,24,42,6,5,2,12,26,51
820,1,1995,23,1,3,46,7,424,68,121,0.562,1,3,0.333,67,118,0.568,16,39,0.41,14,39,53,30,19,4,30,48,153
820,2,1996,24,1,3,63,7,838,112,214,0.523,1,3,0.333,111,211,0.526,47,73,0.644,40,58,98,47,28,5,56,94,272
820,3,1997,25,1,3,24,0,133,16,35,0.457,0,0,-1,16,35,0.457,10,14,0.714,4,14,18,12,9,1,11,15,42
821,1,1990,22,1,4,61,8,805,129,295,0.437,0,1,0,129,294,0.439,63,98,0.643,61,107,168,51,11,14,46,98,321
821,2,1991,23,1,4,70,7,1023,155,336,0.461,0,4,0,155,332,0.467,57,79,0.722,58,148,206,43,15,7,54,108,367
821,3,1992,24,1,4,37,19,984,195,400,0.488,0,1,0,195,399,0.489,50,82,0.61,49,136,185,36,22,13,58,118,440
821,4,1993,25,1,4,19,5,142,19,45,0.422,0,0,-1,19,45,0.422,5,8,0.625,5,26,31,8,0,4,3,20,43
821,4,1993,25,1,4,35,0,571,86,176,0.489,0,1,0,86,175,0.491,33,54,0.611,33,63,96,16,18,8,31,57,205
821,4,1993,25,1,4,54,5,713,105,221,0.475,0,1,0,105,220,0.477,38,62,0.613,38,89,127,24,18,12,34,77,248
821,5,1994,26,1,4,74,2,877,115,230,0.5,0,0,-1,115,230,0.5,71,104,0.683,62,137,199,34,20,12,41,91,301
821,6,1995,27,1,4,70,5,956,139,260,0.535,0,1,0,139,259,0.537,132,177,0.746,55,167,222,36,11,14,56,132,410
821,7,1996,28,1,4,71,4,1045,127,268,0.474,0,0,-1,127,268,0.474,88,115,0.765,85,138,223,23,23,13,48,137,342
821,8,1997,29,1,4,81,8,1758,191,398,0.48,0,2,0,191,396,0.482,124,172,0.721,135,266,401,64,16,24,88,205,506
821,9,1998,30,1,4,57,2,1140,127,246,0.516,0,1,0,127,245,0.518,92,132,0.697,100,171,271,36,15,17,48,127,346
821,10,1999,31,1,4,49,0,716,82,179,0.458,0,0,-1,82,179,0.458,48,75,0.64,54,82,136,20,8,7,32,88,212
821,11,2000,32,1,4,56,0,372,42,97,0.433,0,0,-1,42,97,0.433,33,56,0.589,34,67,101,10,8,3,21,55,117
825,1,1984,23,1,2,55,0,419,65,145,0.448,0,8,0,65,137,0.474,18,28,0.643,13,35,48,44,15,4,35,62,148
825,2,1985,24,1,2,54,4,646,110,225,0.489,1,7,0.143,109,218,0.5,40,72,0.556,20,50,70,75,25,1,49,88,261
825,3,1986,25,1,2,82,82,2032,299,628,0.476,17,50,0.34,282,578,0.488,95,132,0.72,82,162,244,193,74,9,126,205,710
825,4,1987,26,1,2,72,72,1453,272,601,0.453,16,45,0.356,256,556,0.46,136,179,0.76,84,119,203,102,44,6,77,146,696
825,5,1988,27,1,2,81,51,1796,316,611,0.517,32,97,0.33,284,514,0.553,113,152,0.743,64,123,187,175,65,5,91,193,777
825,6,1989,28,1,2,46,9,964,140,300,0.467,19,54,0.352,121,246,0.492,42,75,0.56,29,99,128,50,37,6,43,105,341
825,7,1990,29,1,2,81,81,2174,265,568,0.467,54,154,0.351,211,414,0.51,33,64,0.516,66,163,229,149,52,11,79,194,617
825,8,1991,30,1,2,36,24,811,96,256,0.375,19,69,0.275,77,187,0.412,18,36,0.5,33,63,96,90,20,5,34,72,229
825,9,1992,31,1,2,66,0,769,75,169,0.444,7,25,0.28,68,144,0.472,8,22,0.364,15,58,73,68,26,3,28,128,165
825,9,1992,31,1,2,68,2,809,79,178,0.444,7,27,0.259,72,151,0.477,8,22,0.364,17,60,77,69,27,3,28,134,173
828,1,2004,25,1,3,41,4,507,46,130,0.354,9,30,0.3,37,100,0.37,22,27,0.815,30,40,70,19,10,9,15,67,123
830,1,1981,23,1,3,74,-1,1259,138,289,0.478,1,5,0.2,137,284,0.482,119,150,0.793,67,86,153,111,58,20,84,168,396
830,2,1982,24,1,3,81,76,1974,167,357,0.468,0,4,0,167,353,0.473,138,176,0.784,99,167,266,183,81,30,106,250,472
830,3,1983,25,1,3,82,8,1547,187,437,0.428,1,7,0.143,186,430,0.433,125,160,0.781,80,156,236,268,75,15,144,220,500
830,4,1984,26,1,3,80,14,1469,132,306,0.431,3,12,0.25,129,294,0.439,167,207,0.807,66,139,205,252,68,19,109,255,434
830,5,1985,27,1,3,80,1,1673,220,522,0.421,1,15,0.067,219,507,0.432,180,238,0.756,88,119,207,210,84,26,115,291,621
830,6,1986,28,1,3,79,0,1982,331,741,0.447,8,41,0.195,323,700,0.461,318,405,0.785,88,176,264,316,107,16,165,277,988
830,7,1987,29,1,4,73,10,1990,307,746,0.412,22,80,0.275,285,666,0.428,316,402,0.786,79,177,256,280,87,28,132,245,952
830,8,1988,30,1,3,77,0,1334,109,287,0.38,3,16,0.188,106,271,0.391,129,163,0.791,39,132,171,166,64,17,95,185,350
830,9,1989,31,1,4,41,0,701,66,151,0.437,1,5,0.2,65,146,0.445,68,87,0.782,18,75,93,86,25,5,53,82,201
830,10,1990,32,1,4,81,0,1605,179,396,0.452,6,31,0.194,173,365,0.474,136,183,0.743,67,140,207,186,78,29,87,249,500
831,1,2011,23,1,4,28,0,241,28,71,0.394,2,10,0.2,26,61,0.426,5,8,0.625,17,38,55,10,4,7,5,36,63
831,1,2011,23,1,4,21,0,399,51,135,0.378,14,56,0.25,37,79,0.468,14,18,0.778,23,65,88,20,11,10,11,44,130
831,1,2011,23,1,4,49,0,640,79,206,0.383,16,66,0.242,63,140,0.45,19,26,0.731,40,103,143,30,15,17,16,80,193
831,2,2012,24,1,4,21,1,231,23,65,0.354,5,21,0.238,18,44,0.409,9,12,0.75,20,33,53,6,6,3,4,17,60
833,1,1981,23,1,2,22,-1,111,22,59,0.373,0,0,-1,22,59,0.373,7,10,0.7,8,11,19,3,1,9,11,13,51
833,2,1982,24,1,2,38,0,310,62,136,0.456,0,5,0,62,131,0.473,18,29,0.621,14,20,34,20,9,4,20,32,142
835,1,1995,25,1,2,10,0,158,21,53,0.396,1,1,1,20,52,0.385,3,6,0.5,9,14,23,12,9,0,7,12,46
839,1,1980,23,1,4,76,-1,1600,184,363,0.507,1,2,0.5,183,361,0.507,51,66,0.773,124,275,399,104,47,87,105,207,420
839,2,1981,24,1,4,23,-1,509,52,111,0.468,0,0,-1,52,111,0.468,11,20,0.55,39,94,133,36,21,20,23,58,115
839,3,1982,25,1,3,82,17,1814,179,369,0.485,0,1,0,179,368,0.486,64,93,0.688,153,317,470,110,58,67,78,192,422
841,1,1981,23,1,4,55,-1,461,56,136,0.412,0,3,0,56,133,0.421,37,85,0.435,28,65,93,17,23,20,32,73,149
841,2,1982,24,1,4,68,38,1433,184,370,0.497,0,1,0,184,369,0.499,96,153,0.627,127,212,339,54,55,82,92,229,464
842,1,1984,22,1,1,82,1,1712,200,451,0.443,3,26,0.115,197,425,0.464,66,98,0.673,53,119,172,239,95,21,111,143,469
842,2,1985,23,1,1,82,1,2218,329,633,0.52,21,61,0.344,308,572,0.538,111,154,0.721,47,152,199,360,144,37,123,194,790
842,3,1986,24,1,1,79,39,2150,390,730,0.534,12,51,0.235,378,679,0.557,171,229,0.747,75,151,226,416,153,23,144,166,963
842,4,1987,25,1,1,77,76,2556,497,993,0.501,76,212,0.358,421,781,0.539,160,234,0.684,51,148,199,609,167,25,138,195,1230
842,5,1988,26,1,1,82,82,3032,536,1167,0.459,60,192,0.313,476,975,0.488,261,344,0.759,71,175,246,634,168,35,190,164,1393
842,6,1989,27,1,1,81,81,2968,538,1127,0.477,99,278,0.356,439,849,0.517,229,284,0.806,46,182,228,570,172,41,205,219,1404
842,7,1990,28,1,1,82,82,3007,567,1161,0.488,89,240,0.371,478,921,0.519,250,315,0.794,54,190,244,609,187,26,207,224,1473
842,8,1991,29,1,1,77,77,2879,572,1226,0.467,89,246,0.362,483,980,0.493,286,391,0.731,59,174,233,548,147,14,177,222,1519
842,9,1992,30,1,1,65,64,2252,448,1011,0.443,58,186,0.312,390,825,0.473,198,261,0.759,49,121,170,373,101,17,154,150,1152
842,10,1993,31,1,2,62,60,2108,393,939,0.419,101,257,0.393,292,682,0.428,239,316,0.756,42,81,123,334,80,16,136,145,1126
842,11,1994,32,1,1,28,28,893,130,342,0.38,37,105,0.352,93,237,0.392,28,50,0.56,10,45,55,98,45,4,54,46,325
842,11,1994,32,1,1,54,27,1311,173,402,0.43,36,98,0.367,137,304,0.451,84,113,0.743,10,76,86,236,80,4,81,117,466
842,11,1994,32,1,1,82,55,2204,303,744,0.407,73,203,0.36,230,541,0.425,112,163,0.687,20,121,141,334,125,8,135,163,791
842,12,1995,33,1,1,80,80,2716,337,756,0.446,106,292,0.363,231,464,0.498,139,192,0.724,31,163,194,458,79,10,151,219,919
842,13,1996,34,1,1,82,82,2893,436,939,0.464,121,325,0.372,315,614,0.513,156,206,0.757,32,170,202,352,131,5,178,201,1149
842,14,1997,35,1,1,75,29,2210,299,674,0.444,60,176,0.341,239,498,0.48,95,128,0.742,30,107,137,321,92,12,132,144,753
842,15,1998,36,1,2,66,45,1761,226,542,0.417,59,164,0.36,167,378,0.442,55,79,0.696,23,80,103,233,72,10,101,140,566
842,16,1999,37,1,1,45,29,1120,120,291,0.412,43,117,0.368,77,174,0.443,26,32,0.813,13,54,67,187,44,4,52,66,309
843,1,1987,23,1,2,82,82,3064,734,1614,0.455,20,94,0.213,714,1520,0.47,386,564,0.684,169,223,392,394,209,84,345,247,1874
843,2,1988,24,1,2,57,52,1830,340,732,0.464,3,20,0.15,337,712,0.473,196,278,0.705,64,159,223,281,122,52,158,157,879
843,3,1989,25,1,2,82,82,2851,587,1149,0.511,29,116,0.25,558,1033,0.54,323,430,0.751,122,287,409,434,185,74,230,224,1526
843,4,1990,26,1,2,7,7,262,61,138,0.442,1,5,0.2,60,133,0.451,31,41,0.756,19,29,48,49,14,9,18,25,154
843,4,1990,26,1,2,28,28,1105,240,499,0.481,13,46,0.283,227,453,0.501,151,190,0.795,55,103,158,133,67,32,82,80,644
843,4,1990,26,1,2,35,35,1367,301,637,0.473,14,51,0.275,287,586,0.49,182,231,0.788,74,132,206,182,81,41,100,105,798
843,5,1991,27,1,2,39,34,1383,285,729,0.391,48,148,0.324,237,581,0.408,145,217,0.668,58,130,188,209,66,35,129,111,763
843,6,1992,28,1,2,82,82,3144,569,1292,0.44,64,211,0.303,505,1081,0.467,293,398,0.736,120,327,447,417,152,72,252,199,1495
843,7,1993,29,1,2,80,77,2970,542,1203,0.451,52,186,0.28,490,1017,0.482,307,399,0.769,117,308,425,360,177,73,222,212,1443
843,8,1994,30,1,2,75,75,2856,569,1335,0.426,71,236,0.301,498,1099,0.453,299,418,0.715,129,331,460,344,144,54,242,167,1508
843,9,1995,31,1,2,77,53,1536,209,491,0.426,31,110,0.282,178,381,0.467,81,131,0.618,51,129,180,157,97,27,100,132,530
843,10,1996,32,1,1,80,80,1886,234,501,0.467,28,104,0.269,206,397,0.519,98,139,0.705,74,139,213,208,105,32,73,137,594
843,11,1997,33,1,2,76,74,1740,177,406,0.436,68,188,0.362,109,218,0.5,58,82,0.707,46,147,193,191,86,38,50,138,480
843,12,1998,34,1,1,82,82,2284,293,665,0.441,16,84,0.19,277,581,0.477,162,216,0.75,107,183,290,241,108,48,91,181,764
843,13,1999,35,1,2,35,35,1107,147,390,0.377,27,85,0.318,120,305,0.393,71,101,0.703,49,131,180,115,60,35,65,80,392
843,14,2000,36,1,1,80,78,2042,212,531,0.399,33,106,0.311,179,425,0.421,100,147,0.68,96,241,337,270,85,39,132,164,557
843,15,2001,37,1,1,47,46,1139,127,271,0.469,19,72,0.264,108,199,0.543,34,48,0.708,46,120,166,113,39,25,62,70,307
844,1,1999,22,1,3,50,22,1114,148,320,0.463,10,25,0.4,138,295,0.468,102,143,0.713,88,126,214,45,30,6,73,112,408
844,2,2001,24,1,2,56,55,1615,238,524,0.454,13,52,0.25,225,472,0.477,134,165,0.812,90,152,242,102,42,17,90,161,623
844,3,2002,25,1,3,81,81,2541,386,838,0.461,21,69,0.304,365,769,0.475,165,222,0.743,203,370,573,107,70,5,127,201,958
844,4,2003,26,1,3,78,69,2557,521,1020,0.511,66,160,0.413,455,860,0.529,262,331,0.792,190,324,514,133,73,17,160,217,1370
844,5,2004,27,1,3,31,31,1134,193,410,0.471,8,33,0.242,185,377,0.491,108,157,0.688,91,156,247,63,22,2,65,102,502
844,6,2005,28,1,3,78,55,2584,418,855,0.489,9,43,0.209,409,812,0.504,245,315,0.778,196,284,480,142,70,16,133,250,1090
844,7,2006,29,1,3,71,32,1944,322,678,0.475,14,39,0.359,308,639,0.482,227,313,0.725,158,210,368,98,59,14,109,202,885
844,8,2007,30,1,3,77,2,1965,322,656,0.491,13,39,0.333,309,617,0.501,237,309,0.767,117,236,353,99,52,11,118,232,894
844,9,2008,31,1,3,76,0,1374,237,474,0.5,2,10,0.2,235,464,0.506,146,205,0.712,96,144,240,82,45,14,95,162,622
844,10,2009,32,1,2,63,2,693,111,241,0.461,0,2,0,111,239,0.464,55,72,0.764,47,76,123,28,29,9,29,102,277
845,1,2003,22,1,2,19,0,111,11,37,0.297,5,14,0.357,6,23,0.261,3,4,0.75,1,7,8,12,2,1,2,8,30
846,1,1997,23,1,4,57,1,860,112,204,0.549,0,3,0,112,201,0.557,49,81,0.605,75,123,198,18,12,22,57,112,273
846,2,1998,24,1,4,58,3,903,129,266,0.485,0,1,0,129,265,0.487,92,122,0.754,73,134,207,24,10,27,47,112,350
846,3,1999,25,1,4,41,10,903,156,304,0.513,0,0,-1,156,304,0.513,88,122,0.721,72,174,246,15,6,25,61,103,400
846,4,2000,26,1,4,82,82,2677,420,830,0.506,0,2,0,420,828,0.507,236,298,0.792,196,367,563,97,36,58,217,287,1076
846,5,2001,27,1,5,30,5,548,67,121,0.554,0,0,-1,67,121,0.554,51,70,0.729,37,62,99,20,15,19,41,101,185
846,5,2001,27,1,5,44,40,1267,180,386,0.466,0,3,0,180,383,0.47,120,154,0.779,102,187,289,36,19,26,104,136,480
846,5,2001,27,1,5,74,45,1815,247,507,0.487,0,3,0,247,504,0.49,171,224,0.763,139,249,388,56,34,45,145,237,665
846,6,2002,28,1,4,77,4,1563,237,450,0.527,0,2,0,237,448,0.529,122,172,0.709,125,224,349,37,30,36,95,250,596
846,7,2003,29,1,4,74,64,1850,225,443,0.508,0,0,-1,225,443,0.508,123,150,0.82,165,311,476,62,12,23,90,231,573
846,8,2004,30,1,4,56,3,872,100,202,0.495,0,0,-1,100,202,0.495,58,78,0.744,58,119,177,29,12,14,65,134,258
846,9,2005,31,1,4,70,28,1271,217,424,0.512,0,0,-1,217,424,0.512,127,177,0.718,106,186,292,56,24,18,84,188,561
846,10,2006,32,1,5,72,23,824,135,273,0.495,0,0,-1,135,273,0.495,77,123,0.626,54,100,154,39,7,13,61,131,347
846,11,2007,33,1,4,26,0,220,25,56,0.446,0,0,-1,25,56,0.446,17,22,0.773,13,25,38,6,1,1,15,49,67
846,12,2008,34,1,5,22,0,166,18,42,0.429,0,0,-1,18,42,0.429,10,16,0.625,11,31,42,4,1,4,11,34,46
852,1,1994,23,1,2,77,0,1165,162,385,0.421,7,33,0.212,155,352,0.44,87,119,0.731,45,112,157,106,49,10,78,117,418
852,2,1995,24,1,2,79,31,1695,280,610,0.459,55,142,0.387,225,468,0.481,136,170,0.8,85,135,220,132,58,14,77,105,751
852,3,1996,25,1,2,61,1,1016,183,397,0.461,47,125,0.376,136,272,0.5,68,87,0.782,41,81,122,79,35,3,46,56,481
852,4,1997,26,1,2,54,3,813,112,294,0.381,36,99,0.364,76,195,0.39,33,47,0.702,27,44,71,50,41,3,34,45,293
852,5,1998,27,1,2,50,0,671,69,177,0.39,12,39,0.308,57,138,0.413,41,55,0.745,21,31,52,42,42,5,21,77,191
852,6,1999,28,1,2,36,5,602,73,181,0.403,11,50,0.22,62,131,0.473,36,48,0.75,21,46,67,31,18,7,18,52,193
852,7,2000,29,1,2,77,11,1510,198,463,0.428,38,115,0.33,160,348,0.46,79,99,0.798,53,134,187,100,65,6,42,98,513
852,8,2001,30,1,2,73,50,2071,265,624,0.425,46,132,0.348,219,492,0.445,107,139,0.77,71,217,288,135,74,16,64,127,683
852,9,2002,31,1,2,74,0,1553,249,537,0.464,44,118,0.373,205,419,0.489,133,158,0.842,49,158,207,116,53,6,61,99,675
852,10,2003,32,1,2,77,25,1973,298,721,0.413,47,136,0.346,251,585,0.429,152,189,0.804,63,169,232,155,53,8,71,95,795
852,11,2004,33,1,1,69,15,1504,187,463,0.404,38,101,0.376,149,362,0.412,66,78,0.846,39,101,140,135,41,2,53,74,478
852,12,2005,34,1,2,73,4,1128,118,299,0.395,21,65,0.323,97,234,0.415,56,69,0.812,39,82,121,49,27,6,29,68,313
853,1,1986,22,1,2,57,0,482,103,233,0.442,1,5,0.2,102,228,0.447,50,54,0.926,25,32,57,50,21,4,34,55,257
853,2,1987,23,1,2,74,3,1174,251,599,0.419,0,8,0,251,591,0.425,111,130,0.854,71,99,170,100,37,16,74,111,613
853,3,1988,24,1,2,14,10,199,34,86,0.395,0,1,0,34,85,0.4,15,16,0.938,12,9,21,17,8,2,6,15,83
853,3,1988,24,1,2,44,16,885,189,401,0.471,0,6,0,189,395,0.478,74,97,0.763,41,64,105,70,42,6,50,74,452
853,3,1988,24,1,2,58,26,1084,223,487,0.458,0,7,0,223,480,0.465,89,113,0.788,53,73,126,87,50,8,56,89,535
855,1,2005,22,1,5,43,14,760,106,184,0.576,0,0,-1,106,184,0.576,52,91,0.571,48,87,135,13,16,55,53,134,264
855,2,2006,23,1,5,67,17,1034,148,294,0.503,0,0,-1,148,294,0.503,89,174,0.511,84,170,254,14,23,59,79,193,385
855,3,2007,24,1,5,24,2,190,30,58,0.517,0,0,-1,30,58,0.517,11,22,0.5,9,33,42,6,5,12,26,47,71
855,4,2008,25,1,5,55,0,702,90,170,0.529,0,0,-1,90,170,0.529,49,96,0.51,43,75,118,14,20,59,58,164,229
856,1,2002,21,1,4,18,0,162,14,26,0.538,0,0,-1,14,26,0.538,10,22,0.455,12,34,46,5,4,5,8,27,38
856,1,2002,21,1,4,29,4,679,94,191,0.492,0,0,-1,94,191,0.492,44,68,0.647,68,113,181,32,17,19,25,88,232
856,1,2002,21,1,4,47,4,841,108,217,0.498,0,0,-1,108,217,0.498,54,90,0.6,80,147,227,37,21,24,33,115,270
856,2,2003,22,1,3,77,27,1613,246,551,0.446,1,7,0.143,245,544,0.45,118,176,0.67,125,284,409,100,48,27,123,203,611
856,3,2004,23,1,4,24,1,345,36,89,0.404,0,3,0,36,86,0.419,26,39,0.667,29,43,72,8,10,11,22,44,98
856,3,2004,23,1,4,36,7,438,53,112,0.473,0,0,-1,53,112,0.473,35,44,0.795,19,73,92,13,14,16,23,85,141
856,3,2004,23,1,4,60,8,783,89,201,0.443,0,3,0,89,198,0.449,61,83,0.735,48,116,164,21,24,27,45,129,239
857,1,1994,23,1,5,27,2,186,21,45,0.467,0,0,-1,21,45,0.467,13,19,0.684,17,38,55,6,2,15,13,33,55
859,1,2002,22,1,2,78,47,2237,267,628,0.425,60,165,0.364,207,463,0.447,87,114,0.763,65,190,255,172,55,44,101,184,681
859,2,2003,23,1,2,82,53,1999,144,392,0.367,13,40,0.325,131,352,0.372,41,55,0.745,37,218,255,151,45,61,83,197,342
859,3,2004,24,1,2,81,74,2264,177,381,0.465,4,13,0.308,173,368,0.47,48,61,0.787,68,189,257,133,36,54,46,200,406
859,4,2005,25,1,2,82,51,2068,225,475,0.474,1,11,0.091,224,464,0.483,90,114,0.789,80,139,219,128,30,30,64,200,541
859,5,2006,26,1,2,77,67,2514,286,616,0.464,7,23,0.304,279,593,0.47,131,176,0.744,82,134,216,203,43,29,124,201,710
859,6,2007,27,1,2,76,68,2223,217,443,0.49,6,25,0.24,211,418,0.505,72,92,0.783,83,160,243,203,22,26,80,144,512
859,7,2008,28,1,2,26,0,310,20,55,0.364,1,5,0.2,19,50,0.38,6,8,0.75,9,30,39,15,4,2,8,35,47
859,7,2008,28,1,2,37,6,463,37,80,0.463,1,4,0.25,36,76,0.474,1,2,0.5,11,33,44,26,9,1,14,55,76
859,7,2008,28,1,2,63,6,773,57,135,0.422,2,9,0.222,55,126,0.437,7,10,0.7,20,63,83,41,13,3,22,90,123
859,8,2009,29,1,3,53,31,1094,86,191,0.45,2,8,0.25,84,183,0.459,20,25,0.8,50,96,146,51,21,16,30,92,194
859,9,2010,30,1,3,52,31,1106,90,219,0.411,0,5,0,90,214,0.421,52,69,0.754,56,96,152,50,17,9,47,91,232
861,1,1980,24,1,2,74,-1,1135,215,509,0.422,69,198,0.348,146,311,0.469,24,29,0.828,35,59,94,104,46,8,45,85,523
861,2,1981,25,1,2,17,-1,280,59,142,0.415,10,40,0.25,49,102,0.48,10,13,0.769,11,14,25,18,5,0,11,21,138
861,2,1981,25,1,2,24,-1,434,84,198,0.424,43,116,0.371,41,82,0.5,7,8,0.875,13,30,43,56,8,2,11,44,218
861,2,1981,25,1,2,41,-1,714,143,340,0.421,53,156,0.34,90,184,0.489,17,21,0.81,24,44,68,74,13,2,22,65,356
861,3,1982,26,1,2,68,2,787,144,382,0.377,71,214,0.332,73,168,0.435,31,37,0.838,13,40,53,104,30,3,36,94,390
861,4,1983,27,1,2,6,2,139,19,44,0.432,1,9,0.111,18,35,0.514,0,0,-1,3,8,11,21,2,0,9,14,39
862,1,1983,22,1,5,31,0,140,13,38,0.342,0,3,0,13,35,0.371,11,20,0.55,15,26,41,3,6,1,9,34,37
862,2,1984,23,1,4,68,8,1135,111,237,0.468,1,4,0.25,110,233,0.472,82,104,0.788,96,174,270,46,40,36,66,220,305
862,3,1985,24,1,4,64,1,825,89,188,0.473,0,0,-1,89,188,0.473,63,81,0.778,59,100,159,46,24,23,50,135,241
862,4,1986,25,1,4,62,0,650,65,159,0.409,3,4,0.75,62,155,0.4,60,70,0.857,44,80,124,26,14,8,40,118,193
862,5,1987,26,1,4,40,0,256,23,68,0.338,2,12,0.167,21,56,0.375,23,29,0.793,16,54,70,13,10,7,13,35,71
862,6,1988,27,1,4,55,0,403,40,82,0.488,5,12,0.417,35,70,0.5,25,27,0.926,27,70,97,16,8,10,14,67,110
862,7,1989,28,1,5,75,6,1206,143,328,0.436,9,28,0.321,134,300,0.447,91,107,0.85,72,159,231,59,32,42,68,203,386
862,8,1990,29,1,4,40,0,166,10,33,0.303,3,12,0.25,7,21,0.333,19,22,0.864,7,25,32,8,3,3,7,31,42
862,9,1991,30,1,4,27,0,113,16,28,0.571,3,4,0.75,13,24,0.542,13,13,1,14,14,28,7,0,0,7,23,48
862,10,1992,31,1,5,40,4,421,17,50,0.34,0,9,0,17,41,0.415,24,28,0.857,30,68,98,26,10,15,22,56,58
862,11,1993,32,1,5,76,0,670,57,112,0.509,2,8,0.25,55,104,0.529,40,55,0.727,44,93,137,34,12,8,29,115,156
866,1,1980,29,1,4,82,-1,1853,304,605,0.502,3,8,0.375,301,597,0.504,150,182,0.824,148,348,496,144,74,29,121,205,761
866,2,1981,30,1,5,74,-1,2309,333,637,0.523,1,4,0.25,332,633,0.524,222,278,0.799,165,396,561,168,73,32,161,289,889
866,3,1982,31,1,4,49,42,1317,178,370,0.481,4,10,0.4,174,360,0.483,96,126,0.762,89,231,320,142,36,34,87,156,456
866,4,1983,32,1,4,31,1,556,72,146,0.493,3,7,0.429,69,139,0.496,23,32,0.719,28,105,133,36,9,6,34,79,170
866,4,1983,32,1,4,46,3,860,91,244,0.373,2,14,0.143,89,230,0.387,46,62,0.742,53,175,228,59,29,8,73,110,230
866,4,1983,32,1,4,77,4,1416,163,390,0.418,5,21,0.238,158,369,0.428,69,94,0.734,81,280,361,95,38,14,107,189,400
866,5,1984,33,1,4,79,0,1153,114,237,0.481,1,4,0.25,113,233,0.485,61,78,0.782,50,170,220,99,24,16,52,144,290
868,1,1989,22,1,2,79,79,2577,442,971,0.455,71,166,0.428,371,805,0.461,241,290,0.831,51,174,225,239,120,37,158,184,1196
868,2,1990,23,1,2,82,82,2856,522,1136,0.46,84,200,0.42,438,936,0.468,387,436,0.888,85,219,304,261,130,28,185,217,1515
868,3,1991,24,1,2,80,80,3110,590,1251,0.472,108,270,0.4,482,981,0.491,479,550,0.871,48,262,310,299,178,39,213,182,1767
868,4,1992,25,1,2,81,81,3013,521,1127,0.462,91,229,0.397,430,898,0.479,403,461,0.874,53,218,271,248,157,43,189,174,1536
868,5,1993,26,1,1,81,81,2977,551,1172,0.47,122,307,0.397,429,865,0.496,419,487,0.86,91,255,346,317,137,30,180,189,1643
868,6,1994,27,1,2,82,82,2648,395,859,0.46,78,235,0.332,317,624,0.508,312,362,0.862,89,288,377,216,135,22,158,167,1180
868,7,1995,28,1,2,82,82,2731,390,809,0.482,131,298,0.44,259,511,0.507,261,301,0.867,60,254,314,262,122,18,150,178,1172
868,8,1996,29,1,2,82,82,2823,443,936,0.473,146,380,0.384,297,556,0.534,249,285,0.874,86,211,297,218,149,14,164,172,1281
868,9,1997,30,1,2,82,82,2755,369,795,0.464,143,355,0.403,226,440,0.514,258,295,0.875,92,228,320,250,159,12,130,146,1139
868,10,1998,31,1,2,82,82,2597,280,636,0.44,125,301,0.415,155,335,0.463,177,204,0.868,71,263,334,221,148,17,102,153,862
868,11,1999,32,1,2,50,34,1644,171,408,0.419,55,180,0.306,116,228,0.509,119,132,0.902,51,150,201,123,80,18,80,90,516
868,12,2000,33,1,2,61,49,1622,159,375,0.424,55,141,0.39,104,234,0.444,107,119,0.899,31,144,175,134,74,15,100,146,480
868,13,2001,34,1,2,59,0,681,56,137,0.409,17,46,0.37,39,91,0.429,54,63,0.857,17,63,80,72,33,9,19,45,183
869,1,2003,29,1,2,58,10,685,57,148,0.385,10,24,0.417,47,124,0.379,10,20,0.5,16,62,78,47,29,6,29,57,134
874,1,1980,34,1,4,81,-1,3183,761,1677,0.454,3,13,0.231,758,1664,0.456,334,478,0.699,269,627,896,129,62,189,215,309,1859
874,2,1981,35,1,4,81,-1,2931,584,1296,0.451,0,10,0,584,1286,0.454,271,439,0.617,235,554,789,98,68,171,189,300,1439
874,3,1982,36,1,4,82,82,3032,519,1100,0.472,0,5,0,519,1095,0.474,280,422,0.664,267,480,747,144,62,104,208,287,1318
874,4,1983,37,1,4,81,43,2302,424,890,0.476,2,4,0.5,422,886,0.476,196,287,0.683,199,417,616,158,50,81,200,232,1046
874,5,1984,38,1,4,81,4,994,158,389,0.406,0,2,0,158,387,0.408,86,132,0.652,87,173,260,71,16,28,82,123,402
875,1,2004,22,1,3,70,42,2044,278,695,0.4,40,131,0.305,238,564,0.422,77,98,0.786,71,193,264,106,71,11,110,157,673
875,2,2005,23,1,3,54,22,1560,206,530,0.389,42,123,0.341,164,407,0.403,99,118,0.839,41,186,227,90,49,9,62,107,553
875,3,2006,24,1,2,21,13,516,77,183,0.421,17,47,0.362,60,136,0.441,25,30,0.833,19,57,76,27,16,1,22,38,196
875,4,2007,25,1,3,81,17,1626,224,546,0.41,66,183,0.361,158,363,0.435,71,84,0.845,42,168,210,80,48,13,56,160,585
875,5,2008,26,1,3,82,1,1287,217,504,0.431,73,194,0.376,144,310,0.465,45,60,0.75,35,143,178,62,47,6,47,137,552
875,6,2009,27,1,3,74,1,1832,257,577,0.445,94,244,0.385,163,333,0.489,36,52,0.692,27,240,267,54,52,7,49,162,644
875,7,2010,28,1,3,45,19,1033,138,328,0.421,60,179,0.335,78,149,0.523,14,18,0.778,9,99,108,40,29,9,28,91,350
877,1,1982,26,1,5,26,0,412,46,93,0.495,0,0,-1,46,93,0.495,25,41,0.61,32,68,100,24,3,18,17,54,117
877,1,1982,26,1,5,35,0,487,54,111,0.486,0,0,-1,54,111,0.486,32,53,0.604,39,78,117,28,4,20,19,71,140
877,2,1983,27,1,5,65,3,1058,104,217,0.479,0,1,0,104,216,0.481,29,51,0.569,102,134,236,36,17,41,49,215,237
877,3,1984,28,1,5,43,0,253,26,50,0.52,0,0,-1,26,50,0.52,5,14,0.357,19,43,62,13,5,18,13,52,57
877,4,1985,29,1,5,11,0,101,10,18,0.556,0,0,-1,10,18,0.556,2,4,0.5,11,23,34,1,1,4,2,19,22
877,5,1986,30,1,5,58,0,397,39,87,0.448,0,0,-1,39,87,0.448,11,36,0.306,32,45,77,7,5,19,16,81,89
879,1,2006,23,1,2,80,27,2310,254,630,0.403,113,313,0.361,141,317,0.445,86,123,0.699,33,233,266,215,89,9,119,169,707
879,2,2007,24,1,2,80,10,2211,306,700,0.437,177,401,0.441,129,299,0.431,83,105,0.79,31,221,252,194,76,5,137,133,872
879,3,2008,25,1,2,73,17,1379,206,477,0.432,79,225,0.351,127,252,0.504,66,81,0.815,18,117,135,138,44,9,70,75,557
879,4,2009,26,1,2,10,0,176,16,43,0.372,6,16,0.375,10,27,0.37,5,8,0.625,3,22,25,23,11,1,9,22,43
879,4,2009,26,1,1,22,4,322,39,101,0.386,14,38,0.368,25,63,0.397,14,16,0.875,3,24,27,35,6,1,16,15,106
879,4,2009,26,1,1,32,4,498,55,144,0.382,20,54,0.37,35,90,0.389,19,24,0.792,6,46,52,58,17,2,25,37,149
879,5,2010,27,1,2,47,10,813,136,311,0.437,37,105,0.352,99,206,0.481,48,58,0.828,6,74,80,72,18,9,54,53,357
879,6,2011,28,1,1,36,14,586,68,164,0.415,25,64,0.391,43,100,0.43,39,50,0.78,16,44,60,70,10,9,32,43,200
881,1,1980,31,1,4,82,-1,1403,171,410,0.417,0,2,0,171,408,0.419,64,86,0.744,118,262,380,97,84,49,88,177,406
881,2,1981,32,1,4,78,-1,1631,149,396,0.376,0,7,0,149,389,0.383,79,101,0.782,120,228,348,122,104,72,81,196,377
886,1,1996,23,1,4,79,4,1416,192,434,0.442,0,3,0,192,431,0.445,119,200,0.595,164,192,356,51,44,43,87,217,503
886,2,1997,24,1,4,30,0,501,77,162,0.475,0,0,-1,77,162,0.475,45,75,0.6,47,69,116,23,21,6,29,73,199
886,3,1998,25,1,4,69,33,2000,365,753,0.485,3,6,0.5,362,747,0.485,253,388,0.652,200,242,442,73,42,36,110,175,986
886,4,1999,26,1,3,38,37,1142,187,423,0.442,0,1,0,187,422,0.443,100,149,0.671,100,150,250,28,33,19,58,96,474
886,5,2000,27,1,4,82,82,2775,429,930,0.461,1,10,0.1,428,920,0.465,224,334,0.671,265,306,571,77,81,54,139,233,1083
886,6,2001,28,1,4,73,42,1810,298,671,0.444,0,1,0,298,670,0.445,173,271,0.638,180,226,406,50,51,29,126,164,769
886,7,2002,29,1,4,26,1,422,59,116,0.509,1,1,1,58,115,0.504,24,45,0.533,31,66,97,11,11,15,21,40,143
886,8,2003,30,1,5,82,3,1494,153,327,0.468,0,2,0,153,325,0.471,88,138,0.638,156,242,398,41,33,32,61,168,394
886,9,2005,32,1,4,78,10,1203,116,220,0.527,0,2,0,116,218,0.532,41,76,0.539,164,184,348,21,29,37,49,149,273
886,10,2006,33,1,5,51,3,531,47,91,0.516,0,0,-1,47,91,0.516,33,49,0.673,60,77,137,10,9,12,22,58,127
886,11,2007,34,1,4,38,5,418,43,67,0.642,0,0,-1,43,67,0.642,33,47,0.702,48,59,107,10,9,12,12,62,119
888,1,1998,22,1,3,82,71,2527,348,725,0.48,0,4,0,348,721,0.483,136,190,0.716,71,254,325,168,96,45,165,238,832
888,2,1999,23,1,3,50,48,1517,189,453,0.417,2,12,0.167,187,441,0.424,74,91,0.813,45,152,197,113,58,24,97,136,454
888,3,2000,24,1,3,61,7,1107,129,326,0.396,1,15,0.067,128,311,0.412,69,104,0.663,34,106,140,55,39,17,68,99,328
888,4,2001,25,1,3,55,10,961,102,262,0.389,1,8,0.125,101,254,0.398,30,46,0.652,19,71,90,79,29,23,63,101,235
890,1,1997,22,1,4,29,1,301,32,77,0.416,3,12,0.25,29,65,0.446,18,26,0.692,35,57,92,3,10,4,14,32,85
890,2,1998,23,1,4,48,1,737,58,149,0.389,0,5,0,58,144,0.403,47,57,0.825,33,110,143,41,26,9,31,60,163
890,3,1999,24,1,4,22,6,399,39,88,0.443,0,1,0,39,87,0.448,42,50,0.84,27,41,68,13,12,1,15,39,120
891,1,1988,23,1,2,22,1,351,47,116,0.405,0,1,0,47,115,0.409,32,47,0.681,11,24,35,34,12,5,40,41,126
892,1,1988,23,1,2,12,2,170,19,48,0.396,0,1,0,19,47,0.404,10,14,0.714,6,11,17,21,8,0,15,24,48
892,1,1988,23,1,2,17,2,190,21,53,0.396,0,1,0,21,52,0.404,15,26,0.577,9,12,21,23,8,0,17,26,57
893,1,1980,28,1,1,66,-1,1551,154,323,0.477,0,2,0,154,321,0.48,56,77,0.727,34,77,111,274,55,4,102,107,364
893,2,1981,29,1,2,66,-1,1411,137,332,0.413,0,3,0,137,329,0.416,78,95,0.821,30,74,104,307,53,4,93,111,352
893,3,1982,30,1,2,75,23,1721,183,403,0.454,0,2,0,183,401,0.456,105,150,0.7,33,105,138,306,55,7,105,120,471
893,4,1983,31,1,2,51,2,789,107,263,0.407,0,2,0,107,261,0.41,45,57,0.789,18,51,69,138,37,2,50,57,259
894,1,1999,22,1,3,30,0,331,35,96,0.365,2,5,0.4,33,91,0.363,25,45,0.556,20,27,47,22,9,4,18,29,97
896,1,1980,24,1,1,76,2,1061,191,382,0.5,2,6,0.333,189,376,0.503,89,129,0.69,37,46,83,147,45,15,109,96,473
896,2,1981,25,1,1,82,10,1608,261,579,0.451,1,16,0.063,260,563,0.462,113,157,0.72,43,89,132,213,79,12,160,177,636
896,3,1982,26,1,1,82,31,1844,353,705,0.501,2,12,0.167,351,693,0.506,125,172,0.727,47,105,152,252,82,11,150,199,833
896,4,1983,27,1,1,82,9,1551,286,618,0.463,3,16,0.188,283,602,0.47,96,133,0.722,57,67,124,195,95,3,128,190,671
896,5,1984,28,1,1,78,78,2088,376,718,0.524,20,57,0.351,356,661,0.539,136,177,0.768,68,79,147,300,117,14,161,209,908
896,6,1985,29,1,1,79,78,2648,427,891,0.479,9,38,0.237,418,853,0.49,199,255,0.78,71,119,190,559,140,9,231,196,1062
896,7,1986,30,1,1,82,82,2568,434,900,0.482,18,52,0.346,416,848,0.491,185,223,0.83,89,98,187,487,138,11,184,230,1071
896,8,1987,31,1,1,6,6,155,25,50,0.5,0,3,0,25,47,0.532,17,18,0.944,6,3,9,32,6,0,15,17,67
896,8,1987,31,1,1,68,53,1890,273,624,0.438,19,74,0.257,254,550,0.462,173,212,0.816,44,122,166,439,95,11,157,191,738
896,8,1987,31,1,1,74,59,2045,298,674,0.442,19,77,0.247,279,597,0.467,190,230,0.826,50,125,175,471,101,11,172,208,805
896,9,1988,32,1,1,69,3,1436,189,439,0.431,67,159,0.421,122,280,0.436,136,168,0.81,26,71,97,218,67,5,125,173,581
896,9,1988,32,1,1,75,5,1505,194,453,0.428,69,163,0.423,125,290,0.431,138,170,0.812,27,80,107,231,69,5,133,187,595
896,10,1989,33,1,1,65,0,986,144,348,0.414,33,107,0.308,111,241,0.461,104,127,0.819,17,51,68,140,42,3,73,121,425
896,11,1990,34,1,1,11,0,129,11,26,0.423,3,7,0.429,8,19,0.421,2,2,1,3,9,12,13,8,0,8,14,27
896,11,1990,34,1,1,46,0,335,42,83,0.506,14,31,0.452,28,52,0.538,10,13,0.769,8,23,31,61,8,2,16,36,108
896,11,1990,34,1,1,57,0,464,53,109,0.486,17,38,0.447,36,71,0.507,12,15,0.8,11,32,43,74,16,2,24,50,135
896,12,1991,35,1,1,23,10,392,50,117,0.427,7,21,0.333,43,96,0.448,16,21,0.762,8,29,37,62,12,2,28,43,123
899,1,1986,25,1,2,28,0,149,31,67,0.463,4,10,0.4,27,57,0.474,12,17,0.706,8,11,19,4,5,0,9,11,78
900,1,1987,23,1,2,36,0,231,38,103,0.369,12,31,0.387,26,72,0.361,10,17,0.588,7,20,27,27,6,1,17,27,98
900,1,1987,23,1,2,54,0,323,46,136,0.338,13,42,0.31,33,94,0.351,17,27,0.63,7,27,34,35,9,1,26,34,122
900,2,1988,24,1,2,14,2,145,13,41,0.317,2,6,0.333,11,35,0.314,4,7,0.571,5,14,19,29,4,1,14,11,32
900,2,1988,24,1,2,15,0,207,38,81,0.469,15,31,0.484,23,50,0.46,26,30,0.867,6,14,20,26,7,3,16,15,117
900,2,1988,24,1,2,39,2,433,62,150,0.413,20,45,0.444,42,105,0.4,39,47,0.83,13,36,49,67,12,5,39,37,183
904,1,2000,24,1,1,45,1,597,45,124,0.363,24,67,0.358,21,57,0.368,27,40,0.675,12,40,52,111,15,2,42,74,141
904,2,2001,25,1,1,25,7,408,29,96,0.302,16,55,0.291,13,41,0.317,9,12,0.75,4,17,21,56,14,0,20,43,83
905,1,1992,25,1,4,43,7,566,83,161,0.516,0,1,0,83,160,0.519,25,44,0.568,33,66,99,27,16,25,37,60,191
905,2,1993,26,1,4,81,12,1800,240,444,0.541,0,2,0,240,442,0.543,125,176,0.71,148,306,454,61,47,35,92,190,605
905,3,1994,27,1,4,75,0,1292,142,310,0.458,0,0,-1,142,310,0.458,69,97,0.711,101,184,285,37,32,26,69,159,353
905,4,1995,28,1,4,61,26,1331,171,327,0.523,0,2,0,171,325,0.526,73,117,0.624,98,180,278,44,40,38,71,136,415
905,5,1996,29,1,4,44,6,393,40,97,0.412,0,1,0,40,96,0.417,5,17,0.294,30,51,81,16,9,8,29,61,85
905,6,1997,30,1,4,75,58,1837,257,593,0.433,2,6,0.333,255,587,0.434,81,118,0.686,118,222,340,50,62,53,95,217,597
905,7,1998,31,1,4,58,1,516,76,175,0.434,0,1,0,76,174,0.437,18,44,0.409,24,67,91,22,19,12,38,71,170
905,8,1999,32,1,4,24,0,265,27,63,0.429,0,1,0,27,62,0.435,5,9,0.556,20,34,54,1,12,7,12,38,59
905,8,1999,32,1,4,28,0,307,30,76,0.395,0,1,0,30,75,0.4,5,11,0.455,25,37,62,4,12,7,16,41,65
906,1,2007,27,1,4,48,12,936,174,330,0.527,53,115,0.461,121,215,0.563,41,53,0.774,28,111,139,26,17,7,32,76,442
906,2,2008,28,1,4,17,0,174,25,65,0.385,9,26,0.346,16,39,0.41,9,10,0.9,10,26,36,4,4,0,4,12,68
906,2,2008,28,1,4,28,0,199,31,79,0.392,11,38,0.289,20,41,0.488,12,15,0.8,12,25,37,14,3,1,8,12,85
906,2,2008,28,1,4,45,0,373,56,144,0.389,20,64,0.313,36,80,0.45,21,25,0.84,22,51,73,18,7,1,12,24,153
906,3,2009,29,1,3,59,0,630,82,207,0.396,41,120,0.342,41,87,0.471,19,25,0.76,28,79,107,22,7,4,17,43,224
913,1,2012,22,1,1,38,0,423,52,160,0.325,4,20,0.2,48,140,0.343,42,60,0.7,7,28,35,36,5,6,39,40,150
916,1,1983,23,1,3,82,42,2196,313,698,0.448,13,41,0.317,300,657,0.457,209,264,0.792,159,207,366,175,66,65,127,248,848
916,2,1984,24,1,3,78,6,1577,193,432,0.447,1,22,0.045,192,410,0.468,113,156,0.724,87,119,206,116,49,29,76,161,500
916,3,1985,25,1,3,68,5,942,119,270,0.441,10,37,0.27,109,233,0.468,60,90,0.667,55,92,147,73,21,13,49,91,308
916,4,1986,26,1,3,11,0,128,18,40,0.45,0,2,0,18,38,0.474,11,16,0.688,5,19,24,12,2,3,5,21,47
916,4,1986,26,1,3,30,0,332,39,106,0.368,1,9,0.111,38,97,0.392,19,27,0.704,14,37,51,24,9,11,13,49,98
916,5,1987,27,1,3,73,28,1497,214,412,0.519,3,17,0.176,211,395,0.534,200,240,0.833,72,165,237,96,40,21,76,145,631
916,6,1988,28,1,3,68,67,2188,381,725,0.526,19,39,0.487,362,686,0.528,273,322,0.848,94,199,293,188,70,31,111,188,1054
916,7,1989,29,1,4,81,1,1887,301,633,0.476,66,168,0.393,235,465,0.505,188,229,0.821,111,265,376,160,39,42,76,172,856
916,8,1990,30,1,4,82,22,1993,304,632,0.481,67,193,0.347,237,439,0.54,234,285,0.821,120,302,422,129,47,53,93,184,909
916,9,1991,31,1,3,82,9,2024,259,559,0.463,73,220,0.332,186,339,0.549,185,226,0.819,109,245,354,113,52,37,65,198,776
916,10,1992,32,1,3,25,6,535,87,211,0.412,33,95,0.347,54,116,0.466,48,59,0.814,30,55,85,22,15,13,15,75,255
916,11,1993,33,1,3,69,4,1425,199,483,0.412,43,133,0.323,156,350,0.446,130,151,0.861,66,127,193,119,51,29,63,141,571
916,12,1994,34,1,3,36,11,547,71,163,0.436,22,50,0.44,49,113,0.434,31,42,0.738,25,57,82,36,25,14,21,53,195
918,1,1980,26,1,1,79,-1,2092,177,431,0.411,1,4,0.25,176,427,0.412,124,146,0.849,31,107,138,424,107,8,171,261,479
918,2,1981,27,1,1,24,-1,624,39,116,0.336,0,1,0,39,115,0.339,42,50,0.84,10,41,51,118,26,3,58,60,120
918,2,1981,27,1,1,51,-1,1114,78,219,0.356,0,6,0,78,213,0.366,99,122,0.811,31,77,108,174,40,8,69,147,255
918,2,1981,27,1,1,75,-1,1738,117,335,0.349,0,7,0,117,328,0.357,141,172,0.82,41,118,159,292,66,11,127,207,375
918,3,1982,28,1,1,21,4,243,19,37,0.514,0,0,-1,19,37,0.514,17,23,0.739,6,19,25,25,5,2,14,37,55
918,3,1982,28,1,1,19,14,480,34,89,0.382,0,2,0,34,87,0.391,22,32,0.688,6,21,27,81,16,3,52,51,90
918,3,1982,28,1,1,40,18,723,53,126,0.421,0,2,0,53,124,0.427,39,55,0.709,12,40,52,106,21,5,66,88,145
918,4,1983,29,1,1,14,3,169,14,26,0.538,0,0,-1,14,26,0.538,18,22,0.818,5,15,20,27,9,0,13,20,46
918,5,1984,30,1,1,15,2,181,14,46,0.304,0,0,-1,14,46,0.304,17,21,0.81,2,8,10,35,7,0,14,30,45
924,1,1984,22,1,3,80,61,1858,184,371,0.496,0,0,-1,184,371,0.496,69,117,0.59,175,324,499,69,31,145,109,306,437
924,2,1985,23,1,4,76,75,2344,465,925,0.503,0,3,0,465,922,0.504,271,376,0.721,186,410,596,68,51,173,171,311,1201
924,3,1986,24,1,3,82,82,2834,621,1167,0.532,0,4,0,621,1163,0.534,364,506,0.719,167,472,639,102,62,112,188,316,1606
924,4,1987,25,1,3,76,58,2489,393,823,0.478,0,1,0,393,822,0.478,273,360,0.758,150,338,488,60,45,161,149,281,1059
924,5,1988,26,1,3,29,10,845,123,272,0.452,0,1,0,123,271,0.454,89,124,0.718,53,116,169,27,24,68,63,90,335
924,5,1988,26,1,3,48,47,1747,330,658,0.502,0,1,0,330,657,0.502,183,227,0.806,106,242,348,72,45,72,106,185,843
924,5,1988,26,1,3,77,57,2592,453,930,0.487,0,2,0,453,928,0.488,272,351,0.775,159,358,517,99,69,140,169,275,1178
924,6,1989,27,1,3,82,39,2542,495,1027,0.482,0,2,0,495,1025,0.483,318,420,0.757,152,370,522,71,34,121,165,298,1308
924,7,1990,28,1,4,25,19,793,145,286,0.507,0,0,-1,145,286,0.507,86,99,0.869,61,111,172,22,14,27,52,87,376
927,1,2007,23,1,2,12,0,136,19,60,0.317,5,23,0.217,14,37,0.378,8,12,0.667,4,12,16,8,3,2,6,8,51
929,1,1992,22,1,4,51,27,1058,163,328,0.497,0,0,-1,163,328,0.497,100,150,0.667,118,157,275,39,25,23,75,128,426
929,2,1993,23,1,5,79,8,1267,161,400,0.403,0,0,-1,161,400,0.403,71,104,0.683,93,201,294,75,33,37,90,204,393
929,3,1994,24,1,5,50,0,428,46,101,0.455,0,0,-1,46,101,0.455,44,52,0.846,46,49,95,32,15,13,30,66,136
929,4,1995,25,1,5,54,0,633,83,204,0.407,4,14,0.286,79,190,0.416,39,51,0.765,40,82,122,41,10,14,39,107,209
929,5,1996,26,1,5,13,0,113,9,24,0.375,0,0,-1,9,24,0.375,0,0,-1,9,13,22,4,1,8,2,26,18
929,5,1996,26,1,5,15,0,115,9,24,0.375,0,0,-1,9,24,0.375,0,0,-1,9,14,23,4,1,8,2,26,18
930,1,1991,22,1,4,74,22,1192,147,299,0.492,0,0,-1,147,299,0.492,96,152,0.632,157,226,383,19,33,30,72,264,390
930,2,1992,23,1,5,82,75,1886,254,487,0.522,0,1,0,254,486,0.523,163,235,0.694,182,411,593,47,73,43,106,315,671
930,3,1993,24,1,5,74,66,2070,251,494,0.508,0,4,0,251,490,0.512,138,221,0.624,255,499,754,68,41,40,92,320,640
930,4,1994,25,1,4,57,20,1447,216,398,0.543,0,2,0,216,396,0.545,171,256,0.668,184,315,499,46,53,35,78,193,603
930,5,1995,26,1,5,70,67,2397,350,694,0.504,0,1,0,350,693,0.505,263,397,0.662,269,496,765,55,55,41,151,245,963
930,6,1996,27,1,4,44,2,929,130,254,0.512,0,0,-1,130,254,0.512,81,135,0.6,94,150,244,33,31,20,64,144,341
930,7,1997,28,1,5,74,70,2582,357,595,0.6,0,1,0,357,594,0.601,241,381,0.633,259,477,736,92,63,30,147,268,955
930,8,1998,29,1,4,57,56,2064,208,418,0.498,0,1,0,208,417,0.499,155,255,0.608,212,396,608,88,67,30,106,230,571
930,9,1999,30,1,4,17,17,517,50,118,0.424,0,0,-1,50,118,0.424,46,81,0.568,51,83,134,17,18,8,24,68,146
930,9,1999,30,1,4,21,6,587,72,150,0.48,0,0,-1,72,150,0.48,35,69,0.507,64,89,153,18,16,8,35,77,179
930,9,1999,30,1,4,38,23,1104,122,268,0.455,0,0,-1,122,268,0.455,81,150,0.54,115,172,287,35,34,16,59,145,325
930,10,2000,31,1,4,68,65,2155,318,656,0.485,0,1,0,318,655,0.485,179,259,0.691,220,405,625,52,64,27,124,243,815
930,11,2001,32,1,4,76,75,2363,278,587,0.474,0,1,0,278,586,0.474,172,273,0.63,239,448,687,48,37,27,127,242,728
930,12,2002,33,1,4,26,26,810,71,182,0.39,0,1,0,71,181,0.392,67,103,0.65,79,195,274,23,17,13,48,102,209
930,13,2003,34,1,4,24,18,496,44,109,0.404,0,0,-1,44,109,0.404,21,35,0.6,56,68,124,9,15,7,16,68,109
930,13,2003,34,1,4,32,25,855,85,197,0.431,0,0,-1,85,197,0.431,33,45,0.733,70,197,267,32,31,19,52,104,203
930,13,2003,34,1,4,56,43,1351,129,306,0.422,0,0,-1,129,306,0.422,54,80,0.675,126,265,391,41,46,26,68,172,312
931,1,1980,30,1,4,49,-1,708,82,179,0.458,0,0,-1,82,179,0.458,34,68,0.5,59,121,180,47,21,24,59,128,198
933,1,1983,22,1,2,76,48,2022,318,704,0.452,20,90,0.222,298,614,0.485,94,130,0.723,53,69,122,275,82,4,161,192,750
933,2,1984,23,1,2,76,28,1571,258,573,0.45,10,46,0.217,248,527,0.471,66,88,0.75,22,64,86,116,58,1,85,166,592
933,3,1985,24,1,2,82,63,2496,359,732,0.49,47,135,0.348,312,597,0.523,106,130,0.815,74,112,186,349,96,1,135,262,871
933,4,1986,25,1,2,66,66,1739,284,568,0.5,73,162,0.451,211,406,0.52,75,86,0.872,39,78,117,229,74,2,89,157,716
933,5,1987,26,1,1,78,43,2147,315,682,0.462,85,228,0.373,230,454,0.507,131,147,0.891,48,92,140,240,76,7,124,189,846
933,6,1988,27,1,2,23,0,462,87,178,0.489,31,57,0.544,56,121,0.463,27,32,0.844,7,25,32,44,16,2,28,38,232
933,6,1988,27,1,2,43,0,983,155,345,0.449,55,118,0.466,100,227,0.441,32,39,0.821,12,34,46,109,30,0,49,80,397
933,6,1988,27,1,2,66,0,1445,242,523,0.463,86,175,0.491,156,348,0.448,59,71,0.831,19,59,78,153,46,2,77,118,629
933,7,1989,28,1,2,49,6,1112,187,394,0.475,71,168,0.423,116,226,0.513,45,53,0.849,21,63,84,138,41,4,52,82,490
933,7,1989,28,1,2,59,6,1204,203,430,0.472,75,180,0.417,128,250,0.512,48,57,0.842,23,66,89,146,43,4,57,90,529
933,8,1990,29,1,2,63,0,1055,145,331,0.438,87,181,0.481,58,150,0.387,30,33,0.909,11,42,53,110,30,2,30,87,407
933,9,1991,30,1,2,73,0,843,146,344,0.424,44,115,0.383,102,229,0.445,26,27,0.963,10,32,42,97,34,2,35,74,362
933,10,1992,31,1,2,56,2,555,93,242,0.384,36,96,0.375,57,146,0.39,16,17,0.941,7,17,24,54,14,1,22,33,238
937,1,1997,24,1,2,47,0,572,67,156,0.429,29,70,0.414,38,86,0.442,61,77,0.792,13,68,81,41,27,6,22,51,224
937,2,1998,25,1,2,65,1,874,85,222,0.383,32,85,0.376,53,137,0.387,59,69,0.855,14,109,123,45,40,3,22,101,261
937,3,2000,27,1,2,31,11,845,89,230,0.387,32,94,0.34,57,136,0.419,69,76,0.908,7,103,110,85,40,2,43,66,279
937,4,2001,28,1,2,74,37,2247,217,495,0.438,103,250,0.412,114,245,0.465,136,157,0.866,21,287,308,263,98,12,74,155,673
937,5,2002,29,1,2,79,8,1408,121,291,0.416,24,92,0.261,97,199,0.487,79,94,0.84,18,192,210,136,61,5,32,87,345
937,6,2003,30,1,2,63,0,784,49,126,0.389,5,21,0.238,44,105,0.419,41,50,0.82,11,126,137,70,40,5,25,59,144
937,7,2004,31,1,2,79,3,1804,178,383,0.465,76,172,0.442,102,211,0.483,98,116,0.845,21,247,268,109,66,10,44,136,530
937,8,2005,32,1,2,76,0,1272,139,284,0.489,70,145,0.483,69,139,0.496,89,102,0.873,32,149,181,85,50,15,20,105,437
943,1,1980,23,1,2,38,-1,197,44,104,0.423,3,15,0.2,41,89,0.461,15,16,0.938,4,13,17,22,15,1,13,24,106
943,2,1981,24,1,2,41,-1,295,47,111,0.423,1,3,0.333,46,108,0.426,35,49,0.714,9,20,29,23,21,1,31,44,130
943,3,1982,25,1,2,13,3,185,27,73,0.37,0,3,0,27,70,0.386,3,4,0.75,6,7,13,16,11,1,7,12,57
943,3,1982,25,1,2,14,3,194,27,78,0.346,0,3,0,27,75,0.36,3,6,0.5,6,7,13,18,11,1,8,13,57
945,1,1980,26,1,1,20,-1,413,82,213,0.385,1,10,0.1,81,203,0.399,34,53,0.642,5,15,20,50,30,1,60,35,199
945,1,1980,26,1,2,27,-1,796,130,313,0.415,2,10,0.2,128,303,0.422,67,87,0.77,24,45,69,112,46,9,68,68,329
945,1,1980,26,1,2,47,-1,1209,212,526,0.403,3,20,0.15,209,506,0.413,101,140,0.721,29,60,89,162,76,10,128,103,528
945,2,1981,27,1,1,82,-1,2154,327,696,0.47,2,15,0.133,325,681,0.477,125,171,0.731,47,144,191,352,104,18,207,205,781
945,3,1982,28,1,1,81,81,2257,380,797,0.477,2,16,0.125,378,781,0.484,132,188,0.702,35,152,187,316,103,20,146,198,894
945,4,1983,29,1,1,56,54,1844,313,717,0.437,3,21,0.143,310,696,0.445,129,179,0.721,30,98,128,373,111,14,198,155,758
945,5,1984,30,1,1,32,0,216,24,63,0.381,0,2,0,24,61,0.393,11,13,0.846,4,18,22,62,13,1,24,26,59
945,6,1985,31,1,1,80,60,1950,249,540,0.461,3,13,0.231,246,527,0.467,108,136,0.794,33,140,173,417,78,10,170,187,609
946,1,1985,23,1,2,74,59,1761,257,576,0.446,14,45,0.311,243,531,0.458,96,118,0.814,30,102,132,198,59,6,123,141,624
946,2,1986,24,1,1,24,0,447,73,155,0.471,1,10,0.1,72,145,0.497,24,38,0.632,10,20,30,48,23,0,23,40,171
946,2,1986,24,1,1,28,0,512,77,175,0.44,1,12,0.083,76,163,0.466,28,44,0.636,11,22,33,55,25,0,27,47,183
946,3,1987,25,1,1,58,1,479,70,171,0.409,7,23,0.304,63,148,0.426,44,55,0.8,9,29,38,73,16,2,41,51,191
946,4,1988,26,1,1,82,2,1279,163,353,0.462,3,15,0.2,160,338,0.473,107,129,0.829,50,99,149,211,41,10,86,154,436
946,5,1989,27,1,1,67,60,1696,215,504,0.427,3,14,0.214,212,490,0.433,120,143,0.839,30,75,105,424,66,12,119,165,553
946,6,1990,28,1,1,16,0,109,14,26,0.538,0,0,-1,14,26,0.538,1,2,0.5,1,1,2,16,1,0,13,19,29
952,1,1998,23,1,4,38,0,530,90,221,0.407,29,77,0.377,61,144,0.424,36,58,0.621,27,66,93,33,20,6,49,83,245
952,2,1999,24,1,4,16,0,102,9,32,0.281,5,17,0.294,4,15,0.267,7,10,0.7,3,9,12,3,5,2,9,16,30
958,1,1988,23,1,5,36,8,607,80,172,0.465,0,1,0,80,171,0.468,51,59,0.864,54,113,167,30,13,6,35,84,211
958,1,1988,23,1,5,39,8,642,84,183,0.459,0,1,0,84,182,0.462,54,62,0.871,58,116,174,32,13,6,37,87,222
958,2,1989,24,1,5,77,36,1419,199,353,0.564,1,2,0.5,198,351,0.564,101,139,0.727,123,261,384,57,25,21,77,239,500
958,3,1990,25,1,5,10,2,135,16,41,0.39,0,0,-1,16,41,0.39,8,10,0.8,19,17,36,6,2,1,8,26,40
958,4,1991,26,1,5,19,0,112,18,32,0.563,0,1,0,18,31,0.581,8,10,0.8,14,16,30,3,2,1,12,18,44
958,4,1991,26,1,5,30,0,155,24,44,0.545,0,2,0,24,42,0.571,16,22,0.727,18,21,39,3,3,1,13,29,64
960,1,1988,22,1,2,61,19,1365,222,549,0.404,12,45,0.267,210,504,0.417,131,177,0.74,63,80,143,118,57,25,119,145,587
960,2,1989,23,1,2,62,36,1551,299,714,0.419,4,27,0.148,295,687,0.429,186,219,0.849,91,111,202,103,70,30,102,150,788
960,3,1990,24,1,2,79,64,2551,474,1093,0.434,32,101,0.317,442,992,0.446,271,342,0.792,113,166,279,151,100,51,168,183,1251
960,4,1991,25,1,3,61,0,728,104,244,0.426,1,5,0.2,103,239,0.431,55,83,0.663,49,60,109,65,25,14,59,79,264
960,5,1992,26,1,2,69,0,1304,275,591,0.465,12,47,0.255,263,544,0.483,179,253,0.708,105,101,206,102,66,39,100,113,741
960,5,1992,26,1,2,71,0,1314,276,593,0.465,12,47,0.255,264,546,0.484,179,253,0.708,105,101,206,102,67,39,100,115,743
961,1,1981,24,1,4,68,-1,1599,221,480,0.46,0,3,0,221,477,0.463,130,186,0.699,120,338,458,104,33,19,120,226,572
961,2,1982,25,1,4,77,1,1372,204,414,0.493,3,13,0.231,201,401,0.501,116,199,0.583,119,276,395,65,26,19,111,230,527
962,1,1990,22,1,4,45,10,374,80,162,0.494,0,4,0,80,158,0.506,42,69,0.609,59,49,108,19,9,5,39,63,202
966,1,1987,23,1,2,80,3,1561,159,350,0.454,12,43,0.279,147,307,0.479,94,121,0.777,41,143,184,361,70,5,153,130,424
966,2,1988,24,1,2,82,49,2243,306,605,0.506,17,58,0.293,289,547,0.528,152,185,0.822,71,191,262,540,107,10,156,151,781
966,3,1989,25,1,2,78,73,2487,440,889,0.495,27,81,0.333,413,808,0.511,147,178,0.826,75,191,266,465,129,8,111,188,1054
966,4,1990,26,1,2,67,60,2278,483,901,0.536,40,98,0.408,443,803,0.552,173,202,0.856,86,227,313,337,117,14,125,144,1179
966,5,1991,27,1,2,80,77,2733,544,1051,0.518,61,146,0.418,483,905,0.534,201,224,0.897,74,247,321,409,111,16,130,185,1350
966,6,1992,28,1,2,81,81,3078,635,1240,0.512,83,189,0.439,552,1051,0.525,279,315,0.886,106,301,407,411,158,31,170,218,1632
966,7,1993,29,1,2,79,78,2860,582,1239,0.47,97,249,0.39,485,990,0.49,250,289,0.865,84,258,342,548,131,21,222,203,1511
966,8,1994,30,1,2,27,9,826,147,289,0.509,18,42,0.429,129,247,0.522,82,92,0.891,19,48,67,104,32,3,33,71,394
966,8,1994,30,1,2,53,53,1994,325,715,0.455,52,166,0.313,273,549,0.497,178,204,0.873,41,171,212,315,95,10,138,115,880
966,8,1994,30,1,2,80,62,2820,472,1004,0.47,70,208,0.337,402,796,0.505,260,296,0.878,60,219,279,419,127,13,171,186,1274
966,9,1995,31,1,2,81,81,2696,482,937,0.514,89,219,0.406,393,718,0.547,284,322,0.882,53,157,210,347,129,17,145,181,1337
966,10,1996,32,1,2,82,59,2588,442,880,0.502,104,223,0.466,338,657,0.514,259,290,0.893,62,147,209,340,106,20,127,171,1247
966,11,1997,33,1,2,82,82,2592,413,856,0.482,72,195,0.369,341,661,0.516,293,326,0.899,60,181,241,361,124,26,134,188,1191
966,12,1998,34,1,2,80,80,2460,399,828,0.482,56,127,0.441,343,701,0.489,285,322,0.885,65,205,270,349,109,15,132,175,1139
966,13,1999,35,1,2,48,48,1435,214,449,0.477,34,81,0.42,180,368,0.489,125,140,0.893,33,127,160,192,52,14,82,95,587
966,14,2000,36,1,2,77,77,2133,358,728,0.492,66,138,0.478,292,590,0.495,171,180,0.95,49,133,182,202,66,16,113,149,953
967,1,1993,22,1,3,79,79,2330,323,682,0.474,12,47,0.255,311,635,0.49,143,200,0.715,113,279,392,191,80,83,156,210,801
967,2,1994,23,1,3,81,81,2370,322,702,0.459,44,136,0.324,278,566,0.491,115,157,0.732,128,312,440,231,119,75,137,186,803
967,3,1995,24,1,4,64,61,2074,240,537,0.447,86,227,0.379,154,310,0.497,86,113,0.761,81,243,324,216,94,76,122,161,652
967,4,1996,25,1,3,71,71,2634,300,732,0.41,142,388,0.366,158,344,0.459,111,143,0.776,97,315,412,281,116,109,160,197,853
967,5,1997,26,1,3,22,14,676,75,165,0.455,25,76,0.329,50,89,0.562,28,40,0.7,28,90,118,56,38,29,26,72,203
967,5,1997,26,1,3,32,15,719,82,195,0.421,24,78,0.308,58,117,0.496,32,50,0.64,40,79,119,54,28,26,46,81,220
967,5,1997,26,1,3,54,29,1395,157,360,0.436,49,154,0.318,108,206,0.524,60,90,0.667,68,169,237,110,66,55,72,153,423
967,6,1998,27,1,4,72,71,2192,200,420,0.476,19,93,0.204,181,327,0.554,117,169,0.692,186,356,542,163,112,94,99,238,536
967,7,1999,28,1,4,38,5,744,67,146,0.459,20,45,0.444,47,101,0.465,34,46,0.739,56,96,152,56,36,39,49,103,188
967,8,2000,29,1,4,76,0,1685,159,363,0.438,29,94,0.309,130,269,0.483,89,113,0.788,133,228,361,118,84,80,73,189,436
967,9,2001,30,1,4,79,1,1587,147,380,0.387,54,156,0.346,93,224,0.415,59,83,0.711,93,203,296,128,54,54,79,210,407
967,10,2002,31,1,4,81,23,2140,183,460,0.398,76,203,0.374,107,257,0.416,108,138,0.783,130,349,479,232,77,89,88,208,550
967,11,2003,32,1,4,80,26,2343,184,476,0.387,51,177,0.288,133,299,0.445,103,134,0.769,181,333,514,233,96,61,112,247,522
967,12,2004,33,1,4,81,1,1290,141,348,0.405,41,108,0.38,100,240,0.417,69,107,0.645,108,164,272,101,48,49,55,165,392
967,13,2005,34,1,4,75,16,1396,157,375,0.419,51,138,0.37,106,237,0.447,86,109,0.789,91,177,268,80,67,60,69,138,451
967,14,2006,35,1,4,63,3,1182,112,292,0.384,53,144,0.368,59,148,0.399,44,68,0.647,71,171,242,79,43,51,41,115,321
967,15,2007,36,1,4,68,8,1124,90,251,0.359,50,149,0.336,40,102,0.392,38,64,0.594,73,156,229,77,45,41,44,105,268
967,16,2008,37,1,4,45,5,583,38,119,0.319,18,70,0.257,20,49,0.408,18,28,0.643,35,74,109,47,21,19,22,55,112
968,1,2001,22,1,1,50,0,550,104,247,0.421,19,55,0.345,85,192,0.443,24,35,0.686,5,37,42,52,13,0,35,58,251
968,2,2002,23,1,1,64,3,1230,209,524,0.399,54,157,0.344,155,367,0.422,42,49,0.857,17,93,110,123,43,5,80,98,514
968,3,2003,24,1,2,55,7,1025,172,444,0.387,36,120,0.3,136,324,0.42,31,36,0.861,17,84,101,87,44,1,46,73,411
968,4,2004,25,1,2,60,10,1188,161,449,0.359,51,136,0.375,110,313,0.351,36,45,0.8,28,110,138,148,65,4,63,92,409
968,5,2005,26,1,2,13,5,300,61,135,0.452,12,29,0.414,49,106,0.462,10,13,0.769,2,17,19,24,24,3,13,23,144
968,5,2005,26,1,1,50,2,550,98,214,0.458,28,62,0.452,70,152,0.461,13,14,0.929,14,47,61,67,18,3,22,39,237
968,5,2005,26,1,1,68,7,891,165,366,0.451,44,97,0.454,121,269,0.45,23,27,0.852,16,67,83,96,44,6,35,65,397
968,6,2006,27,1,1,81,0,1421,320,759,0.422,123,316,0.389,197,443,0.445,33,41,0.805,15,117,132,148,42,12,76,96,796
968,7,2007,28,1,2,56,1,946,180,421,0.428,75,175,0.429,105,246,0.427,33,36,0.917,14,78,92,67,27,3,27,69,468
968,8,2008,29,1,1,78,2,1480,217,531,0.409,117,298,0.393,100,233,0.429,33,36,0.917,19,148,167,152,59,10,76,114,584
968,9,2009,30,1,1,81,0,1479,249,560,0.445,151,340,0.444,98,220,0.445,42,53,0.792,11,146,157,92,61,7,55,113,691
968,10,2010,31,1,2,18,0,371,44,133,0.331,15,60,0.25,29,73,0.397,12,12,1,6,34,40,37,12,0,20,20,115
968,10,2010,31,1,1,50,0,846,129,322,0.401,64,167,0.383,65,155,0.419,36,40,0.9,7,62,69,48,28,7,27,61,358
968,10,2010,31,1,1,68,0,1217,173,455,0.38,79,227,0.348,94,228,0.412,48,52,0.923,13,96,109,85,40,7,47,81,473
968,11,2011,32,1,2,56,1,978,128,321,0.399,68,175,0.389,60,146,0.411,38,40,0.95,9,83,92,62,32,3,29,68,362
969,1,1994,22,1,2,79,20,1519,272,671,0.405,35,117,0.299,237,554,0.428,89,108,0.824,19,101,120,100,34,13,99,165,668
969,2,1995,23,1,2,76,39,1996,398,859,0.463,158,373,0.424,240,486,0.494,147,171,0.86,29,138,167,164,61,14,113,182,1101
969,3,1996,24,1,2,82,75,3072,564,1244,0.453,191,447,0.427,373,797,0.468,298,362,0.823,54,246,300,250,61,16,233,233,1617
969,4,1997,25,1,2,81,81,2681,437,1032,0.423,148,384,0.385,289,648,0.446,175,218,0.803,43,197,240,179,41,18,167,233,1197
969,5,1998,26,1,2,82,82,2848,571,1277,0.447,82,213,0.385,489,1064,0.46,285,335,0.851,43,231,274,212,63,24,200,207,1509
969,6,1999,27,1,2,50,50,1815,294,703,0.418,57,140,0.407,237,563,0.421,168,195,0.862,20,132,152,137,35,9,130,115,813
969,7,2000,28,1,2,82,82,3169,614,1271,0.483,106,243,0.436,508,1028,0.494,280,334,0.838,38,233,271,224,65,14,186,219,1614
969,8,2001,29,1,2,78,78,2858,542,1208,0.449,96,252,0.381,446,956,0.467,279,307,0.909,20,263,283,173,52,10,161,190,1459
969,9,2002,30,1,2,77,77,2914,568,1301,0.437,136,346,0.393,432,955,0.452,295,339,0.87,37,215,252,190,54,10,170,182,1567
969,10,2003,31,1,2,82,82,3108,652,1465,0.445,178,450,0.396,474,1015,0.467,363,395,0.919,26,205,231,220,54,7,178,191,1845
969,11,2004,32,1,2,50,50,1799,340,781,0.435,87,202,0.431,253,579,0.437,157,172,0.913,20,101,121,99,38,2,102,105,924
969,12,2005,33,1,2,20,11,532,85,205,0.415,31,80,0.388,54,125,0.432,36,43,0.837,4,19,23,42,8,2,21,40,237
970,1,1993,23,1,2,79,8,1274,145,325,0.446,2,7,0.286,143,318,0.45,129,194,0.665,119,196,315,69,44,43,87,253,421
970,2,1994,24,1,3,71,2,866,81,177,0.458,1,7,0.143,80,170,0.471,33,54,0.611,67,127,194,32,33,31,49,181,196
970,3,1995,25,1,3,39,0,258,49,107,0.458,6,22,0.273,43,85,0.506,28,38,0.737,20,35,55,6,13,5,20,50,132
970,4,1996,26,1,3,25,0,276,32,64,0.5,1,3,0.333,31,61,0.508,21,26,0.808,31,53,84,7,13,7,17,59,86
972,1,1992,24,1,3,27,0,318,54,104,0.519,1,2,0.5,53,102,0.52,22,31,0.71,17,34,51,14,11,8,15,55,131
972,2,1993,25,1,3,68,22,1295,183,414,0.442,1,7,0.143,182,407,0.447,72,94,0.766,66,146,212,67,55,34,68,217,439
977,1,1995,21,1,4,65,52,2348,455,931,0.489,0,7,0,455,924,0.492,194,292,0.664,184,361,545,165,52,15,166,236,1104
977,2,1996,22,1,4,81,81,3294,733,1500,0.489,4,13,0.308,729,1487,0.49,319,426,0.749,188,472,660,360,67,39,303,269,1789
977,3,1997,23,1,3,82,82,3324,638,1313,0.486,0,2,0,638,1311,0.487,294,389,0.756,202,450,652,311,93,23,246,259,1570
977,4,1998,24,1,4,64,64,2559,463,991,0.467,0,2,0,463,989,0.468,258,358,0.721,161,288,449,208,82,23,185,225,1184
977,5,1999,25,1,3,36,36,1430,286,604,0.474,0,3,0,286,601,0.476,110,146,0.753,90,203,293,107,42,14,95,130,682
977,6,2000,26,1,4,82,82,2909,509,1108,0.459,0,7,0,509,1101,0.462,202,275,0.735,132,338,470,247,67,21,225,299,1220
977,7,2001,27,1,4,27,27,993,191,391,0.488,0,3,0,191,388,0.492,99,127,0.78,50,143,193,70,29,16,73,106,481
977,7,2001,27,1,4,54,54,1981,392,827,0.474,0,0,-1,392,827,0.474,197,256,0.77,121,258,379,154,46,21,169,186,981
977,7,2001,27,1,4,81,81,2974,583,1218,0.479,0,3,0,583,1215,0.48,296,383,0.773,171,401,572,224,75,37,242,292,1462
977,8,2002,28,1,4,28,28,976,192,420,0.457,0,1,0,192,419,0.458,117,152,0.77,85,137,222,76,18,17,74,95,501
977,8,2002,28,1,4,53,44,1659,270,585,0.462,0,1,0,270,584,0.462,144,191,0.754,138,252,390,93,28,30,78,170,684
977,8,2002,28,1,4,81,72,2635,462,1005,0.46,0,2,0,462,1003,0.461,261,343,0.761,223,389,612,169,46,47,152,265,1185
977,9,2003,29,1,4,77,77,2730,567,1261,0.45,2,4,0.5,565,1257,0.449,282,351,0.803,181,404,585,234,77,27,189,239,1418
977,10,2004,30,1,4,81,77,2877,529,1169,0.453,0,1,0,529,1168,0.453,318,393,0.809,171,399,570,158,54,22,178,284,1376
977,11,2005,31,1,4,61,47,1624,244,541,0.451,0,1,0,244,540,0.452,97,115,0.843,126,220,346,94,32,5,79,143,585
977,12,2006,32,1,4,80,80,2537,394,859,0.459,0,4,0,394,855,0.461,154,191,0.806,168,367,535,112,49,8,133,235,942
977,13,2007,33,1,4,80,38,2123,309,665,0.465,0,0,-1,309,665,0.465,155,188,0.824,138,332,470,131,29,8,112,205,773
977,14,2008,34,1,4,50,0,353,23,64,0.359,0,0,-1,23,64,0.359,11,14,0.786,21,60,81,17,5,2,17,62,57
977,15,2009,35,1,3,39,2,450,74,145,0.51,0,0,-1,74,145,0.51,23,34,0.676,29,43,72,24,6,5,26,67,171
977,15,2009,35,1,3,42,2,472,75,147,0.51,0,0,-1,75,147,0.51,23,34,0.676,30,46,76,26,7,6,26,71,173
977,16,2010,36,1,5,73,27,1632,191,375,0.509,0,1,0,191,374,0.511,55,70,0.786,108,227,335,61,27,10,72,191,437
977,17,2011,37,1,4,57,0,592,55,125,0.44,0,0,-1,55,125,0.44,29,35,0.829,36,86,122,23,10,4,25,61,139
977,18,2012,38,1,4,28,0,190,17,55,0.309,0,0,-1,17,55,0.309,8,10,0.8,18,29,47,10,4,1,20,18,42
979,1,1980,23,1,4,64,-1,1189,210,451,0.466,0,2,0,210,449,0.468,165,220,0.75,114,206,320,70,48,10,120,202,585
979,2,1981,24,1,4,80,-1,2289,433,880,0.492,1,3,0.333,432,877,0.493,294,426,0.69,236,350,586,150,80,20,229,317,1161
979,3,1982,25,1,3,31,2,735,119,255,0.467,0,1,0,119,254,0.469,85,117,0.726,86,115,201,24,27,3,62,116,323
979,3,1982,25,1,3,52,38,1104,207,410,0.505,0,3,0,207,407,0.509,106,163,0.65,101,171,272,67,38,16,99,176,520
979,3,1982,25,1,3,83,40,1839,326,665,0.49,0,4,0,326,661,0.493,191,280,0.682,187,286,473,91,65,19,161,292,843
979,4,1983,26,1,3,82,38,1953,288,597,0.482,0,2,0,288,595,0.484,204,296,0.689,222,249,471,89,87,8,158,271,780
979,5,1984,27,1,3,80,6,1799,321,628,0.511,0,1,0,321,627,0.512,221,299,0.739,172,208,380,86,71,6,115,244,863
979,6,1985,28,1,3,76,55,2249,415,822,0.505,0,4,0,415,818,0.507,371,494,0.751,214,265,479,114,81,9,178,258,1201
979,7,1986,29,1,3,23,21,640,93,198,0.47,0,1,0,93,197,0.472,76,112,0.679,48,72,120,29,20,3,66,78,262
979,8,1987,30,1,3,68,68,2083,321,605,0.531,0,4,0,321,601,0.534,162,272,0.596,178,210,388,136,66,7,156,224,804
979,9,1988,31,1,3,78,59,1631,237,485,0.489,0,5,0,237,480,0.494,182,243,0.749,117,164,281,81,50,7,118,167,656
979,10,1989,32,1,3,31,0,191,28,63,0.444,0,0,-1,28,63,0.444,17,25,0.68,14,26,40,11,6,0,9,20,73
981,1,1999,22,1,1,25,6,524,60,150,0.4,15,47,0.319,45,103,0.437,34,38,0.895,15,40,55,92,11,2,38,28,169
981,2,2000,23,1,1,62,38,1592,204,541,0.377,60,193,0.311,144,348,0.414,77,95,0.811,28,120,148,242,43,0,108,65,545
981,3,2001,24,1,1,75,7,1008,125,372,0.336,22,109,0.202,103,263,0.392,85,104,0.817,38,67,105,162,37,3,92,82,357
981,4,2002,25,1,1,81,4,1854,354,815,0.434,66,187,0.353,288,628,0.459,176,201,0.876,30,115,145,255,57,6,163,119,950
981,5,2003,26,1,1,79,74,2600,409,956,0.428,97,266,0.365,312,690,0.452,208,231,0.9,42,141,183,452,60,7,182,160,1123
981,6,2004,27,1,1,29,1,503,80,207,0.386,31,77,0.403,49,130,0.377,27,33,0.818,4,31,35,70,7,0,34,32,218
981,7,2005,28,1,1,79,32,1729,266,664,0.401,89,258,0.345,177,406,0.436,70,90,0.778,19,86,105,283,27,6,113,121,691
981,8,2006,29,1,1,36,0,800,127,333,0.381,40,101,0.396,87,232,0.375,48,52,0.923,8,36,44,106,12,4,40,55,342
981,9,2007,30,1,1,34,6,554,74,195,0.379,28,80,0.35,46,115,0.4,26,32,0.813,8,40,48,73,14,2,40,23,202
983,1,1986,23,1,2,68,0,866,152,372,0.409,3,17,0.176,149,355,0.42,49,84,0.583,49,64,113,61,26,5,63,79,356
984,1,2000,26,1,4,21,0,224,35,72,0.486,0,1,0,35,71,0.493,12,26,0.462,24,25,49,9,3,1,14,30,82
985,1,1989,28,1,1,26,1,224,28,64,0.438,7,22,0.318,21,42,0.5,7,12,0.583,6,13,19,35,17,2,11,30,70
985,2,1990,29,1,1,60,7,892,83,202,0.411,20,49,0.408,63,153,0.412,23,34,0.676,15,55,70,116,48,1,39,87,209
986,1,1980,27,1,5,70,-1,1208,102,202,0.505,0,0,-1,102,202,0.505,15,41,0.366,125,201,326,74,66,77,50,184,219
986,2,1981,28,1,5,8,-1,159,11,25,0.44,0,0,-1,11,25,0.44,1,2,0.5,19,31,50,11,11,14,11,33,23
986,2,1981,28,1,5,45,-1,331,16,45,0.356,0,0,-1,16,45,0.356,0,0,-1,29,48,77,24,17,21,33,73,32
986,2,1981,28,1,5,53,-1,490,27,70,0.386,0,0,-1,27,70,0.386,1,2,0.5,48,79,127,35,28,35,44,106,55
987,1,2003,23,1,4,13,0,122,12,35,0.343,0,0,-1,12,35,0.343,5,11,0.455,4,26,30,4,5,2,2,18,29
987,1,2003,23,1,4,35,1,322,23,85,0.271,0,0,-1,23,85,0.271,18,28,0.643,30,39,69,7,4,16,21,57,64
987,1,2003,23,1,4,48,1,444,35,120,0.292,0,0,-1,35,120,0.292,23,39,0.59,34,65,99,11,9,18,23,75,93
987,2,2005,25,1,3,35,0,317,42,103,0.408,0,2,0,42,101,0.416,18,37,0.486,50,37,87,6,10,1,23,35,102
989,1,2004,23,1,4,36,12,406,53,116,0.457,0,3,0,53,113,0.469,19,43,0.442,50,68,118,19,13,1,22,40,125
989,2,2005,24,1,4,31,0,224,37,73,0.507,0,0,-1,37,73,0.507,21,39,0.538,25,44,69,3,4,7,22,42,95
990,1,1985,22,1,2,80,39,2062,279,626,0.446,4,20,0.2,275,606,0.454,141,170,0.829,32,132,164,350,107,8,167,209,703
990,2,1986,23,1,1,82,82,2733,352,735,0.479,4,29,0.138,348,706,0.493,197,257,0.767,56,204,260,526,132,9,190,222,905
990,3,1987,24,1,1,82,82,2579,359,753,0.477,5,27,0.185,354,726,0.488,200,260,0.769,62,198,260,632,112,9,195,239,923
990,4,1988,25,1,1,18,0,252,20,54,0.37,0,2,0,20,52,0.385,9,14,0.643,5,18,23,41,20,1,19,23,49
990,4,1988,25,1,1,50,33,1557,264,484,0.545,3,16,0.188,261,468,0.558,103,139,0.741,44,107,151,354,61,4,108,154,634
990,4,1988,25,1,1,68,33,1809,284,538,0.528,3,18,0.167,281,520,0.54,112,153,0.732,49,125,174,395,81,5,127,177,683
990,5,1989,26,1,1,73,50,2220,345,714,0.483,25,94,0.266,320,620,0.516,129,158,0.816,70,119,189,405,142,5,160,187,844
990,6,1990,27,1,1,81,81,2818,496,1005,0.494,21,70,0.3,475,935,0.508,224,285,0.786,80,189,269,472,156,11,151,253,1237
990,7,1991,28,1,1,80,80,2726,482,960,0.502,60,161,0.373,422,799,0.528,191,239,0.799,57,163,220,538,129,7,151,237,1215
990,8,1992,29,1,1,71,71,2261,377,803,0.469,42,144,0.292,335,659,0.508,195,249,0.783,44,140,184,466,119,13,148,210,991
990,9,1993,30,1,2,78,20,2034,287,659,0.436,15,75,0.2,272,584,0.466,101,130,0.777,40,103,143,317,101,11,132,236,690
990,10,1994,31,1,2,75,19,1619,233,535,0.436,38,96,0.396,195,439,0.444,57,76,0.75,35,92,127,219,65,11,95,168,561
990,11,1995,32,1,2,12,0,149,4,25,0.16,2,3,0.667,2,22,0.091,0,0,-1,2,8,10,9,7,0,12,25,10
990,11,1995,32,1,2,18,0,201,8,34,0.235,2,4,0.5,6,30,0.2,2,4,0.5,4,9,13,19,9,0,17,35,20
993,1,2010,25,1,5,60,9,783,109,217,0.502,0,4,0,109,213,0.512,52,69,0.754,56,111,167,37,13,35,30,132,270
994,1,1994,23,1,1,82,26,2172,335,893,0.375,69,207,0.333,266,686,0.388,104,142,0.732,47,142,189,390,121,10,184,174,843
994,2,1995,24,1,1,42,26,944,119,318,0.374,36,108,0.333,83,210,0.395,40,55,0.727,24,51,75,159,51,7,79,94,314
994,3,1996,25,1,1,80,48,2138,239,628,0.381,117,289,0.405,122,339,0.36,84,120,0.7,44,150,194,188,84,18,80,185,679
994,4,1997,26,1,1,82,76,3023,421,1042,0.404,166,468,0.355,255,574,0.444,158,203,0.778,59,174,233,154,129,24,96,206,1166
994,5,1998,27,1,1,71,67,2505,316,826,0.383,85,265,0.321,231,561,0.412,145,196,0.74,61,186,247,224,123,10,110,174,862
994,6,1999,28,1,1,49,49,1755,228,524,0.435,59,153,0.386,169,371,0.456,67,89,0.753,26,142,168,193,86,8,92,126,582
994,7,2000,29,1,1,82,82,2919,379,892,0.425,168,389,0.432,211,503,0.419,117,154,0.76,35,215,250,327,129,22,145,216,1043
994,8,2001,30,1,1,82,5,2002,298,783,0.381,152,407,0.373,146,376,0.388,77,96,0.802,32,137,169,222,102,12,68,172,825
994,9,2002,31,1,1,82,47,1616,187,490,0.382,79,208,0.38,108,282,0.383,20,40,0.5,18,103,121,129,66,19,55,120,473
994,10,2003,32,1,1,29,0,673,106,302,0.351,34,107,0.318,72,195,0.369,34,47,0.723,15,44,59,71,35,5,57,50,280
994,11,2004,33,1,2,33,8,661,49,143,0.343,14,50,0.28,35,93,0.376,5,8,0.625,13,54,67,85,39,6,34,45,117
994,12,2005,34,1,2,76,3,1144,108,302,0.358,23,84,0.274,85,218,0.39,46,58,0.793,38,85,123,130,68,13,68,125,285
994,13,2006,35,1,1,30,1,353,37,100,0.37,11,43,0.256,26,57,0.456,2,4,0.5,10,30,40,62,19,1,20,44,87
994,14,2007,36,1,1,52,0,745,94,244,0.385,38,119,0.319,56,125,0.448,30,33,0.909,9,38,47,93,34,7,35,56,256
994,15,2008,37,1,1,24,0,215,22,64,0.344,7,26,0.269,15,38,0.395,7,9,0.778,4,9,13,33,13,2,13,30,58
994,16,2009,38,1,1,28,0,266,27,82,0.329,16,48,0.333,11,34,0.324,3,5,0.6,2,10,12,37,20,1,19,28,73
994,17,2010,39,1,1,13,0,122,5,30,0.167,1,13,0.077,4,17,0.235,2,2,1,1,13,14,9,1,0,4,12,13
996,1,1994,22,1,1,19,19,499,54,146,0.37,2,16,0.125,52,130,0.4,24,30,0.8,6,28,34,115,13,1,48,28,134
996,2,1995,23,1,1,68,6,1105,103,284,0.363,21,76,0.276,82,208,0.394,58,76,0.763,14,56,70,226,29,0,110,79,285
996,3,1996,24,1,1,72,22,1059,65,230,0.283,22,76,0.289,43,154,0.279,68,85,0.8,12,63,75,216,28,3,86,121,220
996,4,1997,25,1,1,49,12,632,46,125,0.368,14,45,0.311,32,80,0.4,37,53,0.698,9,29,38,146,27,3,55,53,143
996,5,1998,26,1,1,34,3,417,47,115,0.409,4,15,0.267,43,100,0.43,30,37,0.811,7,29,36,80,13,0,42,36,128
996,5,1998,26,1,1,27,0,458,46,123,0.374,1,7,0.143,45,116,0.388,29,39,0.744,5,25,30,97,10,0,44,43,122
996,5,1998,26,1,1,61,3,875,93,238,0.391,5,22,0.227,88,216,0.407,59,76,0.776,12,54,66,177,23,0,86,79,250
998,1,1980,22,1,1,71,-1,923,94,241,0.39,3,17,0.176,91,224,0.406,28,38,0.737,14,44,58,159,39,5,73,83,219
998,2,1981,23,1,1,25,-1,542,76,153,0.497,0,1,0,76,152,0.5,22,27,0.815,12,27,39,117,13,1,31,35,174
998,2,1981,23,1,1,56,-1,1892,385,789,0.488,1,4,0.25,384,785,0.489,128,185,0.692,33,66,99,277,45,6,148,113,899
998,2,1981,23,1,1,81,-1,2434,461,942,0.489,1,5,0.2,460,937,0.491,150,212,0.708,45,93,138,394,58,7,179,148,1073
998,3,1982,24,1,1,78,43,2409,325,672,0.484,3,10,0.3,322,662,0.486,153,200,0.765,53,97,150,590,70,11,171,169,806
998,4,1983,25,1,1,80,79,2716,401,832,0.482,4,12,0.333,397,820,0.484,168,245,0.686,41,118,159,487,74,4,195,215,974
998,5,1984,26,1,1,77,56,2041,348,699,0.498,2,11,0.182,346,688,0.503,110,154,0.714,32,64,96,413,38,1,145,126,808
998,6,1986,28,1,1,82,0,1208,140,273,0.513,2,6,0.333,138,267,0.517,63,92,0.685,10,55,65,342,38,4,83,67,345
998,7,1987,29,1,1,19,8,428,55,121,0.455,1,2,0.5,54,119,0.454,18,34,0.529,6,11,17,101,14,0,45,28,129
1005,1,2010,23,1,1,32,0,217,38,82,0.463,7,26,0.269,31,56,0.554,23,46,0.5,6,23,29,39,12,0,14,17,106
1005,2,2011,24,1,1,10,0,146,20,48,0.417,4,17,0.235,16,31,0.516,11,20,0.55,10,14,24,25,9,0,13,11,55
1005,2,2011,24,1,1,24,0,301,42,105,0.4,9,38,0.237,33,67,0.493,18,36,0.5,13,25,38,42,16,1,27,25,111
1005,3,2012,25,1,2,57,12,793,102,271,0.376,28,82,0.341,74,189,0.392,59,96,0.615,27,81,108,126,55,2,52,58,291
1008,1,2004,23,1,1,38,1,364,25,86,0.291,3,10,0.3,22,76,0.289,16,25,0.64,8,31,39,40,11,2,18,22,69
1008,2,2005,24,1,1,10,0,108,10,27,0.37,3,12,0.25,7,15,0.467,3,4,0.75,0,11,11,3,3,0,4,12,26
1008,2,2005,24,1,1,21,0,187,17,50,0.34,4,14,0.286,13,36,0.361,3,4,0.75,1,13,14,7,5,1,7,17,41
1009,1,1980,29,1,1,67,-1,1474,171,377,0.454,2,13,0.154,169,364,0.464,97,120,0.808,34,118,152,312,123,13,115,134,441
1009,2,1981,30,1,1,42,-1,476,71,145,0.49,1,4,0.25,70,141,0.496,36,42,0.857,9,38,47,70,39,5,38,61,179
1009,2,1981,30,1,1,35,-1,636,86,164,0.524,1,3,0.333,85,161,0.528,19,26,0.731,7,45,52,99,55,2,39,56,192
1009,2,1981,30,1,1,77,-1,1112,157,309,0.508,2,7,0.286,155,302,0.513,55,68,0.809,16,83,99,169,94,7,77,117,371
1009,3,1982,31,1,1,75,70,1793,185,373,0.496,0,5,0,185,368,0.503,51,65,0.785,37,152,189,261,121,28,126,173,421
1013,1,1989,23,1,3,44,6,375,75,136,0.551,2,11,0.182,73,125,0.584,35,55,0.636,11,31,42,34,14,3,19,40,187
1013,2,1990,24,1,3,71,10,990,137,301,0.455,3,18,0.167,134,283,0.473,85,107,0.794,42,70,112,119,28,8,44,77,362
1013,3,1991,25,1,3,82,76,2706,548,933,0.587,0,7,0,548,926,0.592,185,227,0.815,85,182,267,256,100,34,148,237,1281
1013,4,1992,26,1,3,82,77,2496,480,908,0.529,9,31,0.29,471,877,0.537,139,157,0.885,80,206,286,219,75,37,97,200,1108
1013,5,1993,27,1,3,82,58,2541,459,906,0.507,52,139,0.374,407,767,0.531,123,149,0.826,46,200,246,226,86,37,81,185,1093
1013,6,1994,28,1,3,75,28,1880,368,804,0.458,25,103,0.243,343,701,0.489,103,126,0.817,41,118,159,149,57,22,77,134,864
1013,7,1995,29,1,3,77,0,1223,220,450,0.489,39,98,0.398,181,352,0.514,87,111,0.784,29,93,122,119,52,10,49,130,566
1013,8,1996,30,1,3,21,0,292,35,82,0.427,6,23,0.261,29,59,0.492,5,10,0.5,7,20,27,18,4,3,11,28,81
1013,8,1996,30,1,3,44,13,1033,117,297,0.394,38,91,0.418,79,206,0.383,33,38,0.868,14,72,86,82,31,5,32,119,305
1013,8,1996,30,1,3,65,13,1325,152,379,0.401,44,114,0.386,108,265,0.408,38,48,0.792,21,92,113,100,35,8,43,147,386
1013,9,1997,31,1,3,62,2,953,123,286,0.43,54,112,0.482,69,174,0.397,7,10,0.7,13,94,107,77,21,17,27,76,307
1015,1,2007,29,1,4,67,60,1909,222,529,0.42,66,193,0.342,156,336,0.464,57,78,0.731,48,282,330,125,78,15,64,90,567
1017,1,2005,24,1,2,8,3,146,18,52,0.346,5,18,0.278,13,34,0.382,3,4,0.75,7,8,15,18,4,1,8,15,44
1026,1,1980,22,1,1,78,-1,1106,155,356,0.435,6,19,0.316,149,337,0.442,18,26,0.692,50,88,138,145,54,4,73,80,334
1027,1,1983,22,1,5,75,13,1411,170,319,0.533,0,3,0,170,316,0.538,129,174,0.741,141,265,406,103,48,70,81,245,469
1027,2,1984,23,1,4,80,34,1529,141,299,0.472,0,2,0,141,297,0.475,129,176,0.733,123,208,331,128,44,66,68,217,411
1027,3,1985,24,1,4,65,13,1123,149,310,0.481,0,2,0,149,308,0.484,120,174,0.69,98,188,286,67,28,15,92,196,418
1027,4,1986,25,1,4,80,2,1197,112,239,0.469,0,2,0,112,237,0.473,116,162,0.716,106,169,275,95,39,22,91,174,340
1028,1,1999,23,1,1,24,0,205,15,51,0.294,6,23,0.261,9,28,0.321,15,20,0.75,3,18,21,18,5,1,12,18,51
1029,1,1984,24,1,4,33,1,267,52,102,0.51,0,0,-1,52,102,0.51,27,34,0.794,35,42,77,10,8,6,11,40,131
1030,1,1981,24,1,3,70,-1,1638,188,415,0.453,1,3,0.333,187,412,0.454,50,62,0.806,85,179,264,132,50,10,90,167,427
1030,2,1982,25,1,3,51,22,858,105,242,0.434,3,10,0.3,102,232,0.44,17,26,0.654,27,67,94,76,32,6,38,94,230
1030,3,1984,27,1,3,41,0,478,78,152,0.513,2,6,0.333,76,146,0.521,30,39,0.769,24,47,71,31,12,2,34,62,188
1031,1,1997,30,1,5,68,47,1665,223,389,0.573,0,0,-1,223,389,0.573,96,138,0.696,149,346,495,38,40,95,34,158,542
1031,2,1998,31,1,5,82,82,2632,242,565,0.428,0,0,-1,242,565,0.428,114,176,0.648,227,417,644,90,57,133,84,197,598
1031,3,1999,32,1,5,49,37,1054,116,231,0.502,0,0,-1,116,231,0.502,38,51,0.745,99,158,257,28,30,45,29,113,270
1031,4,2000,33,1,5,56,23,604,48,108,0.444,0,0,-1,48,108,0.444,18,26,0.692,41,99,140,19,8,40,21,94,114
1031,5,2001,34,1,5,70,21,831,75,156,0.481,0,0,-1,75,156,0.481,27,39,0.692,65,152,217,24,26,49,25,93,177
1031,6,2002,35,1,5,29,0,152,14,40,0.35,0,0,-1,14,40,0.35,0,3,0,13,34,47,4,5,9,7,26,28
1031,6,2002,35,1,5,34,0,183,18,55,0.327,0,0,-1,18,55,0.327,0,3,0,16,41,57,5,7,10,10,32,36
1034,1,1989,22,1,2,71,20,1499,176,359,0.49,0,13,0,176,346,0.509,102,127,0.803,37,119,156,243,78,9,116,141,454
1034,2,1990,23,1,2,73,22,1721,208,421,0.494,4,21,0.19,204,400,0.51,88,114,0.772,34,128,162,289,90,7,117,151,508
1034,3,1991,24,1,2,67,0,949,100,236,0.424,0,22,0,100,214,0.467,60,79,0.759,40,87,127,223,62,2,66,101,260
1034,4,1992,25,1,2,15,0,112,11,33,0.333,1,2,0.5,10,31,0.323,6,8,0.75,2,7,9,18,7,3,10,14,29
1034,4,1992,25,1,2,19,5,374,44,93,0.473,0,1,0,44,92,0.478,10,16,0.625,8,33,41,63,21,1,30,33,98
1034,4,1992,25,1,2,40,5,549,59,143,0.413,1,4,0.25,58,139,0.417,18,26,0.692,12,44,56,98,36,4,44,54,137
1036,1,1999,22,1,4,39,9,538,85,170,0.5,7,18,0.389,78,152,0.513,40,56,0.714,26,49,75,18,8,3,20,62,217
1036,2,2000,23,1,3,82,1,1479,258,585,0.441,79,197,0.401,179,388,0.461,80,111,0.721,44,166,210,58,31,19,85,197,675
1036,3,2001,24,1,3,76,1,1579,223,576,0.387,97,224,0.433,126,352,0.358,85,98,0.867,51,159,210,51,40,15,68,241,628
1036,4,2002,25,1,4,80,43,2406,327,767,0.426,169,396,0.427,158,371,0.426,61,73,0.836,77,261,338,99,61,28,68,230,884
1036,5,2003,26,1,4,81,53,2584,312,744,0.419,161,407,0.396,151,337,0.448,83,100,0.83,72,234,306,121,62,20,77,255,868
1036,6,2005,28,1,4,71,0,955,123,306,0.402,49,147,0.333,74,159,0.465,29,33,0.879,21,103,124,30,19,9,30,107,324
1036,7,2006,29,1,4,57,0,938,101,242,0.417,50,129,0.388,51,113,0.451,30,37,0.811,31,77,108,38,12,9,38,108,282
1036,8,2007,30,1,4,33,0,277,22,70,0.314,11,32,0.344,11,38,0.289,16,18,0.889,12,30,42,14,7,0,14,37,71
1036,9,2008,31,1,4,31,0,284,27,80,0.338,8,37,0.216,19,43,0.442,4,5,0.8,9,35,44,13,6,1,17,35,66
1038,1,1992,24,1,4,54,1,612,117,206,0.568,0,4,0,117,202,0.579,72,109,0.661,75,107,182,16,31,36,44,101,306
1038,2,1993,25,1,4,70,11,1248,249,462,0.539,0,6,0,249,456,0.546,150,207,0.725,129,191,320,40,44,53,102,197,648
1038,3,1994,26,1,5,82,23,1296,271,461,0.588,0,1,0,271,460,0.589,129,208,0.62,143,254,397,41,40,63,84,223,671
1038,4,1995,27,1,4,58,22,1470,324,512,0.633,0,1,0,324,511,0.634,148,250,0.592,144,299,443,51,39,52,117,184,796
1038,5,1996,28,1,4,24,0,565,155,259,0.598,0,0,-1,155,259,0.598,55,75,0.733,51,124,175,17,17,11,35,82,365
1038,5,1996,28,1,4,47,2,862,171,308,0.555,0,1,0,171,307,0.557,84,132,0.636,78,164,242,26,19,29,60,135,426
1038,5,1996,28,1,4,71,2,1427,326,567,0.575,0,1,0,326,566,0.576,139,207,0.671,129,288,417,43,36,40,95,217,791
1038,6,1997,29,1,4,44,1,1191,309,580,0.533,1,6,0.167,308,574,0.537,221,313,0.706,126,222,348,25,35,31,114,125,840
1038,6,1997,29,1,4,47,1,1283,327,623,0.525,1,6,0.167,326,617,0.528,236,329,0.717,134,236,370,28,39,31,120,138,891
1038,7,1998,30,1,4,57,16,1359,248,545,0.455,1,4,0.25,247,541,0.457,159,265,0.6,118,216,334,53,52,29,99,152,656
1038,8,1999,31,1,5,18,2,281,36,97,0.371,0,1,0,36,96,0.375,12,24,0.5,21,44,65,12,8,4,29,40,84
1038,8,1999,31,1,5,30,1,494,81,168,0.482,1,7,0.143,80,161,0.497,25,69,0.362,31,83,114,20,24,6,33,78,188
1038,8,1999,31,1,5,48,3,775,117,265,0.442,1,8,0.125,116,257,0.451,37,93,0.398,52,127,179,32,32,10,62,118,272
1038,9,2000,32,1,4,40,0,770,155,340,0.456,11,47,0.234,144,293,0.491,95,128,0.742,63,142,205,31,34,13,64,104,416
1038,9,2000,32,1,4,45,0,1041,210,462,0.455,7,23,0.304,203,439,0.462,171,245,0.698,91,206,297,40,48,10,105,142,598
1038,9,2000,32,1,4,85,0,1811,365,802,0.455,18,70,0.257,347,732,0.474,266,373,0.713,154,348,502,71,82,23,169,246,1014
1038,10,2001,33,1,4,74,6,1670,329,733,0.449,28,92,0.304,301,641,0.47,156,228,0.684,99,292,391,61,52,27,119,185,842
1038,11,2002,34,1,4,54,1,809,131,293,0.447,1,8,0.125,130,285,0.456,82,117,0.701,71,135,206,25,17,11,58,109,345
1040,1,1997,23,1,1,39,0,246,22,58,0.379,8,21,0.381,14,37,0.378,5,11,0.455,4,11,15,36,13,2,15,36,57
1040,2,1998,24,1,1,62,2,685,56,169,0.331,12,40,0.3,44,129,0.341,28,56,0.5,19,48,67,74,37,12,42,95,152
1041,1,1993,23,1,5,48,2,554,76,145,0.524,0,4,0,76,141,0.539,62,92,0.674,46,74,120,14,15,18,36,123,214
1041,2,1994,24,1,5,72,0,1199,202,352,0.574,1,5,0.2,201,347,0.579,116,149,0.779,119,184,303,32,36,29,61,201,521
1041,3,1995,25,1,5,74,43,1712,260,485,0.536,4,10,0.4,256,475,0.539,93,143,0.65,146,267,413,55,41,51,113,245,617
1041,4,1996,26,1,5,77,50,2349,357,666,0.536,3,8,0.375,354,658,0.538,149,205,0.727,201,448,649,60,46,63,137,290,866
1041,5,1997,27,1,5,49,13,1044,171,350,0.489,6,20,0.3,165,330,0.5,89,127,0.701,100,158,258,38,20,27,67,153,437
1041,6,1998,28,1,5,78,42,1839,358,709,0.505,1,11,0.091,357,698,0.511,168,236,0.712,196,325,521,78,68,87,111,191,885
1041,7,1999,29,1,5,50,40,1540,266,555,0.479,1,5,0.2,265,550,0.482,141,177,0.797,137,225,362,58,39,40,101,157,674
1041,8,2000,30,1,5,65,20,1406,260,589,0.441,0,4,0,260,585,0.444,109,140,0.779,154,233,387,39,29,22,91,194,629
1041,9,2001,31,1,5,35,4,542,88,224,0.393,0,2,0,88,222,0.396,37,54,0.685,50,89,139,14,12,8,25,73,213
1042,1,2000,22,1,3,49,1,345,56,144,0.389,16,47,0.34,40,97,0.412,27,41,0.659,29,46,75,12,10,4,21,54,155
1042,2,2001,23,1,3,59,1,593,64,207,0.309,15,68,0.221,49,139,0.353,39,55,0.709,35,75,110,19,15,15,34,87,182
1042,3,2002,24,1,3,82,1,1759,215,523,0.411,66,178,0.371,149,345,0.432,85,126,0.675,78,225,303,111,71,42,66,190,581
1042,4,2003,25,1,3,71,7,1613,180,461,0.39,49,132,0.371,131,329,0.398,83,105,0.79,91,195,286,92,56,38,65,180,492
1042,5,2004,26,1,3,82,48,1951,233,571,0.408,65,186,0.349,168,385,0.436,73,96,0.76,87,245,332,112,81,38,88,189,604
1042,6,2005,27,1,3,15,3,306,37,104,0.356,21,58,0.362,16,46,0.348,15,20,0.75,13,40,53,14,8,2,12,32,110
1042,7,2006,28,1,3,71,5,1542,170,425,0.4,50,160,0.313,120,265,0.453,58,86,0.674,82,192,274,68,66,34,54,159,448
1042,8,2007,29,1,3,60,17,1283,146,370,0.395,53,150,0.353,93,220,0.423,36,48,0.75,57,156,213,33,46,23,51,143,381
1042,9,2008,30,1,3,53,4,821,74,207,0.357,22,68,0.324,52,139,0.374,24,34,0.706,28,109,137,35,19,13,24,90,194
1042,10,2009,31,1,3,43,17,708,54,142,0.38,22,76,0.289,32,66,0.485,17,22,0.773,25,53,78,15,23,11,17,57,147
1042,11,2010,32,1,3,45,4,761,89,206,0.432,48,123,0.39,41,83,0.494,16,23,0.696,21,93,114,32,41,10,15,89,242
1044,1,1980,26,1,3,73,-1,869,159,348,0.457,1,3,0.333,158,345,0.458,66,100,0.66,77,100,177,43,41,26,49,96,385
1044,2,1981,27,1,3,16,-1,123,19,51,0.373,0,3,0,19,48,0.396,19,29,0.655,13,16,29,6,3,6,7,24,57
1044,2,1981,27,1,3,11,-1,129,22,60,0.367,0,1,0,22,59,0.373,8,11,0.727,17,21,38,9,7,3,8,17,52
1044,2,1981,27,1,3,27,-1,252,41,111,0.369,0,4,0,41,107,0.383,27,40,0.675,30,37,67,15,10,9,15,41,109
1045,1,1990,26,1,4,21,0,339,93,197,0.472,0,3,0,93,194,0.479,65,89,0.73,29,36,65,8,20,7,12,47,251
1045,2,1991,27,1,4,56,4,743,164,394,0.416,7,28,0.25,157,366,0.429,90,114,0.789,40,70,110,30,19,19,45,88,425
1050,1,2010,24,1,3,11,0,140,19,39,0.487,0,8,0,19,31,0.613,7,11,0.636,12,19,31,7,5,1,10,19,45
1050,1,2010,24,1,3,32,1,239,28,60,0.467,0,10,0,28,50,0.56,13,23,0.565,16,35,51,13,9,2,17,29,69
1051,1,1980,27,1,2,78,-1,2934,1024,1940,0.528,32,102,0.314,992,1838,0.54,505,593,0.852,154,249,403,202,110,79,254,208,2585
1051,2,1981,28,1,2,82,-1,2765,850,1729,0.492,9,35,0.257,841,1694,0.496,512,620,0.826,126,293,419,260,94,56,251,212,2221
1051,3,1982,29,1,2,79,79,2817,993,1987,0.5,10,36,0.278,983,1951,0.504,555,642,0.864,138,254,392,187,77,45,210,215,2551
1051,4,1983,30,1,2,78,78,2830,757,1553,0.487,12,33,0.364,745,1520,0.49,517,606,0.853,111,246,357,264,88,67,247,243,2043
1051,5,1984,31,1,2,76,76,2584,765,1561,0.49,10,24,0.417,755,1537,0.491,427,507,0.842,106,207,313,220,79,47,224,219,1967
1051,6,1985,32,1,2,72,69,2091,600,1182,0.508,0,10,0,600,1172,0.512,324,384,0.844,79,155,234,178,66,48,198,208,1524
1051,7,1986,33,1,2,82,75,2065,519,1100,0.472,4,19,0.211,515,1081,0.476,283,322,0.879,78,137,215,144,49,23,161,210,1325
1052,1,1980,29,1,5,17,-1,285,23,66,0.348,0,0,-1,23,66,0.348,9,16,0.563,14,48,62,17,6,7,22,26,55
1055,1,1991,22,1,2,82,36,1944,376,836,0.45,2,14,0.143,374,822,0.455,152,182,0.835,105,158,263,303,104,39,163,186,906
1055,2,1992,23,1,2,79,79,2906,666,1427,0.467,6,25,0.24,660,1402,0.471,284,381,0.745,165,237,402,329,154,46,180,237,1622
1055,3,1993,24,1,2,69,67,2430,463,1032,0.449,17,62,0.274,446,970,0.46,224,290,0.772,120,220,340,268,98,36,174,191,1167
1055,4,1994,25,1,2,79,77,2435,429,969,0.443,38,120,0.317,391,849,0.461,215,275,0.782,91,177,268,275,151,32,143,194,1111
1055,5,1995,26,1,2,73,58,2125,392,858,0.457,63,171,0.368,329,687,0.479,155,209,0.742,99,191,290,192,117,28,138,186,1002
1055,6,1996,27,1,2,11,10,418,67,152,0.441,9,25,0.36,58,127,0.457,49,59,0.831,16,27,43,35,22,2,21,30,192
1055,6,1996,27,1,2,36,36,1265,179,372,0.481,17,54,0.315,162,318,0.509,89,117,0.761,56,133,189,225,42,22,110,101,464
1055,6,1996,27,1,2,47,46,1683,246,524,0.469,26,79,0.329,220,445,0.494,138,176,0.784,72,160,232,260,64,24,131,131,656
1055,7,1997,28,1,3,82,81,3199,644,1453,0.443,74,220,0.336,570,1233,0.462,427,536,0.797,183,316,499,326,154,46,218,225,1789
1055,8,1998,29,1,3,81,81,2733,418,974,0.429,26,101,0.257,392,873,0.449,225,327,0.688,112,279,391,200,156,64,124,268,1087
1055,9,1999,30,1,3,50,47,1606,236,593,0.398,2,17,0.118,234,576,0.406,114,167,0.683,61,183,244,123,134,26,71,162,588
1055,10,2000,31,1,3,76,75,2355,396,956,0.414,20,78,0.256,376,878,0.428,181,255,0.71,82,201,283,210,139,41,89,211,993
1055,11,2001,32,1,2,31,26,892,107,323,0.331,4,14,0.286,103,309,0.333,65,90,0.722,32,99,131,87,47,7,48,64,283
1055,12,2002,33,1,2,65,49,1410,162,422,0.384,6,44,0.136,156,378,0.413,42,62,0.677,29,155,184,100,44,8,55,140,372
1055,13,2003,34,1,2,82,34,2068,286,677,0.422,19,59,0.322,267,618,0.432,123,161,0.764,51,197,248,156,78,15,108,176,714
1055,14,2004,35,1,2,56,35,1411,215,548,0.392,9,38,0.237,206,510,0.404,100,136,0.735,61,129,190,89,65,16,83,107,539
1055,15,2005,36,1,2,14,0,284,32,80,0.4,3,9,0.333,29,71,0.408,18,20,0.9,11,26,37,27,14,4,9,37,85
1059,1,1988,23,1,4,55,53,1807,342,720,0.475,0,0,-1,342,720,0.475,131,193,0.679,134,300,434,72,58,29,123,143,815
1059,2,1989,24,1,4,74,60,2120,468,930,0.503,0,0,-1,468,930,0.503,240,323,0.743,165,376,541,52,54,27,140,176,1176
1059,3,1990,25,1,4,16,7,267,52,121,0.43,0,0,-1,52,121,0.43,39,56,0.696,26,44,70,8,6,5,17,28,143
1059,3,1990,25,1,4,60,59,2159,432,819,0.527,0,2,0,432,817,0.529,264,363,0.727,185,344,529,91,63,46,166,184,1128
1059,3,1990,25,1,4,76,66,2426,484,940,0.515,0,2,0,484,938,0.516,303,419,0.723,211,388,599,99,69,51,183,212,1271
1059,4,1991,26,1,4,25,25,949,195,380,0.513,0,0,-1,195,380,0.513,104,128,0.813,86,148,234,27,34,21,64,65,494
1059,4,1991,26,1,4,50,50,1695,292,621,0.47,0,2,0,292,619,0.472,164,201,0.816,134,230,364,78,35,32,110,120,748
1059,4,1991,26,1,4,75,75,2644,487,1001,0.487,0,2,0,487,999,0.487,268,329,0.815,220,378,598,105,69,53,174,185,1242
1059,5,1992,27,1,4,81,81,2771,512,1001,0.511,0,2,0,512,999,0.513,343,425,0.807,234,426,660,118,51,85,166,176,1367
1059,6,1993,28,1,4,80,26,1742,359,774,0.464,0,1,0,359,773,0.464,274,325,0.843,136,336,472,116,37,54,157,123,992
1059,7,1994,29,1,4,82,5,1969,348,682,0.51,0,1,0,348,681,0.511,274,361,0.759,197,303,500,69,38,61,106,129,970
1059,8,1995,30,1,4,82,30,2472,455,905,0.503,0,2,0,455,903,0.504,302,392,0.77,192,421,613,99,67,89,152,171,1212
1059,9,1996,31,1,3,78,76,2856,576,1216,0.474,0,1,0,576,1215,0.474,277,350,0.791,241,472,713,140,73,53,177,180,1429
1059,10,1997,32,1,4,80,25,2050,246,522,0.471,0,0,-1,246,522,0.471,199,259,0.768,136,361,497,53,61,40,105,206,691
1059,11,1998,33,1,4,82,25,2114,327,676,0.484,0,4,0,327,672,0.487,267,333,0.802,146,293,439,104,65,37,148,177,921
1059,12,1999,34,1,4,34,5,668,101,223,0.453,0,1,0,101,222,0.455,79,101,0.782,33,93,126,19,22,12,36,48,281
1059,13,2000,35,1,4,50,0,782,133,305,0.436,0,1,0,133,304,0.438,67,86,0.779,72,137,209,42,12,16,55,83,333
1061,1,1980,30,1,5,48,-1,1568,305,513,0.595,0,0,-1,305,513,0.595,245,344,0.712,108,324,432,133,29,59,133,167,855
1061,2,1981,31,1,5,82,-1,2832,547,816,0.67,0,0,-1,547,816,0.67,375,532,0.705,220,608,828,172,47,198,236,295,1469
1061,3,1982,32,1,5,82,82,2796,546,837,0.652,1,1,1,545,836,0.652,424,552,0.768,224,611,835,136,49,220,227,287,1517
1061,4,1983,33,1,5,82,82,2797,556,888,0.626,0,6,0,556,882,0.63,367,496,0.74,299,685,984,126,40,192,254,273,1479
1061,5,1984,34,1,5,64,59,2034,351,556,0.631,0,3,0,351,553,0.635,280,390,0.718,213,449,662,70,36,132,149,229,982
1061,6,1985,35,1,5,81,81,2756,532,854,0.623,0,2,0,532,852,0.624,484,646,0.749,231,615,846,131,40,173,241,306,1548
1061,7,1986,36,1,5,71,71,2395,423,684,0.618,0,1,0,423,683,0.619,338,482,0.701,166,434,600,102,39,108,186,239,1184
1061,8,1987,37,1,5,82,74,2405,346,580,0.597,0,0,-1,346,580,0.597,242,356,0.68,185,394,579,150,39,95,178,235,934
1061,9,1988,38,1,5,24,23,372,41,80,0.513,0,0,-1,41,80,0.513,19,37,0.514,15,48,63,9,5,12,28,54,101
1061,9,1988,38,1,5,47,4,521,58,101,0.574,0,0,-1,58,101,0.574,48,91,0.527,54,94,148,12,10,18,39,94,164
1061,9,1988,38,1,5,71,27,893,99,181,0.547,0,0,-1,99,181,0.547,67,128,0.523,69,142,211,21,15,30,67,148,265
1066,1,1980,23,1,3,82,-1,1254,182,473,0.385,0,2,0,182,471,0.386,106,128,0.828,114,128,242,59,51,19,59,132,470
1068,1,2003,25,1,3,27,27,961,143,325,0.44,39,119,0.328,104,206,0.505,62,76,0.816,18,112,130,67,30,2,51,55,387
1068,1,2003,25,1,2,49,35,1187,207,478,0.433,46,130,0.354,161,348,0.463,88,107,0.822,18,90,108,70,22,6,94,104,548
1068,1,2003,25,1,2,76,62,2148,350,803,0.436,85,249,0.341,265,554,0.478,150,183,0.82,36,202,238,137,52,8,145,159,935
1068,2,2004,26,1,2,25,18,606,128,297,0.431,14,39,0.359,114,258,0.442,68,77,0.883,14,48,62,42,15,5,40,46,338
1068,2,2004,26,1,3,48,25,1435,188,427,0.44,46,113,0.407,142,314,0.452,67,81,0.827,37,127,164,80,41,10,63,98,489
1068,2,2004,26,1,3,73,43,2041,316,724,0.436,60,152,0.395,256,572,0.448,135,158,0.854,51,175,226,122,56,15,103,144,827
1068,3,2005,27,1,2,81,44,1660,283,632,0.448,38,105,0.362,245,527,0.465,111,137,0.81,25,157,182,137,46,11,90,155,715
1068,4,2006,28,1,2,37,36,956,166,383,0.433,18,59,0.305,148,324,0.457,43,57,0.754,15,55,70,63,16,4,63,87,393
1068,5,2007,29,1,2,61,6,1188,176,381,0.462,52,122,0.426,124,259,0.479,71,87,0.816,24,105,129,63,28,5,64,122,475
1068,6,2008,30,1,2,12,0,110,13,41,0.317,5,15,0.333,8,26,0.308,6,8,0.75,1,13,14,11,3,1,8,9,37
1068,6,2008,30,1,2,22,0,279,41,102,0.402,12,34,0.353,29,68,0.426,1,1,1,6,25,31,16,13,1,21,24,95
1068,6,2008,30,1,2,22,0,442,79,159,0.497,19,50,0.38,60,109,0.55,16,17,0.941,9,42,51,35,8,2,23,49,193
1068,6,2008,30,1,2,56,0,831,133,302,0.44,36,99,0.364,97,203,0.478,23,26,0.885,16,80,96,62,24,4,52,82,325
1069,1,1980,24,1,2,75,-1,800,188,364,0.516,2,10,0.2,186,354,0.525,63,73,0.863,21,45,66,85,35,7,38,79,441
1069,2,1981,25,1,1,82,-1,1506,285,511,0.558,4,11,0.364,281,500,0.562,98,110,0.891,27,61,88,108,72,5,62,126,672
1069,3,1982,26,1,2,49,0,833,158,291,0.543,1,2,0.5,157,289,0.543,59,67,0.881,5,56,61,87,26,3,27,80,376
1069,4,1983,27,1,2,73,4,1124,230,444,0.518,0,1,0,230,443,0.519,74,89,0.831,16,74,90,125,30,9,52,132,534
1069,5,1984,28,1,2,81,0,1503,312,554,0.563,1,2,0.5,311,552,0.563,56,70,0.8,17,87,104,171,46,5,63,146,681
1069,6,1985,29,1,2,60,5,1126,228,388,0.588,0,2,0,228,386,0.591,62,76,0.816,20,61,81,122,27,0,55,74,518
1069,7,1986,30,1,2,38,1,573,94,190,0.495,0,0,-1,94,190,0.495,47,49,0.959,4,53,57,39,9,3,18,42,235
1070,1,1986,26,1,4,49,16,772,84,209,0.402,1,1,1,83,208,0.399,70,122,0.574,31,132,163,32,26,25,76,124,239
1071,1,2000,21,1,2,30,1,446,66,171,0.386,12,45,0.267,54,126,0.429,51,70,0.729,15,23,38,27,15,4,28,28,195
1071,2,2001,22,1,2,57,7,929,141,336,0.42,9,46,0.196,132,290,0.455,47,69,0.681,39,92,131,69,49,10,54,92,338
1071,3,2002,23,1,2,55,25,1156,192,456,0.421,30,91,0.33,162,365,0.444,78,103,0.757,36,133,169,84,45,14,76,89,492
1071,4,2003,24,1,2,76,42,1890,277,648,0.427,56,158,0.354,221,490,0.451,127,162,0.784,62,220,282,141,71,15,108,146,737
1071,5,2004,25,1,2,14,4,178,25,65,0.385,4,14,0.286,21,51,0.412,10,14,0.714,4,25,29,15,10,2,19,17,64
1071,5,2004,25,1,2,55,26,1465,205,524,0.391,36,105,0.343,169,419,0.403,110,142,0.775,54,183,237,115,40,17,83,106,556
1071,5,2004,25,1,2,69,30,1643,230,589,0.39,40,119,0.336,190,470,0.404,120,156,0.769,58,208,266,130,50,19,102,123,620
1075,1,1980,24,1,3,59,-1,1020,148,286,0.517,2,6,0.333,146,280,0.521,92,121,0.76,107,152,259,81,68,16,58,119,390
1075,2,1981,25,1,4,73,-1,1077,155,329,0.471,0,2,0,155,327,0.474,112,137,0.818,136,171,307,83,91,20,69,185,422
1075,3,1982,26,1,3,80,0,1699,250,495,0.505,0,3,0,250,492,0.508,160,217,0.737,140,283,423,152,92,36,100,229,660
1075,4,1983,27,1,4,76,2,1130,134,294,0.456,0,3,0,134,291,0.46,82,114,0.719,108,193,301,100,80,9,49,161,350
1076,1,1981,21,1,5,56,-1,1579,291,688,0.423,0,1,0,291,687,0.424,155,202,0.767,137,282,419,72,54,100,128,127,737
1076,2,1982,22,1,5,64,6,740,119,270,0.441,0,0,-1,119,270,0.441,97,118,0.822,70,116,186,41,17,48,56,69,335
1076,3,1983,23,1,5,80,1,1255,213,426,0.5,0,1,0,213,425,0.501,175,225,0.778,154,228,382,61,35,116,126,118,601
1076,4,1984,24,1,5,82,2,1655,237,462,0.513,0,3,0,237,459,0.516,147,184,0.799,161,272,433,92,37,70,120,162,621
1076,5,1985,25,1,5,81,54,2418,380,818,0.465,0,1,0,380,817,0.465,276,328,0.841,229,404,633,158,38,92,136,135,1036
1076,6,1986,26,1,5,81,78,2525,491,949,0.517,0,1,0,491,948,0.518,351,393,0.893,206,462,668,133,56,71,140,163,1333
1076,7,1987,27,1,5,72,66,2272,433,947,0.457,0,0,-1,433,947,0.457,313,370,0.846,192,438,630,99,52,69,129,159,1179
1076,8,1988,28,1,5,34,34,1194,215,474,0.454,0,2,0,215,472,0.456,143,166,0.861,82,238,320,55,28,33,83,78,573
1076,8,1988,28,1,5,47,47,1767,290,652,0.445,0,0,-1,290,652,0.445,212,226,0.938,163,331,494,84,36,85,94,98,792
1076,8,1988,28,1,5,81,81,2961,505,1126,0.448,0,2,0,505,1124,0.449,355,392,0.906,245,569,814,139,64,118,177,176,1365
1076,9,1989,29,1,5,82,82,2739,556,1166,0.477,0,6,0,556,1160,0.479,297,341,0.871,213,556,769,138,46,106,129,142,1409
1076,10,1990,30,1,5,81,81,2659,458,1002,0.457,3,17,0.176,455,985,0.462,193,235,0.821,196,491,687,128,43,102,98,136,1112
1076,11,1991,31,1,5,30,29,791,109,284,0.384,1,8,0.125,108,276,0.391,53,63,0.841,71,130,201,33,16,34,31,41,272
1076,11,1991,31,1,5,50,50,1405,248,524,0.473,1,6,0.167,247,518,0.477,75,95,0.789,115,266,381,60,24,22,54,58,572
1076,11,1991,31,1,5,80,79,2196,357,808,0.442,2,14,0.143,355,794,0.447,128,158,0.81,186,396,582,93,40,56,85,99,844
1076,12,1992,32,1,5,35,10,499,90,199,0.452,1,3,0.333,89,196,0.454,21,28,0.75,37,81,118,31,11,16,20,37,202
1076,13,1993,33,1,5,34,0,251,42,83,0.506,0,0,-1,42,83,0.506,9,10,0.9,34,51,85,7,1,9,11,28,93
1076,14,1994,34,1,5,21,6,255,31,79,0.392,0,0,-1,31,79,0.392,11,14,0.786,19,40,59,11,13,13,11,20,73
1076,14,1994,34,1,5,29,7,309,36,103,0.35,0,0,-1,36,103,0.35,14,18,0.778,22,52,74,11,13,16,13,23,86
1078,1,2001,24,1,4,12,0,133,7,18,0.389,1,3,0.333,6,15,0.4,4,7,0.571,7,14,21,6,2,1,8,14,19
1084,1,1985,22,1,2,63,1,682,110,287,0.383,2,9,0.222,108,278,0.388,37,49,0.755,26,35,61,88,33,6,69,61,259
1084,2,1986,23,1,2,60,1,704,130,345,0.377,7,28,0.25,123,317,0.388,45,56,0.804,24,44,68,60,33,10,62,91,312
1084,3,1987,24,1,2,70,4,1130,221,545,0.406,14,48,0.292,207,497,0.416,70,95,0.737,64,62,126,139,61,13,102,106,526
1087,1,1994,23,1,2,70,6,889,122,305,0.4,2,25,0.08,120,280,0.429,92,110,0.836,21,65,86,66,61,4,65,54,338
1087,2,1995,24,1,2,50,7,775,95,223,0.426,6,28,0.214,89,195,0.456,55,73,0.753,19,43,62,66,29,6,48,76,251
1087,3,1996,25,1,2,8,3,128,17,32,0.531,7,14,0.5,10,18,0.556,15,17,0.882,5,10,15,11,5,0,17,16,56
1087,3,1996,25,1,2,45,2,485,61,161,0.379,25,68,0.368,36,93,0.387,37,51,0.725,12,30,42,41,20,1,29,48,184
1087,3,1996,25,1,2,53,5,613,78,193,0.404,32,82,0.39,46,111,0.414,52,68,0.765,17,40,57,52,25,1,46,64,240
1087,4,1997,26,1,2,28,0,197,29,80,0.363,9,31,0.29,20,49,0.408,26,40,0.65,2,11,13,11,12,1,10,12,93
1088,1,2006,23,1,3,80,24,1581,198,414,0.478,29,87,0.333,169,327,0.517,108,133,0.812,57,187,244,60,37,13,92,228,533
1088,2,2007,24,1,3,79,21,1319,192,388,0.495,9,31,0.29,183,357,0.513,110,131,0.84,55,193,248,44,30,4,49,161,503
1088,3,2008,25,1,3,38,3,331,49,113,0.434,2,3,0.667,47,110,0.427,38,45,0.844,18,49,67,15,3,0,23,47,138
1088,4,2009,26,1,3,78,10,1541,231,480,0.481,3,16,0.188,228,464,0.491,132,160,0.825,95,197,292,48,35,12,74,191,597
1088,5,2010,27,1,3,63,18,759,105,202,0.52,2,13,0.154,103,189,0.545,54,73,0.74,39,84,123,22,23,7,43,104,266
1088,6,2011,28,1,3,39,8,586,82,179,0.458,9,30,0.3,73,149,0.49,29,36,0.806,8,76,84,18,6,7,28,73,202
1091,1,1992,24,1,2,78,9,1718,305,682,0.447,55,141,0.39,250,541,0.462,126,170,0.741,72,159,231,175,96,21,91,193,791
1091,2,1993,25,1,2,80,11,1508,256,560,0.457,42,141,0.298,214,419,0.511,96,131,0.733,61,129,190,164,86,6,120,185,650
1091,3,1994,26,1,2,21,0,128,21,57,0.368,3,13,0.231,18,44,0.409,13,17,0.765,4,8,12,13,4,5,5,11,58
1092,1,1991,30,1,4,26,0,168,30,58,0.517,9,17,0.529,21,41,0.512,10,21,0.476,20,30,50,8,2,8,11,33,79
1093,1,1995,22,1,4,80,59,2289,413,809,0.511,1,4,0.25,412,805,0.512,231,363,0.636,207,391,598,99,49,116,163,276,1058
1093,2,1996,23,1,4,78,75,2398,427,842,0.507,4,17,0.235,423,825,0.513,262,358,0.732,175,370,545,127,40,103,185,269,1120
1093,3,1997,24,1,4,24,15,607,91,207,0.44,0,0,-1,91,207,0.44,70,90,0.778,49,93,142,28,19,25,44,75,252
1093,4,1998,25,1,3,61,49,1921,283,557,0.508,0,1,0,283,556,0.509,171,228,0.75,197,358,555,86,44,45,110,184,737
1093,5,1999,26,1,4,48,46,1525,183,382,0.479,0,0,-1,183,382,0.479,184,226,0.814,173,297,470,67,21,34,96,136,550
1093,6,2000,27,1,4,63,14,1322,173,352,0.491,1,2,0.5,172,350,0.491,112,166,0.675,121,223,344,64,32,28,84,166,459
1093,7,2001,28,1,5,82,79,2771,484,1010,0.479,0,1,0,484,1009,0.48,282,354,0.797,217,501,718,101,60,71,170,293,1250
1093,8,2002,29,1,4,72,72,2256,286,610,0.469,0,2,0,286,608,0.47,101,119,0.849,168,407,575,137,48,31,122,236,673
1093,9,2003,30,1,5,82,82,2641,344,676,0.509,0,0,-1,344,676,0.509,158,205,0.771,241,596,837,104,63,47,129,300,846
1093,10,2004,31,1,5,76,76,2303,289,613,0.471,0,1,0,289,612,0.472,86,110,0.782,174,350,524,69,51,35,82,254,664
1093,11,2005,32,1,5,69,8,1136,103,209,0.493,0,0,-1,103,209,0.493,57,79,0.722,101,156,257,34,23,23,43,175,263
1093,12,2006,33,1,5,21,2,248,27,65,0.415,0,0,-1,27,65,0.415,7,8,0.875,11,46,57,7,5,3,7,45,61
1095,1,1989,23,1,1,71,48,1924,361,830,0.435,5,22,0.227,356,808,0.441,119,162,0.735,80,158,238,506,144,9,258,170,846
1095,2,1990,24,1,1,44,44,1529,241,517,0.466,5,21,0.238,236,496,0.476,88,113,0.779,59,136,195,442,108,5,206,120,575
1095,3,1991,25,1,1,68,65,2105,265,587,0.451,9,39,0.231,256,548,0.467,51,74,0.689,69,140,209,587,103,12,210,192,590
1095,4,1992,26,1,1,78,53,2049,275,595,0.462,15,51,0.294,260,544,0.478,44,54,0.815,34,150,184,538,138,14,187,181,609
1095,5,1993,27,1,1,74,8,1624,210,476,0.441,11,42,0.262,199,434,0.459,55,74,0.743,27,112,139,353,106,9,129,168,486
1095,6,1994,28,1,1,78,8,1533,253,563,0.449,17,62,0.274,236,501,0.471,65,76,0.855,42,100,142,291,119,12,136,139,588
1095,7,1995,29,1,1,33,2,470,78,166,0.47,4,16,0.25,74,150,0.493,45,55,0.818,8,27,35,93,29,3,44,66,205
1095,8,1996,30,1,1,47,1,596,88,181,0.486,8,24,0.333,80,157,0.51,48,58,0.828,12,40,52,69,39,3,45,91,232
1095,9,1997,31,1,1,28,0,365,39,110,0.355,14,46,0.304,25,64,0.391,18,22,0.818,8,30,38,45,16,0,27,39,110
1095,10,1998,32,1,1,22,2,359,43,93,0.462,7,19,0.368,36,74,0.486,12,14,0.857,8,40,48,84,17,2,24,30,105
1096,1,1989,23,1,4,71,1,1193,181,390,0.464,0,1,0,181,389,0.465,34,57,0.596,75,88,163,79,35,29,28,147,396
1096,2,1990,24,1,4,81,25,1846,284,601,0.473,0,8,0,284,593,0.479,96,137,0.701,138,204,342,131,52,43,85,194,664
1096,3,1991,25,1,4,77,76,2842,609,1224,0.498,2,15,0.133,607,1209,0.502,185,249,0.743,179,378,557,204,91,61,125,232,1405
1096,4,1992,26,1,3,64,60,2388,489,1022,0.478,1,8,0.125,488,1014,0.481,176,220,0.8,157,275,432,170,74,27,109,178,1155
1096,5,1993,27,1,3,72,72,2667,560,1149,0.487,1,10,0.1,559,1139,0.491,218,300,0.727,133,279,412,205,72,44,90,168,1339
1096,6,1994,28,1,3,77,73,2112,356,774,0.46,2,7,0.286,354,767,0.462,84,131,0.641,109,242,351,107,70,49,56,179,798
1096,7,1995,29,1,4,75,14,1771,286,621,0.461,8,26,0.308,278,595,0.467,103,146,0.705,103,181,284,82,56,53,62,163,683
1096,8,1996,30,1,4,76,75,2394,314,679,0.462,21,67,0.313,293,612,0.479,60,110,0.545,117,244,361,111,60,43,82,173,709
1096,9,1997,31,1,4,78,25,1604,129,314,0.411,28,89,0.315,101,225,0.449,30,39,0.769,63,193,256,68,46,48,30,167,316
1096,10,1998,32,1,3,65,8,895,75,196,0.383,1,6,0.167,74,190,0.389,19,30,0.633,60,108,168,39,23,15,26,94,170
1096,11,1999,33,1,4,47,10,798,62,168,0.369,1,6,0.167,61,162,0.377,21,29,0.724,36,74,110,23,20,16,21,73,146
1098,1,1994,26,1,4,53,0,382,59,146,0.404,17,61,0.279,42,85,0.494,22,29,0.759,27,62,89,24,18,8,30,62,157
1101,1,1988,22,1,4,81,6,1827,254,507,0.501,0,2,0,254,505,0.503,114,182,0.626,155,292,447,89,51,53,86,221,622
1101,2,1989,23,1,4,79,79,2809,405,781,0.519,0,5,0,405,776,0.522,140,199,0.704,240,441,681,168,86,62,128,251,950
1101,3,1990,24,1,4,80,80,2753,446,853,0.523,0,0,-1,446,853,0.523,179,256,0.699,236,393,629,227,92,84,110,230,1071
1101,4,1991,25,1,4,78,76,2641,401,733,0.547,1,6,0.167,400,727,0.55,197,277,0.711,266,393,659,178,95,69,92,203,1000
1101,5,1992,26,1,4,81,81,2859,457,790,0.578,0,2,0,457,788,0.58,235,317,0.741,344,463,807,217,100,131,98,196,1149
1101,6,1993,27,1,4,77,77,2745,421,829,0.508,1,5,0.2,420,824,0.51,174,281,0.619,341,388,729,201,89,96,110,218,1017
1101,7,1994,28,1,4,70,69,2570,460,878,0.524,0,6,0,460,872,0.528,137,230,0.596,306,463,769,236,74,84,109,164,1057
1101,8,1995,29,1,4,74,74,2693,401,707,0.567,0,8,0,401,699,0.574,146,211,0.692,223,492,715,173,76,88,85,203,948
1101,9,1996,30,1,4,63,62,2286,347,677,0.513,1,6,0.167,346,671,0.516,152,207,0.734,178,402,580,170,62,74,64,144,847
1101,10,1997,31,1,4,67,67,2496,358,695,0.515,1,6,0.167,357,689,0.518,128,179,0.715,206,394,600,163,101,65,99,157,845
1101,11,1998,32,1,5,76,76,2803,393,857,0.459,0,7,0,393,850,0.462,135,199,0.678,228,390,618,172,81,79,88,180,921
1101,12,1999,33,1,4,50,50,1660,198,456,0.434,0,2,0,198,454,0.436,47,70,0.671,117,234,351,90,46,60,44,99,443
1101,13,2000,34,1,4,76,76,2688,266,599,0.444,0,4,0,266,595,0.447,80,111,0.721,167,424,591,188,55,60,61,192,612
1101,14,2001,35,1,4,77,77,2390,263,569,0.462,0,3,0,263,566,0.465,131,169,0.775,220,325,545,121,51,61,48,181,657
1101,15,2002,36,1,5,76,76,2210,264,515,0.513,0,0,-1,264,515,0.513,80,111,0.721,159,322,481,104,57,49,51,118,608
1101,16,2004,38,1,4,55,10,1106,92,224,0.411,0,1,0,92,223,0.413,39,54,0.722,79,154,233,71,24,21,29,70,223
1102,1,1998,22,1,2,30,3,472,77,202,0.381,18,46,0.391,59,156,0.378,55,65,0.846,9,36,45,34,15,11,30,73,227
1102,2,1999,23,1,2,30,3,337,53,182,0.291,12,42,0.286,41,140,0.293,28,37,0.757,7,21,28,12,12,1,29,30,146
1106,1,1985,21,1,5,52,0,391,35,92,0.38,0,0,-1,35,92,0.38,32,47,0.681,29,94,123,15,9,14,51,82,102
1106,2,1986,22,1,5,67,3,423,54,108,0.5,0,0,-1,54,108,0.5,47,74,0.635,45,73,118,15,8,11,32,94,155
1106,3,1987,23,1,5,55,1,456,41,101,0.406,0,0,-1,41,101,0.406,28,39,0.718,39,90,129,26,10,28,36,93,110
1106,4,1988,24,1,5,74,0,807,90,193,0.466,0,1,0,90,192,0.469,44,73,0.603,70,180,250,44,11,32,50,152,224
1106,5,1989,25,1,5,72,0,783,72,153,0.471,0,1,0,72,152,0.474,44,64,0.688,84,161,245,29,11,21,48,128,188
1106,6,1990,26,1,5,39,1,466,38,82,0.463,0,2,0,38,80,0.475,25,39,0.641,38,93,131,17,12,24,19,64,101
1106,6,1990,26,1,5,58,1,560,42,99,0.424,0,5,0,42,94,0.447,32,47,0.681,40,105,145,19,15,26,24,90,116
1107,1,1989,21,1,3,55,15,1220,167,398,0.42,1,4,0.25,166,394,0.421,105,156,0.673,117,169,286,117,36,25,102,144,440
1109,1,2006,23,1,2,27,0,135,6,28,0.214,0,2,0,6,26,0.231,13,21,0.619,10,14,24,7,3,0,5,13,25
1112,1,1986,21,1,3,20,0,221,44,101,0.436,0,1,0,44,100,0.44,21,26,0.808,17,21,38,3,4,7,17,26,109
1112,1,1986,21,1,3,21,0,232,39,91,0.429,0,0,-1,39,91,0.429,14,23,0.609,10,25,35,6,1,2,18,27,92
1112,1,1986,21,1,3,41,0,453,83,192,0.432,0,1,0,83,191,0.435,35,49,0.714,27,46,73,9,5,9,35,53,201
1112,2,1987,22,1,3,19,0,172,25,70,0.357,0,0,-1,25,70,0.357,14,19,0.737,6,22,28,7,4,2,15,8,64
1115,1,1986,22,1,4,82,1,1542,209,388,0.539,1,6,0.167,208,382,0.545,102,167,0.611,160,221,381,54,49,49,99,229,521
1115,2,1987,23,1,4,79,72,2240,316,587,0.538,0,5,0,316,582,0.543,220,282,0.78,210,405,615,84,70,80,102,171,852
1115,3,1988,24,1,4,82,64,2636,322,640,0.503,0,2,0,322,638,0.505,293,379,0.773,245,465,710,93,87,45,120,204,937
1115,4,1989,25,1,4,82,82,2510,401,758,0.529,4,17,0.235,397,741,0.536,282,359,0.786,258,481,739,103,94,55,119,172,1088
1115,5,1990,26,1,4,82,82,2709,385,806,0.478,13,46,0.283,372,760,0.489,278,370,0.751,262,450,712,90,66,50,116,207,1061
1115,6,1991,27,1,4,82,21,2164,258,542,0.476,11,55,0.2,247,487,0.507,223,302,0.738,201,315,516,71,59,23,99,117,750
1115,7,1992,28,1,4,82,53,2902,382,803,0.476,12,56,0.214,370,747,0.495,340,457,0.744,306,456,762,117,91,36,111,141,1116
1115,8,1993,29,1,4,82,55,2819,379,706,0.537,16,46,0.348,363,660,0.55,277,375,0.739,287,424,711,116,88,39,116,149,1051
1115,9,1994,30,1,4,82,55,2825,465,926,0.502,8,35,0.229,457,891,0.513,266,362,0.735,275,478,753,137,70,38,100,142,1204
1115,10,1995,31,1,3,82,52,2687,311,617,0.504,43,127,0.339,268,490,0.547,251,343,0.732,194,475,669,127,55,31,114,146,916
1115,11,1996,32,1,3,82,36,2113,215,444,0.484,14,52,0.269,201,392,0.513,168,237,0.709,166,388,554,72,45,23,79,141,612
1115,12,1997,33,1,4,27,19,548,61,128,0.477,0,3,0,61,125,0.488,31,48,0.646,33,105,138,17,18,1,20,34,153
1115,12,1997,33,1,4,56,54,1944,173,356,0.486,1,17,0.059,172,339,0.507,97,149,0.651,189,329,518,52,52,15,54,111,444
1115,12,1997,33,1,4,83,73,2492,234,484,0.483,1,20,0.05,233,464,0.502,128,197,0.65,222,434,656,69,70,16,74,145,597
1115,13,1998,34,1,4,82,68,2649,242,534,0.453,0,4,0,242,530,0.457,116,162,0.716,219,449,668,123,78,27,68,157,600
1115,14,1999,35,1,4,50,35,924,108,256,0.422,0,8,0,108,248,0.435,30,52,0.577,82,146,228,25,28,8,19,69,246
1115,15,2000,36,1,4,82,82,1929,173,387,0.447,1,4,0.25,172,383,0.449,66,95,0.695,160,326,486,80,53,18,53,127,413
1115,16,2001,37,1,4,82,1,1411,144,324,0.444,0,6,0,144,318,0.453,79,111,0.712,107,206,313,39,30,8,45,119,367
1116,1,1980,28,1,5,21,-1,459,69,159,0.434,0,2,0,69,157,0.439,24,42,0.571,35,78,113,28,13,21,36,55,162
1117,1,1992,21,1,4,35,0,256,62,158,0.392,2,10,0.2,60,148,0.405,15,28,0.536,22,20,42,22,13,6,27,31,141
1117,2,1994,23,1,4,35,0,332,63,182,0.346,10,41,0.244,53,141,0.376,13,18,0.722,10,24,34,16,18,6,27,21,149
1117,2,1994,23,1,4,36,0,334,63,183,0.344,10,41,0.244,53,142,0.373,13,18,0.722,10,24,34,16,18,6,27,21,149
1118,1,1984,23,1,4,49,0,667,100,228,0.439,0,0,-1,100,228,0.439,55,77,0.714,58,116,174,25,18,17,60,128,255
1118,2,1985,24,1,4,48,1,740,108,250,0.432,0,4,0,108,246,0.439,79,98,0.806,72,174,246,29,11,14,68,102,295
1118,3,1986,25,1,4,80,68,2307,407,875,0.465,0,8,0,407,867,0.469,262,335,0.782,208,450,658,139,70,37,220,292,1076
1118,4,1987,26,1,4,80,69,1792,256,542,0.472,0,2,0,256,540,0.474,119,177,0.672,196,457,653,62,41,50,127,197,631
1118,5,1988,27,1,4,82,65,2049,258,585,0.441,0,2,0,258,583,0.443,126,190,0.663,221,421,642,93,65,32,148,318,642
1118,6,1989,28,1,4,82,0,1277,194,422,0.46,0,3,0,194,419,0.463,129,170,0.759,157,237,394,76,47,18,125,172,517
1118,7,1990,29,1,5,73,31,1860,312,667,0.468,1,3,0.333,311,664,0.468,136,209,0.651,166,422,588,99,50,26,119,231,761
1118,8,1991,30,1,4,66,7,1099,177,384,0.461,0,3,0,177,381,0.465,89,105,0.848,98,215,313,52,32,13,89,172,443
1118,9,1992,31,1,4,80,1,1127,147,344,0.427,0,0,-1,147,344,0.427,73,89,0.82,92,250,342,36,29,11,62,148,367
1118,10,1993,32,1,4,24,0,127,14,40,0.35,0,2,0,14,38,0.368,12,16,0.75,14,33,47,5,1,2,8,16,40
1118,10,1993,32,1,4,15,0,202,20,49,0.408,0,0,-1,20,49,0.408,13,15,0.867,18,53,71,19,5,3,12,21,53
1118,10,1993,32,1,4,39,0,329,34,89,0.382,0,2,0,34,87,0.391,25,31,0.806,32,86,118,24,6,5,20,37,93
1123,1,1980,22,1,4,82,-1,2791,498,1051,0.474,1,7,0.143,497,1044,0.476,337,416,0.81,223,550,773,182,60,129,210,313,1334
1123,2,1981,23,1,4,82,-1,2710,481,989,0.486,0,2,0,481,987,0.487,217,290,0.748,243,481,724,218,77,124,192,282,1179
1123,3,1982,24,1,4,82,82,2914,480,1014,0.473,0,3,0,480,1011,0.475,240,291,0.825,192,594,786,262,70,93,180,292,1200
1123,4,1983,25,1,4,79,61,2355,312,686,0.455,0,4,0,312,682,0.457,165,233,0.708,217,548,765,151,54,90,154,261,789
1123,5,1984,26,1,4,78,76,2718,369,753,0.49,0,1,0,369,752,0.491,213,289,0.737,214,572,786,139,67,72,149,265,951
1123,6,1985,27,1,4,61,28,1523,152,332,0.458,0,1,0,152,331,0.459,67,94,0.713,108,280,388,78,34,18,63,190,371
1123,7,1986,28,1,4,68,24,1910,198,388,0.51,0,1,0,198,387,0.512,142,184,0.772,151,380,531,90,37,52,113,207,538
1123,8,1987,29,1,4,79,78,2587,336,655,0.513,3,6,0.5,333,649,0.513,241,307,0.785,256,527,783,237,71,50,161,248,916
1123,9,1988,30,1,4,45,40,1236,151,328,0.46,0,2,0,151,326,0.463,83,111,0.748,92,208,300,97,33,22,74,134,385
1123,10,1989,31,1,4,29,3,491,62,148,0.419,0,0,-1,62,148,0.419,48,71,0.676,48,116,164,41,17,28,36,78,172
1123,10,1989,31,1,4,38,15,912,105,247,0.425,0,0,-1,105,247,0.425,84,105,0.8,92,146,238,55,30,24,55,123,294
1123,10,1989,31,1,4,67,18,1403,167,395,0.423,0,0,-1,167,395,0.423,132,176,0.75,140,262,402,96,47,52,91,201,466
1123,11,1990,32,1,4,37,0,205,22,52,0.423,0,0,-1,22,52,0.423,16,29,0.552,24,54,78,12,4,9,16,40,60
1123,12,1991,33,1,4,63,11,1018,85,169,0.503,0,2,0,85,167,0.509,69,94,0.734,61,160,221,52,29,25,71,172,239
1127,1,1980,26,1,3,65,-1,1818,331,804,0.412,34,92,0.37,297,712,0.417,216,249,0.867,80,107,187,177,56,16,102,158,912
1127,2,1981,27,1,2,75,-1,2616,500,1103,0.453,45,136,0.331,455,967,0.471,244,290,0.841,67,152,219,300,68,17,144,161,1289
1127,3,1982,28,1,2,71,62,2164,376,857,0.439,28,82,0.341,348,775,0.449,165,193,0.855,57,138,195,149,44,23,96,151,945
1127,4,1983,29,1,3,41,11,756,114,294,0.388,15,38,0.395,99,256,0.387,54,69,0.783,18,31,49,49,18,7,27,61,297
1127,5,1984,30,1,2,64,3,923,178,395,0.451,15,53,0.283,163,342,0.477,75,84,0.893,30,51,81,75,27,4,45,95,446
1127,6,1985,31,1,3,78,6,1182,190,424,0.448,8,33,0.242,182,391,0.465,88,107,0.822,27,76,103,94,30,2,55,85,476
1129,1,2007,27,1,2,41,0,432,61,141,0.433,18,52,0.346,43,89,0.483,27,32,0.844,2,25,27,53,17,1,18,32,167
1133,1,1980,26,1,5,82,-1,1812,173,313,0.553,0,0,-1,173,313,0.553,174,240,0.725,154,284,438,250,81,53,131,306,520
1133,2,1981,27,1,4,82,-1,1930,166,325,0.511,0,0,-1,166,325,0.511,170,253,0.672,184,321,505,249,77,38,132,207,502
1133,3,1982,28,1,4,23,0,459,32,66,0.485,0,0,-1,32,66,0.485,24,37,0.649,29,66,95,54,20,8,40,67,88
1133,4,1983,29,1,4,53,0,956,60,116,0.517,0,0,-1,60,116,0.517,53,76,0.697,77,139,216,86,33,25,68,153,173
1135,1,2000,25,1,2,72,47,1927,175,413,0.424,16,57,0.281,159,356,0.447,119,158,0.753,128,244,372,177,116,15,93,222,485
1135,2,2001,26,1,3,44,0,377,33,97,0.34,9,26,0.346,24,71,0.338,18,24,0.75,27,60,87,27,18,5,18,45,93
1135,3,2002,27,1,2,58,34,1383,179,359,0.499,16,54,0.296,163,305,0.534,41,49,0.837,68,161,229,106,75,12,42,142,415
1135,4,2003,28,1,2,74,48,1373,146,337,0.433,6,24,0.25,140,313,0.447,27,32,0.844,88,176,264,105,77,6,47,157,325
1135,5,2004,29,1,2,19,1,133,5,18,0.278,1,2,0.5,4,16,0.25,0,4,0,1,18,19,10,7,2,3,17,11
1135,6,2005,30,1,3,69,1,667,58,161,0.36,2,9,0.222,56,152,0.368,33,44,0.75,52,94,146,53,43,4,30,78,151
1135,7,2006,31,1,2,52,45,1245,98,204,0.48,0,2,0,98,202,0.485,41,53,0.774,75,152,227,89,51,9,39,113,237
1135,8,2007,32,1,3,54,1,585,61,129,0.473,0,6,0,61,123,0.496,15,19,0.789,40,69,109,59,32,4,38,78,137
1135,9,2008,33,1,2,22,2,222,24,60,0.4,0,0,-1,24,60,0.4,3,7,0.429,19,18,37,22,12,1,16,19,51
1135,9,2008,33,1,2,35,2,307,30,76,0.395,0,0,-1,30,76,0.395,5,9,0.556,28,31,59,27,17,2,21,27,65
1139,1,1980,26,1,3,62,-1,1581,221,472,0.468,1,10,0.1,220,462,0.476,95,114,0.833,84,165,249,228,60,47,166,179,538
1139,2,1981,27,1,3,82,-1,1934,253,479,0.528,0,9,0,253,470,0.538,135,159,0.849,126,202,328,251,90,67,151,238,641
1139,3,1982,28,1,3,59,24,1377,173,322,0.537,3,6,0.5,170,316,0.538,78,104,0.75,101,158,259,125,75,41,88,162,427
1139,4,1983,29,1,3,27,3,373,35,82,0.427,1,3,0.333,34,79,0.43,12,19,0.632,32,34,66,34,22,7,24,69,83
1144,1,2006,26,1,2,12,0,108,19,38,0.5,5,15,0.333,14,23,0.609,9,14,0.643,1,16,17,9,7,0,9,14,52
1145,1,1980,24,1,3,80,-1,1397,186,420,0.443,1,2,0.5,185,418,0.443,101,131,0.771,87,145,232,109,56,9,81,151,474
1145,2,1981,25,1,3,79,-1,1584,260,486,0.535,0,0,-1,260,486,0.535,75,101,0.743,31,175,206,205,60,15,88,155,595
1145,3,1982,26,1,2,81,11,1892,420,822,0.511,2,14,0.143,418,808,0.517,188,229,0.821,55,127,182,276,72,39,148,191,1030
1145,4,1983,27,1,3,77,0,1422,167,377,0.443,0,4,0,167,373,0.448,81,98,0.827,42,121,163,136,40,10,84,172,415
1145,5,1984,28,1,2,76,6,1119,166,362,0.459,2,9,0.222,164,353,0.465,64,83,0.771,24,97,121,108,43,7,71,151,398
1145,6,1985,29,1,3,69,0,1061,188,384,0.49,2,8,0.25,186,376,0.495,77,104,0.74,41,110,151,105,50,7,40,129,455
1145,7,1986,30,1,3,76,0,1402,148,355,0.417,26,61,0.426,122,294,0.415,90,108,0.833,42,164,206,119,39,13,50,192,412
1147,1,1993,23,1,4,81,81,2795,484,1135,0.426,38,135,0.281,446,1000,0.446,181,281,0.644,219,562,781,306,134,35,230,195,1187
1147,2,1994,24,1,4,78,78,2795,540,1159,0.466,40,148,0.27,500,1011,0.495,213,311,0.685,189,539,728,276,172,51,247,174,1333
1147,3,1995,25,1,4,6,6,226,33,83,0.398,4,8,0.5,29,75,0.387,26,33,0.788,16,37,53,18,21,11,15,19,96
1147,3,1995,25,1,3,31,17,1018,162,357,0.454,28,88,0.318,134,269,0.498,93,122,0.762,49,173,222,139,61,28,81,86,445
1147,3,1995,25,1,4,40,40,1324,176,397,0.443,28,90,0.311,148,307,0.482,55,97,0.567,100,197,297,122,50,23,93,98,435
1147,3,1995,25,1,3,77,63,2568,371,837,0.443,60,186,0.323,311,651,0.478,174,252,0.69,165,407,572,279,132,62,189,203,976
1147,4,1996,26,1,4,78,78,2835,473,1004,0.471,26,86,0.302,447,918,0.487,289,374,0.773,176,514,690,238,139,96,234,265,1261
1147,5,1997,27,1,4,81,81,3131,592,1339,0.442,24,93,0.258,568,1246,0.456,464,566,0.82,187,515,702,335,130,89,293,237,1672
1147,6,1998,28,1,3,41,41,1582,319,635,0.502,2,17,0.118,317,618,0.513,183,223,0.821,106,250,356,167,61,22,109,102,823
1147,7,1999,29,1,4,43,43,1563,277,573,0.483,2,7,0.286,275,566,0.486,173,218,0.794,131,250,381,121,59,21,88,110,729
1147,8,2000,30,1,4,54,54,1767,310,645,0.481,1,8,0.125,309,637,0.485,117,151,0.775,141,284,425,124,80,31,106,152,738
1147,9,2001,31,1,4,57,2,1159,149,380,0.392,3,12,0.25,146,368,0.397,61,77,0.792,76,179,255,55,47,21,51,110,362
1147,10,2002,32,1,4,44,40,1129,127,301,0.422,3,9,0.333,124,292,0.425,28,37,0.757,59,162,221,77,39,30,61,116,285
1147,11,2003,33,1,4,27,11,447,60,132,0.455,0,1,0,60,131,0.458,9,9,1,25,75,100,31,14,5,31,35,129
1147,12,2004,34,1,4,30,3,304,31,99,0.313,0,1,0,31,98,0.316,6,8,0.75,15,41,56,21,14,4,20,34,68
1147,12,2004,34,1,4,25,24,515,39,104,0.375,1,3,0.333,38,101,0.376,14,20,0.7,50,81,131,42,17,8,19,47,93
1147,12,2004,34,1,4,55,27,819,70,203,0.345,1,4,0.25,69,199,0.347,20,28,0.714,65,122,187,63,31,12,39,81,161
1147,13,2005,35,1,4,20,0,218,11,37,0.297,0,0,-1,11,37,0.297,4,6,0.667,15,28,43,12,9,4,9,23,26
1147,13,2005,35,1,4,27,9,748,88,204,0.431,8,26,0.308,80,178,0.449,29,37,0.784,41,107,148,56,32,13,48,81,213
1147,13,2005,35,1,4,47,9,966,99,241,0.411,8,26,0.308,91,215,0.423,33,43,0.767,56,135,191,68,41,17,57,104,239
1148,1,1995,26,1,4,17,0,167,16,47,0.34,0,4,0,16,43,0.372,13,19,0.684,16,29,45,10,8,1,12,29,45
1150,1,1993,23,1,5,32,5,215,19,55,0.345,0,0,-1,19,55,0.345,13,25,0.52,26,38,64,17,9,10,10,48,51
1150,2,1994,24,1,5,32,0,131,16,32,0.5,0,0,-1,16,32,0.5,15,21,0.714,15,18,33,3,4,5,16,23,47
1153,1,2001,22,1,1,33,8,630,78,192,0.406,27,69,0.391,51,123,0.415,15,18,0.833,10,26,36,64,9,5,24,35,198
1153,2,2002,23,1,1,45,6,607,88,244,0.361,46,123,0.374,42,121,0.347,22,27,0.815,12,32,44,81,10,7,37,23,244
1154,1,1991,22,1,4,43,0,290,55,116,0.474,0,0,-1,55,116,0.474,25,44,0.568,27,62,89,12,4,12,22,39,135
1154,2,1992,23,1,4,71,1,934,178,361,0.493,0,0,-1,178,361,0.493,76,101,0.752,81,179,260,30,25,16,66,132,432
1154,3,1993,24,1,4,12,0,159,26,56,0.464,0,1,0,26,55,0.473,12,16,0.75,12,25,37,10,6,4,13,24,64
1154,3,1993,24,1,4,63,52,1152,219,417,0.525,0,0,-1,219,417,0.525,76,100,0.76,114,186,300,17,19,22,84,165,514
1154,3,1993,24,1,4,75,52,1311,245,473,0.518,0,1,0,245,472,0.519,88,116,0.759,126,211,337,27,25,26,97,189,578
1154,4,1994,25,1,4,13,0,159,24,55,0.436,0,0,-1,24,55,0.436,16,25,0.64,12,34,46,3,2,3,17,20,64
1154,5,1995,26,1,4,51,0,476,117,220,0.532,0,2,0,117,218,0.537,20,35,0.571,34,72,106,13,15,12,40,102,254
1154,5,1995,26,1,4,54,0,506,118,231,0.511,0,2,0,118,229,0.515,20,35,0.571,37,77,114,13,15,12,45,104,256
1156,1,1980,32,1,5,82,-1,3143,835,1383,0.604,0,1,0,835,1382,0.604,364,476,0.765,190,696,886,371,81,280,297,216,2034
1156,2,1981,33,1,5,80,-1,2976,836,1457,0.574,0,1,0,836,1456,0.574,423,552,0.766,197,624,821,272,59,228,249,244,2095
1156,3,1982,34,1,5,76,76,2677,753,1301,0.579,0,3,0,753,1298,0.58,312,442,0.706,172,487,659,225,63,207,230,224,1818
1156,4,1983,35,1,5,79,79,2554,722,1228,0.588,0,2,0,722,1226,0.589,278,371,0.749,167,425,592,200,61,170,200,220,1722
1156,5,1984,36,1,5,80,80,2622,716,1238,0.578,0,1,0,716,1237,0.579,285,394,0.723,169,418,587,211,55,143,221,211,1717
1156,6,1985,37,1,5,79,79,2630,723,1207,0.599,0,1,0,723,1206,0.6,289,395,0.732,162,460,622,249,63,162,197,238,1735
1156,7,1986,38,1,5,79,79,2629,755,1338,0.564,0,2,0,755,1336,0.565,336,439,0.765,133,345,478,280,67,130,203,248,1846
1156,8,1987,39,1,5,78,78,2441,560,993,0.564,1,3,0.333,559,990,0.565,245,343,0.714,152,371,523,203,49,97,186,245,1366
1156,9,1988,40,1,5,80,80,2308,480,903,0.532,0,1,0,480,902,0.532,205,269,0.762,118,360,478,135,48,92,159,216,1165
1156,10,1989,41,1,5,74,74,1695,313,659,0.475,0,3,0,313,656,0.477,122,165,0.739,103,231,334,74,38,85,95,196,748
1159,1,1998,23,1,2,59,16,959,144,357,0.403,4,19,0.211,140,338,0.414,84,125,0.672,44,72,116,51,35,13,65,81,376
1159,2,1999,24,1,2,49,49,1205,177,407,0.435,6,21,0.286,171,386,0.443,94,136,0.691,72,114,186,50,50,16,70,121,454
1159,3,2000,25,1,2,15,10,373,51,131,0.389,1,2,0.5,50,129,0.388,31,42,0.738,24,28,52,26,6,12,19,31,134
1159,3,2000,25,1,2,46,46,1205,223,515,0.433,2,21,0.095,221,494,0.447,115,151,0.762,77,162,239,72,53,16,87,116,563
1159,3,2000,25,1,2,61,56,1578,274,646,0.424,3,23,0.13,271,623,0.435,146,193,0.756,101,190,291,98,59,28,106,147,697
1159,4,2001,26,1,2,29,12,420,43,111,0.387,4,10,0.4,39,101,0.386,21,36,0.583,14,45,59,22,14,13,34,54,111
1159,5,2002,27,1,2,20,12,417,55,145,0.379,1,2,0.5,54,143,0.378,24,32,0.75,39,39,78,22,18,9,24,51,135
1159,5,2002,27,1,2,24,12,441,55,147,0.374,1,2,0.5,54,145,0.372,24,33,0.727,41,43,84,24,20,10,27,56,135
1159,6,2003,28,1,2,14,0,204,27,58,0.466,0,1,0,27,57,0.474,3,6,0.5,14,26,40,21,6,3,7,26,57
1160,1,1997,20,1,4,80,71,2802,550,1214,0.453,7,27,0.259,543,1187,0.457,387,519,0.746,216,339,555,175,79,79,225,199,1494
1160,2,1998,21,1,3,82,82,2950,653,1347,0.485,21,51,0.412,632,1296,0.488,502,640,0.784,227,354,581,213,89,76,257,201,1829
1160,3,1999,22,1,3,50,50,2021,386,893,0.432,11,36,0.306,375,857,0.438,369,439,0.841,114,260,374,172,69,55,186,137,1152
1160,4,2000,23,1,3,82,82,3223,594,1277,0.465,29,96,0.302,565,1181,0.478,446,551,0.809,218,607,825,271,89,87,249,244,1663
1160,5,2001,24,1,3,81,81,3241,604,1280,0.472,12,64,0.188,592,1216,0.487,443,531,0.834,175,560,735,250,90,77,231,238,1663
1160,6,2002,25,1,4,77,77,2980,598,1297,0.461,21,70,0.3,577,1227,0.47,419,523,0.801,198,498,696,239,98,81,250,214,1636
1160,7,2003,26,1,4,81,81,3087,566,1183,0.478,21,60,0.35,545,1123,0.485,455,541,0.841,175,502,677,242,87,38,212,240,1608
1160,8,2004,27,1,4,32,3,728,118,264,0.447,4,11,0.364,114,253,0.451,79,95,0.832,48,96,144,47,24,18,53,75,319
1160,8,2004,27,1,4,53,53,1956,383,790,0.485,5,23,0.217,378,767,0.493,294,334,0.88,141,354,495,127,44,19,131,147,1065
1160,8,2004,27,1,4,85,56,2684,501,1054,0.475,9,34,0.265,492,1020,0.482,373,429,0.869,189,450,639,174,68,37,184,222,1384
1160,9,2005,28,1,4,54,49,1867,337,670,0.503,15,39,0.385,322,631,0.51,220,254,0.866,123,269,392,111,49,26,117,150,909
1160,10,2006,29,1,4,72,30,1961,332,632,0.525,5,22,0.227,327,610,0.536,218,278,0.784,106,251,357,149,48,42,108,227,887
1160,11,2007,30,1,5,80,45,2015,310,654,0.474,3,20,0.15,307,634,0.484,170,234,0.726,122,276,398,109,53,40,116,243,793
1161,1,1980,25,1,4,67,-1,1222,153,318,0.481,0,1,0,153,317,0.483,56,82,0.683,62,129,191,87,35,12,39,118,362
1161,2,1981,26,1,3,29,-1,259,24,56,0.429,0,1,0,24,55,0.436,11,19,0.579,19,21,40,18,6,3,6,29,59
1161,2,1981,26,1,3,39,-1,298,25,59,0.424,0,1,0,25,58,0.431,13,22,0.591,20,28,48,19,7,3,8,34,63
1165,1,1988,25,1,5,79,5,1151,108,203,0.532,0,0,-1,108,203,0.532,71,111,0.64,105,165,270,42,29,27,54,198,287
1165,2,1989,26,1,5,62,0,632,55,114,0.482,1,1,1,54,113,0.478,26,48,0.542,59,87,146,19,19,6,23,94,137
1165,3,1990,27,1,5,80,50,1691,138,285,0.484,3,4,0.75,135,281,0.48,83,120,0.692,154,277,431,67,36,25,70,248,362
1165,4,1991,28,1,5,68,0,1313,109,214,0.509,1,3,0.333,108,211,0.512,66,101,0.653,140,219,359,25,25,25,42,218,285
1165,5,1992,29,1,5,68,6,926,78,151,0.517,1,3,0.333,77,148,0.52,51,67,0.761,97,155,252,22,25,15,33,140,208
1165,6,1993,30,1,5,12,7,246,24,40,0.6,0,0,-1,24,40,0.6,10,14,0.714,24,37,61,5,3,6,11,32,58
1165,6,1993,30,1,5,18,7,269,26,49,0.531,1,2,0.5,25,47,0.532,11,16,0.688,26,41,67,5,3,6,13,34,64
1167,1,1980,25,1,5,75,-1,2168,465,875,0.531,0,2,0,465,873,0.533,188,236,0.797,158,451,609,322,108,55,218,237,1118
1167,2,1981,26,1,5,75,-1,2054,458,870,0.526,0,0,-1,458,870,0.526,199,259,0.768,157,389,546,344,106,69,226,226,1115
1167,3,1982,27,1,5,79,75,2393,507,1027,0.494,0,1,0,507,1026,0.494,182,233,0.781,138,448,586,356,114,78,196,269,1196
1167,4,1983,28,1,5,80,75,2447,477,981,0.486,1,3,0.333,476,978,0.487,180,217,0.829,161,387,548,376,114,74,242,287,1135
1167,5,1984,29,1,5,70,13,1452,269,582,0.462,0,4,0,269,578,0.465,132,160,0.825,118,201,319,219,73,31,117,195,670
1167,6,1985,30,1,4,82,69,2136,476,915,0.52,0,0,-1,476,915,0.52,250,283,0.883,153,347,500,308,115,48,197,254,1202
1167,7,1986,31,1,5,78,45,2005,341,679,0.502,0,2,0,341,677,0.504,159,203,0.783,148,329,477,324,103,46,206,272,841
1167,8,1987,32,1,5,68,40,1690,311,618,0.503,0,1,0,311,617,0.504,134,170,0.788,91,247,338,223,62,37,139,207,756
1167,9,1988,33,1,5,82,25,1646,251,506,0.496,1,2,0.5,250,504,0.496,108,128,0.844,118,247,365,183,82,41,140,245,611
1168,1,1986,23,1,1,18,0,139,16,44,0.364,0,3,0,16,41,0.39,8,12,0.667,2,4,6,22,9,1,11,9,40
1168,2,1987,24,1,1,63,0,1303,160,393,0.407,28,102,0.275,132,291,0.454,105,124,0.847,38,85,123,244,85,6,81,88,453
1168,3,1988,25,1,1,82,75,2778,416,927,0.449,139,379,0.367,277,548,0.505,166,199,0.834,40,183,223,503,168,16,144,138,1137
1168,4,1989,26,1,1,77,77,2787,468,1082,0.433,166,466,0.356,302,616,0.49,322,393,0.819,71,212,283,490,166,11,180,149,1424
1168,5,1990,27,1,1,79,74,2690,398,989,0.402,158,432,0.366,240,557,0.431,267,314,0.85,49,176,225,495,121,3,141,133,1221
1168,6,1991,28,1,1,66,66,2346,560,1421,0.394,167,564,0.296,393,857,0.459,465,529,0.879,58,198,256,693,147,6,240,162,1752
1168,7,1992,29,1,1,78,78,2795,485,1233,0.393,125,386,0.324,360,847,0.425,313,360,0.869,58,252,310,594,145,9,212,162,1408
1168,8,1993,30,1,1,70,70,2499,365,831,0.439,68,212,0.321,297,619,0.48,237,277,0.856,52,188,240,526,100,4,175,146,1035
1168,9,1994,31,1,1,70,67,2337,285,698,0.408,55,191,0.288,230,507,0.454,224,270,0.83,37,146,183,480,96,6,167,140,849
1168,10,1995,32,1,1,29,0,443,67,148,0.453,29,81,0.358,38,67,0.567,25,30,0.833,6,23,29,95,23,1,26,41,188
1168,11,1996,33,1,1,21,3,329,37,83,0.446,14,41,0.341,23,42,0.548,26,35,0.743,5,17,22,67,21,4,25,25,114
1172,1,1982,22,1,3,51,20,1468,381,820,0.465,25,71,0.352,356,749,0.475,168,247,0.68,89,160,249,164,37,22,135,152,955
1172,2,1983,23,1,3,81,75,2784,767,1589,0.483,16,76,0.211,751,1513,0.496,429,589,0.728,191,317,508,332,80,26,261,247,1979
1172,3,1984,24,1,3,79,79,2900,925,1765,0.524,15,56,0.268,910,1709,0.532,465,621,0.749,161,308,469,358,80,22,285,246,2330
1172,4,1985,25,1,3,80,79,2699,794,1569,0.506,27,85,0.318,767,1484,0.517,440,580,0.759,188,289,477,249,60,24,253,250,2055
1172,5,1986,26,1,3,74,73,2501,668,1327,0.503,16,56,0.286,652,1271,0.513,318,451,0.705,177,268,445,339,62,14,252,229,1670
1172,6,1987,27,1,3,80,80,2663,787,1590,0.495,53,150,0.353,734,1440,0.51,429,557,0.77,181,246,427,254,84,30,217,243,2056
1172,7,1988,28,1,3,77,77,2610,746,1571,0.475,52,172,0.302,694,1399,0.496,388,504,0.77,182,252,434,278,70,57,203,223,1932
1172,8,1989,29,1,3,36,32,1068,213,441,0.483,22,75,0.293,191,366,0.522,110,149,0.738,56,95,151,89,16,7,68,101,558
1172,8,1989,29,1,3,44,44,1529,373,829,0.45,29,99,0.293,344,730,0.471,178,244,0.73,90,145,235,189,29,29,140,128,953
1172,8,1989,29,1,3,80,76,2597,586,1270,0.461,51,174,0.293,535,1096,0.488,288,393,0.733,146,240,386,278,45,36,208,229,1511
1172,9,1990,30,1,3,78,40,2005,438,898,0.488,31,93,0.333,407,805,0.506,192,254,0.756,117,188,305,145,34,19,121,201,1099
1172,10,1991,31,1,3,78,13,2006,420,909,0.462,24,78,0.308,396,831,0.477,240,317,0.757,134,240,374,139,47,20,128,209,1104
1172,11,1992,32,1,3,75,12,1582,339,787,0.431,15,71,0.211,324,716,0.453,158,230,0.687,67,169,236,126,51,11,105,171,851
1172,12,1993,33,1,3,51,15,1056,187,422,0.443,30,83,0.361,157,339,0.463,99,129,0.767,43,109,152,105,16,7,68,101,503
1172,13,1994,34,1,3,39,0,859,163,348,0.468,37,93,0.398,126,255,0.494,50,72,0.694,28,88,116,104,21,8,70,98,413
1173,1,1982,22,1,2,53,1,564,79,221,0.357,5,17,0.294,74,204,0.363,56,65,0.862,25,31,56,87,37,3,53,86,219
1173,2,1983,23,1,2,80,76,2048,357,720,0.496,5,29,0.172,352,691,0.509,72,97,0.742,83,131,214,251,109,6,98,259,791
1173,3,1984,24,1,2,71,3,1154,166,361,0.46,6,22,0.273,160,339,0.472,46,56,0.821,29,87,116,162,41,4,70,143,384
1173,4,1985,25,1,2,75,73,2564,419,792,0.529,15,56,0.268,404,736,0.549,118,136,0.868,76,192,268,399,122,6,149,228,971
1173,5,1986,26,1,2,80,78,2407,353,701,0.504,26,73,0.356,327,628,0.521,123,136,0.904,47,188,235,405,94,7,129,204,855
1173,6,1987,27,1,2,71,66,2499,410,844,0.486,85,192,0.443,325,652,0.498,148,165,0.897,49,193,242,400,101,14,141,189,1053
1173,7,1988,28,1,2,81,81,3018,482,982,0.491,148,357,0.415,334,625,0.534,158,180,0.878,59,190,249,503,115,17,153,203,1270
1173,8,1989,29,1,1,28,26,1028,209,462,0.452,58,150,0.387,151,312,0.484,91,112,0.813,34,67,101,187,41,7,63,78,567
1173,8,1989,29,1,1,45,28,1349,271,589,0.46,58,155,0.374,213,434,0.491,114,128,0.891,37,117,154,215,52,1,82,108,714
1173,8,1989,29,1,1,73,54,2377,480,1051,0.457,116,305,0.38,364,746,0.488,205,240,0.854,71,184,255,402,93,8,145,186,1281
1173,9,1990,30,1,1,75,68,2727,506,1154,0.438,108,289,0.374,398,865,0.46,222,267,0.831,69,257,326,453,113,18,185,238,1342
1173,10,1991,31,1,2,80,0,1710,337,714,0.472,102,251,0.406,235,463,0.508,114,138,0.826,45,160,205,285,63,13,100,195,890
1173,11,1992,32,1,2,81,6,1595,299,676,0.442,78,230,0.339,221,446,0.496,108,131,0.824,40,108,148,202,73,13,70,148,784
1173,12,1993,33,1,2,80,0,2163,337,730,0.462,150,372,0.403,187,358,0.522,123,145,0.848,49,165,214,260,69,8,113,175,947
1173,13,1994,34,1,2,68,1,1555,224,537,0.417,80,244,0.328,144,293,0.491,78,94,0.83,28,103,131,180,57,8,81,140,606
1173,14,1995,35,1,2,74,1,1374,194,422,0.46,78,214,0.364,116,208,0.558,105,130,0.808,25,84,109,210,46,7,79,155,571
1176,1,1987,23,1,4,64,25,1110,217,443,0.49,2,9,0.222,215,434,0.495,67,101,0.663,73,141,214,74,22,28,56,138,503
1176,2,1988,24,1,4,63,0,769,144,300,0.48,4,18,0.222,140,282,0.496,35,49,0.714,70,90,160,39,10,12,50,107,327
1176,3,1989,25,1,4,74,5,1141,206,431,0.478,13,38,0.342,193,393,0.491,73,87,0.839,103,152,255,63,25,22,62,160,498
1176,4,1990,26,1,4,82,10,1893,371,785,0.473,10,49,0.204,361,736,0.49,108,133,0.812,151,223,374,142,60,39,101,219,860
1176,5,1991,27,1,4,42,1,587,99,225,0.44,5,21,0.238,94,204,0.461,41,48,0.854,41,76,117,45,15,8,40,88,244
1178,1,1985,25,1,5,74,4,1114,161,337,0.478,0,1,0,161,336,0.479,55,75,0.733,87,183,270,36,15,15,72,171,377
1179,1,2001,23,1,1,38,6,472,62,178,0.348,3,10,0.3,59,168,0.351,33,45,0.733,20,43,63,21,16,3,21,76,160
1179,1,2001,23,1,1,27,18,910,177,395,0.448,14,36,0.389,163,359,0.454,90,105,0.857,22,58,80,41,29,2,54,63,458
1179,1,2001,23,1,1,65,24,1382,239,573,0.417,17,46,0.37,222,527,0.421,123,150,0.82,42,101,143,62,45,5,75,139,618
1179,2,2002,24,1,2,56,28,1325,223,474,0.47,5,18,0.278,218,456,0.478,98,121,0.81,43,105,148,86,35,7,60,113,549
1179,3,2003,25,1,1,66,7,1360,193,505,0.382,19,57,0.333,174,448,0.388,118,146,0.808,39,79,118,79,31,6,68,125,523
1181,1,2009,22,1,3,59,0,716,102,245,0.416,16,46,0.348,86,199,0.432,58,83,0.699,44,71,115,42,15,29,52,107,278
1182,1,1990,25,1,2,63,6,746,106,239,0.444,0,7,0,106,232,0.457,23,43,0.535,49,89,138,23,16,19,28,102,235
1183,1,1996,23,1,2,41,0,362,36,105,0.343,10,33,0.303,26,72,0.361,26,36,0.722,5,20,25,49,21,5,34,42,108
1183,2,1997,24,1,2,25,0,251,21,74,0.284,7,34,0.206,14,40,0.35,15,25,0.6,12,21,33,43,4,4,13,17,64
1183,2,1997,24,1,2,51,1,692,57,147,0.388,23,59,0.39,34,88,0.386,27,47,0.574,13,52,65,109,27,0,56,67,164
1183,2,1997,24,1,2,76,1,943,78,221,0.353,30,93,0.323,48,128,0.375,42,72,0.583,25,73,98,152,31,4,69,84,228
1184,1,1988,23,1,1,28,0,197,21,55,0.382,1,8,0.125,20,47,0.426,16,17,0.941,3,20,23,23,17,3,12,23,59
1184,2,1989,24,1,1,57,3,868,145,313,0.463,20,53,0.377,125,260,0.481,49,59,0.831,10,59,69,83,44,3,44,54,359
1184,2,1989,24,1,1,66,3,906,148,324,0.457,20,55,0.364,128,269,0.476,50,61,0.82,10,62,72,92,45,3,45,57,366
1184,3,1990,25,1,1,41,0,302,63,138,0.457,7,22,0.318,56,116,0.483,35,37,0.946,2,23,25,39,15,3,16,22,168
1184,4,1991,26,1,1,34,0,236,59,117,0.504,7,23,0.304,52,94,0.553,26,31,0.839,10,14,24,22,8,1,16,11,151
1188,1,2002,23,1,4,12,2,161,22,51,0.431,0,1,0,22,50,0.44,8,10,0.8,15,23,38,5,3,8,2,16,52
1188,2,2003,24,1,4,80,73,2318,335,790,0.424,0,4,0,335,786,0.426,97,121,0.802,134,291,425,54,37,78,128,234,767
1188,3,2004,25,1,4,45,6,616,83,198,0.419,0,0,-1,83,198,0.419,25,33,0.758,42,77,119,16,12,28,27,81,191
1188,4,2005,26,1,4,14,0,248,35,76,0.461,0,0,-1,35,76,0.461,13,14,0.929,24,28,52,11,4,11,11,29,83
1188,4,2005,26,1,4,22,1,271,49,101,0.485,0,0,-1,49,101,0.485,13,14,0.929,16,31,47,7,5,11,7,24,111
1188,4,2005,26,1,4,36,1,519,84,177,0.475,0,0,-1,84,177,0.475,26,28,0.929,40,59,99,18,9,22,18,53,194
1188,5,2006,27,1,4,54,20,701,121,247,0.49,1,1,1,120,246,0.488,23,38,0.605,44,96,140,20,14,16,34,92,266
1188,6,2007,28,1,4,60,1,638,107,258,0.415,0,1,0,107,257,0.416,28,34,0.824,42,77,119,16,17,16,21,85,242
1188,7,2008,29,1,4,25,4,333,33,66,0.5,0,0,-1,33,66,0.5,11,12,0.917,24,44,68,15,4,10,13,60,77
1188,7,2008,29,1,4,48,12,763,124,261,0.475,1,2,0.5,123,259,0.475,12,13,0.923,42,86,128,29,15,21,32,89,261
1188,7,2008,29,1,4,73,16,1096,157,327,0.48,1,2,0.5,156,325,0.48,23,25,0.92,66,130,196,44,19,31,45,149,338
1188,8,2009,30,1,4,49,3,579,73,170,0.429,0,1,0,73,169,0.432,10,21,0.476,35,68,103,35,7,12,20,89,156
1188,9,2010,31,1,4,51,3,456,46,116,0.397,1,6,0.167,45,110,0.409,12,13,0.923,36,46,82,16,11,5,22,68,105
1188,10,2011,32,1,4,18,0,178,11,31,0.355,0,0,-1,11,31,0.355,1,2,0.5,12,20,32,4,1,4,3,30,23
1192,1,1981,22,1,4,22,-1,276,23,67,0.343,0,1,0,23,66,0.348,13,22,0.591,19,46,65,25,5,8,23,51,59
1193,1,1995,22,1,5,64,1,1032,120,258,0.465,0,4,0,120,254,0.472,59,120,0.492,98,121,219,33,39,35,53,107,299
1193,2,1996,23,1,5,73,41,1614,198,387,0.512,1,3,0.333,197,384,0.513,55,112,0.491,127,175,302,61,56,52,59,191,452
1194,1,2000,23,1,1,27,0,361,27,95,0.284,3,14,0.214,24,81,0.296,3,4,0.75,5,18,23,70,12,0,29,29,60
1194,2,2001,24,1,1,37,2,288,30,84,0.357,8,30,0.267,22,54,0.407,9,13,0.692,4,27,31,68,13,0,20,27,77
1194,3,2002,25,1,1,50,7,600,66,191,0.346,27,71,0.38,39,120,0.325,18,29,0.621,10,62,72,143,32,2,40,42,177
1194,4,2003,26,1,1,47,4,980,139,335,0.415,51,130,0.392,88,205,0.429,37,54,0.685,21,86,107,192,38,15,86,120,366
1194,5,2004,27,1,1,82,28,2581,287,764,0.376,161,434,0.371,126,330,0.382,103,134,0.769,26,200,226,372,114,18,128,212,838
1194,6,2005,28,1,1,80,78,2717,403,974,0.414,139,389,0.357,264,585,0.451,191,258,0.74,42,237,279,514,118,7,170,212,1136
1194,7,2006,29,1,1,63,63,2431,280,738,0.379,102,312,0.327,178,426,0.418,99,143,0.692,36,219,255,425,101,15,157,194,761
1194,8,2007,30,1,1,82,82,3040,383,1020,0.375,192,529,0.363,191,491,0.389,130,177,0.734,29,253,282,444,129,10,170,195,1088
1194,9,2008,31,1,1,74,74,2526,364,924,0.394,143,407,0.351,221,517,0.427,98,137,0.715,28,232,260,392,98,18,160,139,969
1194,10,2009,32,1,1,29,28,856,123,298,0.413,32,101,0.317,91,197,0.462,70,99,0.707,8,75,83,148,51,3,52,63,348
1194,10,2009,32,1,1,48,48,1591,193,522,0.37,80,230,0.348,113,292,0.387,86,109,0.789,25,119,144,258,57,7,88,72,552
1194,10,2009,32,1,1,77,76,2447,316,820,0.385,112,331,0.338,204,489,0.417,156,208,0.75,33,194,227,406,108,10,140,135,900
1194,11,2010,33,1,1,25,25,655,60,169,0.355,30,81,0.37,30,88,0.341,15,27,0.556,4,50,54,72,23,5,34,53,165
1194,11,2010,33,1,1,27,13,766,95,277,0.343,28,87,0.322,67,190,0.353,44,54,0.815,9,66,75,104,27,5,61,50,262
1194,11,2010,33,1,1,52,38,1421,155,446,0.348,58,168,0.345,97,278,0.349,59,81,0.728,13,116,129,176,50,10,95,103,427
1196,1,1996,24,1,4,54,34,1104,121,252,0.48,0,1,0,121,251,0.482,97,149,0.651,114,189,303,33,22,10,57,151,339
1196,2,1997,25,1,4,31,0,144,12,40,0.3,1,1,1,11,39,0.282,15,28,0.536,19,33,52,3,7,3,10,29,40
1198,1,2010,29,1,5,63,0,891,147,340,0.432,27,78,0.346,120,262,0.458,46,67,0.687,54,154,208,44,15,12,37,119,367
1198,2,2011,30,1,4,11,0,150,23,47,0.489,3,10,0.3,20,37,0.541,7,7,1,8,26,34,7,3,3,8,11,56
1198,2,2011,30,1,4,29,0,223,33,74,0.446,5,13,0.385,28,61,0.459,7,15,0.467,12,38,50,6,2,6,14,29,78
1198,2,2011,30,1,4,40,0,373,56,121,0.463,8,23,0.348,48,98,0.49,14,22,0.636,20,64,84,13,5,9,22,40,134
1203,1,1998,23,1,3,66,13,1839,239,586,0.408,17,84,0.202,222,502,0.442,275,315,0.873,55,132,187,227,86,13,128,136,770
1203,2,1999,24,1,2,38,13,978,125,314,0.398,21,69,0.304,104,245,0.424,138,165,0.836,20,89,109,145,48,4,82,73,409
1203,3,2000,25,1,2,64,58,2201,377,860,0.438,55,178,0.309,322,682,0.472,271,309,0.877,80,178,258,220,90,11,167,149,1080
1203,4,2001,26,1,2,82,82,2859,413,993,0.416,101,253,0.399,312,740,0.422,342,402,0.851,75,288,363,301,120,14,165,188,1269
1203,5,2002,27,1,2,70,27,1860,247,612,0.404,85,228,0.373,162,384,0.422,178,208,0.856,47,142,189,216,68,8,87,113,757
1203,6,2003,28,1,1,76,76,2556,355,832,0.427,116,331,0.35,239,501,0.477,231,269,0.859,53,211,264,325,90,16,128,141,1057
1203,7,2004,29,1,2,51,46,1810,230,612,0.376,79,259,0.305,151,353,0.428,155,188,0.824,26,156,182,228,66,3,90,79,694
1203,8,2005,30,1,2,47,32,1239,152,391,0.389,58,151,0.384,94,240,0.392,70,87,0.805,25,103,128,143,36,4,70,89,432
1203,9,2006,31,1,2,23,3,465,40,130,0.308,21,67,0.313,19,63,0.302,32,38,0.842,9,51,60,48,8,2,17,49,133
1203,9,2006,31,1,2,20,8,582,68,173,0.393,19,67,0.284,49,106,0.462,61,73,0.836,12,71,83,53,15,4,37,49,216
1203,9,2006,31,1,2,43,11,1047,108,303,0.356,40,134,0.299,68,169,0.402,93,111,0.838,21,122,143,101,23,6,54,98,349
1203,10,2007,32,1,3,50,32,1190,126,294,0.429,54,152,0.355,72,142,0.507,93,106,0.877,29,84,113,133,52,7,56,115,399
1203,11,2008,33,1,2,28,0,396,47,125,0.376,19,52,0.365,28,73,0.384,28,38,0.737,9,43,52,44,12,1,25,49,141
1207,1,1983,22,1,3,52,2,1154,182,357,0.51,0,3,0,182,354,0.514,99,172,0.576,115,167,282,66,62,21,74,147,463
1207,1,1983,22,1,3,65,2,1202,190,379,0.501,0,4,0,190,375,0.507,100,175,0.571,119,175,294,67,63,21,79,153,480
1207,2,1984,23,1,3,48,0,311,55,130,0.423,0,3,0,55,127,0.433,12,29,0.414,38,25,63,22,15,9,20,28,122
1207,3,1985,24,1,3,44,0,457,61,149,0.409,0,2,0,61,147,0.415,27,45,0.6,29,53,82,21,29,9,32,70,149
1210,1,1989,22,1,1,36,12,730,73,175,0.417,1,7,0.143,72,168,0.429,57,82,0.695,44,45,89,153,44,3,84,64,204
1211,1,1989,22,1,3,81,79,2738,640,1285,0.498,4,21,0.19,636,1264,0.503,224,289,0.775,152,265,417,372,150,62,261,295,1508
1211,2,1990,23,1,2,82,81,2788,532,1082,0.492,7,26,0.269,525,1056,0.497,217,290,0.748,115,257,372,364,111,58,198,252,1288
1211,3,1991,24,1,2,75,75,2592,453,991,0.457,7,35,0.2,446,956,0.467,170,213,0.798,68,283,351,358,79,46,167,226,1083
1211,4,1992,25,1,2,57,55,1889,312,685,0.455,13,56,0.232,299,629,0.475,107,138,0.775,62,238,300,302,54,51,140,151,744
1211,5,1993,26,1,2,38,7,560,80,186,0.43,1,8,0.125,79,178,0.444,22,28,0.786,7,50,57,79,14,6,44,52,183
1211,6,1994,27,1,2,80,79,2488,394,837,0.471,22,68,0.324,372,769,0.484,145,171,0.848,68,174,242,347,71,46,153,187,955
1211,7,1995,28,1,2,38,11,556,76,162,0.469,3,19,0.158,73,143,0.51,30,41,0.732,15,40,55,52,26,10,38,71,185
1211,8,1996,29,1,2,27,2,496,56,133,0.421,5,25,0.2,51,108,0.472,19,31,0.613,13,47,60,48,17,8,24,59,136
1211,8,1996,29,1,2,49,42,1564,232,527,0.44,29,95,0.305,203,432,0.47,113,132,0.856,35,151,186,149,58,51,119,171,606
1211,8,1996,29,1,2,76,44,2060,288,660,0.436,34,120,0.283,254,540,0.47,132,163,0.81,48,198,246,197,75,59,143,230,742
1211,9,1997,30,1,2,28,1,303,29,64,0.453,8,19,0.421,21,45,0.467,17,20,0.85,15,27,42,34,14,4,19,36,83
1213,1,1990,22,1,2,81,9,1785,372,753,0.494,1,17,0.059,371,736,0.504,186,264,0.705,107,209,316,124,69,34,138,140,931
1213,2,1991,23,1,2,70,42,1971,400,857,0.467,17,58,0.293,383,799,0.479,173,259,0.668,92,294,386,106,74,44,113,145,990
1213,3,1992,24,1,2,60,59,2203,482,1042,0.463,30,85,0.353,452,957,0.472,202,303,0.667,98,286,384,163,97,33,126,132,1196
1213,4,1993,25,1,2,79,76,2920,594,1324,0.449,88,249,0.353,506,1075,0.471,298,402,0.741,122,355,477,265,128,56,164,200,1574
1213,5,1994,26,1,2,81,81,2811,504,1054,0.478,101,314,0.322,403,740,0.545,168,250,0.672,113,363,476,294,134,33,165,148,1277
1213,6,1995,27,1,2,76,76,2588,439,923,0.476,179,431,0.415,260,492,0.528,143,203,0.704,85,250,335,314,125,22,141,124,1200
1213,7,1996,28,1,2,77,77,2717,400,904,0.442,168,430,0.391,232,474,0.489,166,240,0.692,92,323,415,279,121,46,141,135,1134
1213,8,1997,29,1,2,63,61,2163,288,725,0.397,143,405,0.353,145,320,0.453,38,94,0.404,66,238,304,182,120,32,86,160,757
1213,9,1998,30,1,3,58,44,1701,343,754,0.455,77,214,0.36,266,540,0.493,127,199,0.638,98,199,297,119,72,23,85,98,890
1213,10,1999,31,1,3,47,39,1581,253,640,0.395,96,277,0.347,157,363,0.433,99,162,0.611,51,226,277,91,64,15,83,72,701
1213,11,2000,32,1,2,72,72,2094,306,782,0.391,132,397,0.332,174,385,0.452,37,76,0.487,83,256,339,123,94,16,95,118,781
1213,12,2001,33,1,2,21,0,169,14,57,0.246,10,39,0.256,4,18,0.222,0,0,-1,3,22,25,13,10,4,7,13,38
1213,13,2002,34,1,2,15,0,219,21,76,0.276,13,48,0.271,8,28,0.286,5,9,0.556,1,32,33,14,6,6,14,17,60
1214,1,1985,26,1,3,36,7,520,84,195,0.431,1,2,0.5,83,193,0.43,41,50,0.82,39,49,88,34,9,7,34,40,210
1214,2,1986,27,1,3,17,3,207,37,74,0.5,0,1,0,37,73,0.507,12,16,0.75,5,21,26,8,1,0,6,20,86
1214,2,1986,27,1,3,60,27,1469,273,554,0.493,2,8,0.25,271,546,0.496,73,111,0.658,125,123,248,136,55,6,76,105,621
1214,2,1986,27,1,3,77,30,1676,310,628,0.494,2,9,0.222,308,619,0.498,85,127,0.669,130,144,274,144,56,6,82,125,707
1214,3,1987,28,1,3,63,0,721,139,294,0.473,0,5,0,139,289,0.481,85,108,0.787,73,78,151,54,31,3,55,65,363
1214,4,1988,29,1,3,74,1,1097,217,436,0.498,0,2,0,217,434,0.5,108,141,0.766,89,127,216,78,41,6,73,98,542
1214,5,1989,30,1,3,82,12,2618,566,1152,0.491,2,11,0.182,564,1141,0.494,196,229,0.856,167,239,406,139,71,23,126,166,1330
1214,6,1990,31,1,3,78,3,2089,379,841,0.451,3,21,0.143,376,820,0.459,165,197,0.838,81,214,295,143,72,13,78,143,926
1214,7,1991,32,1,3,82,13,2340,512,1055,0.485,9,43,0.209,503,1012,0.497,165,198,0.833,103,264,367,115,65,13,100,163,1198
1214,8,1992,33,1,3,82,11,2432,469,1008,0.465,42,127,0.331,427,881,0.485,143,163,0.877,96,182,278,135,86,11,109,128,1123
1214,9,1993,34,1,3,69,0,1263,225,544,0.414,39,120,0.325,186,424,0.439,72,89,0.809,62,122,184,93,31,5,63,75,561
1214,10,1994,35,1,3,11,2,176,15,43,0.349,4,12,0.333,11,31,0.355,10,12,0.833,8,18,26,6,5,2,1,9,44
1214,10,1994,35,1,3,10,0,180,20,43,0.465,3,14,0.214,17,29,0.586,9,11,0.818,8,19,27,11,3,1,9,7,52
1214,10,1994,35,1,3,21,2,356,35,86,0.407,7,26,0.269,28,60,0.467,19,23,0.826,16,37,53,17,8,3,10,16,96
1215,1,1997,23,1,2,65,0,1066,147,318,0.462,24,47,0.511,123,271,0.454,68,99,0.687,52,127,179,49,27,8,73,113,386
1215,2,1998,24,1,2,82,2,1602,269,500,0.538,7,32,0.219,262,468,0.56,136,185,0.735,86,141,227,89,66,18,91,145,681
1215,3,1999,25,1,2,50,2,1072,162,363,0.446,14,41,0.341,148,322,0.46,89,125,0.712,49,83,132,56,39,10,66,89,427
1215,4,2000,26,1,3,82,82,2700,368,778,0.473,79,225,0.351,289,553,0.523,194,253,0.767,91,293,384,239,96,32,194,182,1009
1215,5,2001,27,1,2,82,82,2396,263,590,0.446,46,170,0.271,217,420,0.517,138,188,0.734,72,261,333,189,82,40,131,202,710
1215,6,2002,28,1,2,82,6,1596,149,373,0.399,39,141,0.277,110,232,0.474,74,107,0.692,57,192,249,76,48,15,97,134,411
1215,7,2003,29,1,3,82,9,1731,248,537,0.462,52,140,0.371,196,397,0.494,139,190,0.732,64,190,254,87,73,20,114,177,687
1215,8,2004,30,1,2,80,37,1974,238,564,0.422,36,128,0.281,202,436,0.463,123,161,0.764,53,169,222,122,68,17,118,182,635
1215,9,2005,31,1,3,65,5,1151,98,215,0.456,5,28,0.179,93,187,0.497,54,66,0.818,40,150,190,70,40,14,49,136,255
1215,9,2005,31,1,3,66,5,1171,98,217,0.452,5,29,0.172,93,188,0.495,54,66,0.818,41,150,191,70,40,14,50,138,255
1215,10,2006,32,1,3,48,1,638,54,126,0.429,5,19,0.263,49,107,0.458,13,18,0.722,18,63,81,30,17,6,24,75,126
1216,1,1992,21,1,1,64,13,1086,187,480,0.39,3,13,0.231,184,467,0.394,73,98,0.745,38,89,127,203,67,9,97,68,450
1216,2,1993,22,1,1,55,55,2010,370,850,0.435,7,25,0.28,363,825,0.44,180,232,0.776,51,175,226,449,96,11,153,140,927
1216,3,1994,23,1,1,82,82,3135,576,1381,0.417,40,132,0.303,536,1249,0.429,346,423,0.818,89,233,322,784,158,15,266,201,1538
1216,4,1995,24,1,1,72,70,2689,411,1031,0.399,97,294,0.33,314,737,0.426,348,414,0.841,73,177,250,680,103,14,225,184,1267
1216,5,1996,25,1,1,31,28,1042,143,380,0.376,36,99,0.364,107,281,0.381,151,188,0.803,37,64,101,247,52,8,58,73,473
1216,5,1996,25,1,1,38,36,1302,206,454,0.454,56,157,0.357,150,297,0.505,109,150,0.727,26,76,102,328,59,6,88,105,577
1216,5,1996,25,1,1,69,64,2344,349,834,0.418,92,256,0.359,257,578,0.445,260,338,0.769,63,140,203,575,111,14,146,178,1050
1216,6,1997,26,1,1,82,81,3081,485,1137,0.427,132,366,0.361,353,771,0.458,334,435,0.768,91,272,363,584,162,15,193,222,1436
1216,7,1998,27,1,1,16,16,386,64,147,0.435,10,27,0.37,54,120,0.45,41,49,0.837,3,36,39,100,26,0,29,36,179
1216,7,1998,27,1,1,45,40,1472,204,527,0.387,47,133,0.353,157,394,0.398,112,145,0.772,36,98,134,245,61,1,114,99,567
1216,7,1998,27,1,1,61,56,1858,268,674,0.398,57,160,0.356,211,514,0.411,153,194,0.789,39,134,173,345,87,1,143,135,746
1216,8,1999,28,1,1,34,33,1010,161,357,0.451,6,24,0.25,155,333,0.465,84,101,0.832,24,79,103,193,33,2,71,78,412
1216,9,2000,29,1,1,82,82,2593,434,986,0.44,85,220,0.386,349,766,0.456,196,253,0.775,55,170,225,420,139,8,130,230,1149
1216,10,2001,30,1,1,33,28,849,88,227,0.388,11,33,0.333,77,194,0.397,59,71,0.831,16,57,73,134,44,2,52,62,246
1216,11,2002,31,1,1,76,76,2430,312,716,0.436,9,33,0.273,303,683,0.444,98,132,0.742,57,218,275,403,141,10,119,210,731
1216,12,2003,32,1,1,23,1,446,61,150,0.407,1,2,0.5,60,148,0.405,16,22,0.727,14,31,45,77,18,4,42,43,139
1216,12,2003,32,1,1,38,1,689,102,232,0.44,0,5,0,102,227,0.449,29,35,0.829,17,70,87,121,40,1,33,63,233
1216,12,2003,32,1,1,61,2,1135,163,382,0.427,1,7,0.143,162,375,0.432,45,57,0.789,31,101,132,198,58,5,75,106,372
1216,13,2004,33,1,1,44,31,905,113,256,0.441,1,4,0.25,112,252,0.444,35,48,0.729,19,62,81,125,26,5,50,73,262
1216,14,2005,34,1,1,39,20,717,81,190,0.426,6,13,0.462,75,177,0.424,27,37,0.73,23,60,83,98,33,0,46,81,195
1216,14,2005,34,1,1,43,20,743,85,201,0.423,6,13,0.462,79,188,0.42,27,37,0.73,24,64,88,103,33,0,49,87,203
1219,1,1990,22,1,3,72,5,1221,231,465,0.497,0,0,-1,231,465,0.497,164,227,0.722,187,175,362,40,24,17,50,152,626
1219,2,1991,23,1,3,67,1,877,144,263,0.548,0,0,-1,144,263,0.548,91,127,0.717,122,131,253,25,27,7,32,125,379
1220,1,1998,23,1,5,41,8,680,92,231,0.398,3,16,0.188,89,215,0.414,53,74,0.716,53,104,157,35,31,27,41,95,240
1220,2,1999,24,1,5,41,4,470,50,139,0.36,0,7,0,50,132,0.379,34,48,0.708,35,62,97,27,18,13,26,98,134
1220,3,2000,25,1,5,73,11,1007,161,364,0.442,1,6,0.167,160,358,0.447,116,147,0.789,90,190,280,65,29,25,80,180,439
1221,1,1992,24,1,1,82,1,1510,161,435,0.37,8,55,0.145,153,380,0.403,117,158,0.741,33,103,136,314,59,9,98,170,447
1221,2,1993,25,1,1,70,35,1699,174,419,0.415,4,30,0.133,170,389,0.437,107,159,0.673,42,128,170,398,113,12,104,141,459
1221,3,1994,26,1,1,80,36,1994,225,571,0.394,48,160,0.3,177,411,0.431,130,168,0.774,43,146,189,365,114,13,127,163,628
1221,4,1995,27,1,1,61,2,943,128,293,0.437,56,155,0.361,72,138,0.522,60,76,0.789,7,57,64,160,50,7,57,99,372
1221,5,1996,28,1,1,69,68,2096,324,781,0.415,90,271,0.332,234,510,0.459,229,297,0.771,29,145,174,476,116,11,160,137,967
1221,6,1997,29,1,1,65,44,1863,199,507,0.393,88,238,0.37,111,269,0.413,130,178,0.73,25,159,184,407,129,4,129,122,616
1221,7,1998,30,1,1,80,0,1021,150,349,0.43,66,159,0.415,84,190,0.442,53,80,0.663,18,93,111,205,64,3,91,97,419
1221,8,1999,31,1,1,50,0,806,104,251,0.414,49,125,0.392,55,126,0.437,62,89,0.697,14,49,63,100,66,3,55,75,319
1221,9,2000,32,1,1,82,3,1548,169,416,0.406,88,233,0.378,81,183,0.443,88,114,0.772,17,116,133,208,59,9,85,143,514
1221,10,2001,33,1,1,58,0,856,97,253,0.383,65,159,0.409,32,94,0.34,23,35,0.657,21,40,61,82,40,3,43,63,282
1221,11,2002,34,1,1,24,3,553,70,188,0.372,19,73,0.26,51,115,0.443,13,21,0.619,6,38,44,79,28,1,36,42,172
1221,11,2002,34,1,1,36,35,961,113,287,0.394,29,90,0.322,84,197,0.426,47,70,0.671,16,72,88,203,49,4,58,72,302
1221,11,2002,34,1,1,60,38,1514,183,475,0.385,48,163,0.294,135,312,0.433,60,91,0.659,22,110,132,282,77,5,94,114,474
1222,1,2005,24,1,5,59,41,736,76,175,0.434,1,3,0.333,75,172,0.436,43,55,0.782,59,126,185,16,21,8,52,157,196
1222,2,2006,25,1,5,52,34,601,53,145,0.366,0,1,0,53,144,0.368,15,28,0.536,43,101,144,15,24,6,42,104,121
1222,3,2007,26,1,5,28,0,248,27,65,0.415,0,0,-1,27,65,0.415,18,29,0.621,22,44,66,10,6,2,17,39,72
1224,1,2004,23,1,5,30,3,246,8,30,0.267,0,0,-1,8,30,0.267,13,27,0.481,21,29,50,12,13,3,9,49,29
1224,1,2004,23,1,5,32,3,256,9,33,0.273,0,0,-1,9,33,0.273,14,31,0.452,21,31,52,13,14,3,10,50,32
1226,1,2002,20,1,1,47,30,1155,174,384,0.453,39,113,0.345,135,271,0.498,124,160,0.775,41,91,132,174,69,11,97,115,511
1226,2,2003,21,1,1,82,82,2866,509,1180,0.431,109,313,0.348,400,867,0.461,370,468,0.791,97,289,386,514,124,17,290,260,1497
1226,3,2004,22,1,1,55,52,2066,358,914,0.392,125,333,0.375,233,581,0.401,237,317,0.748,55,199,254,275,103,12,226,176,1078
1226,4,2005,23,1,1,80,80,3274,656,1523,0.431,205,562,0.365,451,961,0.469,521,640,0.814,83,295,378,411,139,23,242,245,2038
1226,5,2006,24,1,1,80,80,3384,746,1668,0.447,199,540,0.369,547,1128,0.485,655,799,0.82,59,221,280,484,161,25,297,286,2346
1226,6,2007,25,1,1,74,73,2942,647,1548,0.418,205,584,0.351,442,964,0.459,606,718,0.844,61,277,338,443,139,13,236,249,2105
1226,7,2008,26,1,1,13,8,425,78,196,0.398,22,78,0.282,56,118,0.475,74,96,0.771,6,45,51,66,23,1,49,30,252
1226,8,2010,28,1,1,32,32,1169,253,616,0.411,63,181,0.348,190,435,0.437,153,207,0.739,17,116,133,230,41,9,117,95,722
1226,9,2011,29,1,1,21,14,726,130,330,0.394,47,145,0.324,83,185,0.449,56,67,0.836,6,64,70,117,30,12,71,76,363
1226,9,2011,29,1,1,49,2,1070,139,404,0.344,50,182,0.275,89,222,0.401,64,86,0.744,16,103,119,157,44,9,106,112,392
1226,9,2011,29,1,1,70,16,1796,269,734,0.366,97,327,0.297,172,407,0.423,120,153,0.784,22,167,189,274,74,21,177,188,755
1226,10,2012,30,1,1,17,0,211,26,64,0.406,13,39,0.333,13,25,0.52,7,10,0.7,2,16,18,18,11,1,12,35,72
1231,1,2002,21,1,2,35,0,196,27,85,0.318,5,17,0.294,22,68,0.324,5,10,0.5,10,6,16,8,7,1,8,26,64
1231,2,2004,23,1,2,56,0,434,65,175,0.371,19,52,0.365,46,123,0.374,2,4,0.5,12,31,43,14,12,2,24,49,151
1234,1,1997,28,1,1,67,0,1010,132,345,0.383,55,181,0.304,77,164,0.47,92,106,0.868,35,41,76,175,61,9,99,114,411
1234,2,1998,29,1,1,48,17,1236,156,380,0.411,25,68,0.368,131,312,0.42,105,123,0.854,65,94,159,236,58,5,112,96,442
1234,3,1999,30,1,1,50,15,1502,230,522,0.441,69,189,0.365,161,333,0.483,161,178,0.904,53,127,180,335,108,4,158,90,690
1234,4,2000,31,1,1,82,82,2590,484,1119,0.433,137,403,0.34,347,716,0.485,225,247,0.911,65,205,270,501,169,9,248,137,1330
1234,5,2001,32,1,1,75,75,2767,413,1002,0.412,143,403,0.355,270,599,0.451,220,249,0.884,94,249,343,524,135,13,200,155,1189
1234,6,2002,33,1,1,82,79,2730,347,828,0.419,139,398,0.349,208,430,0.484,182,205,0.888,83,236,319,453,157,10,175,166,1015
1234,7,2003,34,1,1,82,23,2350,263,643,0.409,78,232,0.336,185,411,0.45,165,188,0.878,91,204,295,323,135,13,160,167,769
1234,8,2004,35,1,1,79,22,2247,291,736,0.395,135,429,0.315,156,307,0.508,123,144,0.854,63,163,226,311,133,16,155,148,840
1234,9,2005,36,1,1,14,9,412,53,159,0.333,17,70,0.243,36,89,0.404,19,21,0.905,16,32,48,65,15,2,28,30,142
1234,9,2005,36,1,1,52,7,576,36,118,0.305,11,41,0.268,25,77,0.325,39,47,0.83,19,48,67,113,30,6,39,62,122
1234,9,2005,36,1,1,66,16,988,89,277,0.321,28,111,0.252,61,166,0.367,58,68,0.853,35,80,115,178,45,8,67,92,264
1234,10,2006,37,1,1,62,2,622,43,128,0.336,11,48,0.229,32,80,0.4,33,42,0.786,18,63,81,86,27,3,58,71,130
1234,11,2007,38,1,1,81,4,1275,156,377,0.414,72,214,0.336,84,163,0.515,73,93,0.785,34,101,135,191,70,6,76,102,457
1234,12,2008,39,1,1,50,2,549,40,110,0.364,23,69,0.333,17,41,0.415,20,30,0.667,17,50,67,73,28,2,41,53,123
1235,1,1990,22,1,1,81,0,1291,190,392,0.485,3,6,0.5,187,386,0.484,69,78,0.885,19,83,102,199,46,6,83,105,452
1235,2,1991,23,1,1,82,0,1731,304,632,0.481,15,30,0.5,289,602,0.48,97,111,0.874,25,124,149,301,70,4,107,118,720
1235,3,1992,24,1,1,82,3,1875,335,697,0.481,35,87,0.402,300,610,0.492,104,129,0.806,19,126,145,266,46,5,94,88,809
1235,4,1993,25,1,1,82,74,2492,408,818,0.499,63,139,0.453,345,679,0.508,130,151,0.861,27,122,149,330,66,6,83,169,1009
1235,5,1994,26,1,1,82,82,2770,479,1007,0.476,60,135,0.444,419,872,0.481,194,227,0.855,28,142,170,323,80,9,131,147,1212
1235,6,1995,27,1,1,82,82,2577,418,894,0.468,108,253,0.427,310,641,0.484,206,233,0.884,25,161,186,244,84,8,103,159,1150
1235,7,1996,28,1,1,82,64,2262,340,727,0.468,98,207,0.473,242,520,0.465,234,279,0.839,22,162,184,401,68,6,128,147,1012
1235,8,1997,29,1,1,49,17,1020,148,327,0.453,25,90,0.278,123,237,0.519,68,79,0.861,7,67,74,126,25,2,53,56,389
1235,9,1998,30,1,1,62,0,772,99,194,0.51,9,34,0.265,90,160,0.563,37,43,0.86,12,57,69,144,25,0,35,68,244
1235,9,1998,30,1,1,66,0,831,105,213,0.493,9,35,0.257,96,178,0.539,42,50,0.84,16,60,76,150,29,0,42,74,261
1235,10,1999,31,1,1,10,1,178,21,43,0.488,6,8,0.75,15,35,0.429,9,10,0.9,1,15,16,27,3,0,10,16,57
1235,10,1999,31,1,1,22,0,180,19,45,0.422,1,7,0.143,18,38,0.474,9,11,0.818,1,22,23,34,9,0,15,15,48
1235,10,1999,31,1,1,32,1,358,40,88,0.455,7,15,0.467,33,73,0.452,18,21,0.857,2,37,39,61,12,0,25,31,105
1235,11,2000,32,1,1,27,18,583,83,186,0.446,13,29,0.448,70,157,0.446,22,25,0.88,2,45,47,78,7,1,40,34,201
1237,1,1991,23,1,3,39,1,266,34,81,0.42,6,25,0.24,28,56,0.5,12,25,0.48,30,38,68,19,16,13,11,46,86
1237,2,1992,24,1,3,59,4,843,84,205,0.41,25,73,0.342,59,132,0.447,26,37,0.703,65,77,142,38,40,15,47,109,219
1237,3,1993,25,1,3,69,1,935,88,213,0.413,22,65,0.338,66,148,0.446,29,40,0.725,74,124,198,31,31,29,37,141,227
1237,4,1994,26,1,3,37,0,319,36,88,0.409,4,21,0.19,32,67,0.478,9,10,0.9,33,49,82,13,11,1,21,57,85
1237,5,1995,27,1,3,50,5,854,81,207,0.391,21,78,0.269,60,129,0.465,46,57,0.807,86,112,198,39,35,17,25,109,229
1237,6,1996,28,1,3,75,14,1897,157,391,0.402,99,237,0.418,58,154,0.377,45,57,0.789,113,211,324,121,48,61,82,271,458
1237,7,1997,29,1,3,78,30,1773,138,319,0.433,69,172,0.401,69,147,0.469,39,58,0.672,86,185,271,75,53,19,59,196,384
1237,8,1998,30,1,3,46,12,681,39,122,0.32,21,74,0.284,18,48,0.375,12,19,0.632,28,73,101,29,27,12,26,107,111
1237,9,1999,31,1,3,33,13,415,20,62,0.323,8,29,0.276,12,33,0.364,5,8,0.625,10,34,44,10,17,3,13,58,53
1239,1,2000,25,1,1,82,0,1626,314,741,0.424,57,163,0.35,257,578,0.445,97,133,0.729,20,106,126,306,52,3,142,137,782
1239,2,2001,26,1,1,81,75,2363,380,952,0.399,121,339,0.357,259,613,0.423,90,130,0.692,28,145,173,330,67,5,149,184,971
1239,3,2002,27,1,1,79,62,2285,368,790,0.466,138,336,0.411,230,454,0.507,83,120,0.692,31,127,158,263,72,11,128,177,957
1239,4,2003,28,1,1,65,7,1398,168,465,0.361,86,242,0.355,82,223,0.368,40,49,0.816,21,75,96,175,27,4,77,108,462
1239,5,2004,29,1,1,40,0,751,88,235,0.374,42,130,0.323,46,105,0.438,31,43,0.721,6,42,48,95,19,1,48,60,249
1239,5,2004,29,1,1,24,24,793,104,249,0.418,39,111,0.351,65,138,0.471,42,54,0.778,3,42,45,128,26,1,44,42,289
1239,5,2004,29,1,1,64,24,1544,192,484,0.397,81,241,0.336,111,243,0.457,73,97,0.753,9,84,93,223,45,2,92,102,538
1239,6,2005,30,1,1,82,82,2903,388,910,0.426,176,455,0.387,212,455,0.466,163,203,0.803,31,166,197,358,73,2,151,181,1115
1239,7,2006,31,1,2,28,2,552,66,174,0.379,33,92,0.359,33,82,0.402,22,31,0.71,12,33,45,69,14,0,30,58,187
1239,7,2006,31,1,1,43,39,1161,160,399,0.401,64,182,0.352,96,217,0.442,107,132,0.811,11,64,75,129,29,2,57,94,491
1239,7,2006,31,1,1,71,41,1713,226,573,0.394,97,274,0.354,129,299,0.431,129,163,0.791,23,97,120,198,43,2,87,152,678
1239,8,2007,32,1,1,75,23,2064,310,715,0.434,116,306,0.379,194,409,0.474,252,311,0.81,18,121,139,346,50,4,127,136,988
1239,9,2008,33,1,2,24,0,352,42,122,0.344,25,79,0.316,17,43,0.395,4,9,0.444,3,28,31,47,9,1,10,27,113
1239,10,2009,34,1,1,14,0,115,9,27,0.333,5,17,0.294,4,10,0.4,4,4,1,0,6,6,28,2,1,10,5,27
1239,10,2009,34,1,1,19,0,297,25,86,0.291,10,40,0.25,15,46,0.326,11,12,0.917,5,13,18,31,8,1,13,22,71
1239,10,2009,34,1,1,33,0,412,34,113,0.301,15,57,0.263,19,56,0.339,15,16,0.938,5,19,24,59,10,2,23,27,98
1239,11,2010,35,1,1,40,11,644,57,157,0.363,22,73,0.301,35,84,0.417,25,27,0.926,5,24,29,91,17,0,32,53,161
1242,1,1992,23,1,2,82,82,2505,440,899,0.489,1,6,0.167,439,893,0.492,213,320,0.666,191,229,420,201,124,27,181,161,1094
1242,2,1993,24,1,2,73,66,2112,397,792,0.501,0,4,0,397,788,0.504,227,307,0.739,141,146,287,170,91,18,157,141,1021
1242,3,1994,25,1,2,82,82,2605,439,861,0.51,1,7,0.143,438,854,0.513,333,436,0.764,178,216,394,187,149,45,147,179,1212
1242,4,1995,26,1,2,76,76,2362,397,876,0.453,7,26,0.269,390,850,0.459,252,346,0.728,157,211,368,197,100,47,152,163,1053
1242,5,1996,27,1,3,77,49,2294,362,738,0.491,1,4,0.25,361,734,0.492,251,317,0.792,137,167,304,137,106,31,138,188,976
1242,6,1997,28,1,2,20,3,292,31,77,0.403,0,0,-1,31,77,0.403,28,41,0.683,14,35,49,15,10,10,27,29,90
1242,6,1997,28,1,2,40,7,650,74,143,0.517,0,0,-1,74,143,0.517,41,56,0.732,33,56,89,41,32,7,37,58,189
1242,6,1997,28,1,2,60,10,942,105,220,0.477,0,0,-1,105,220,0.477,69,97,0.711,47,91,138,56,42,17,64,87,279
1242,7,1998,29,1,2,71,23,1445,154,372,0.414,1,7,0.143,153,365,0.419,94,156,0.603,104,131,235,88,57,32,81,144,403
1242,8,1999,30,1,3,48,21,874,78,174,0.448,0,2,0,78,172,0.453,52,76,0.684,47,78,125,58,57,18,30,81,208
1242,9,2000,31,1,2,59,0,692,83,175,0.474,0,2,0,83,173,0.48,37,55,0.673,42,74,116,53,27,11,38,69,203
1242,10,2001,32,1,2,66,23,1182,127,266,0.477,0,4,0,127,262,0.485,57,87,0.655,60,99,159,98,48,21,48,105,311
1242,11,2002,33,1,2,77,3,1319,140,328,0.427,0,3,0,140,325,0.431,77,101,0.762,59,166,225,103,56,12,54,115,357
1242,12,2003,34,1,2,70,3,862,79,192,0.411,0,7,0,79,185,0.427,54,72,0.75,26,93,119,69,27,9,40,80,212
1242,13,2004,35,1,3,69,24,1416,143,347,0.412,1,7,0.143,142,340,0.418,110,139,0.791,52,122,174,85,55,15,76,114,397
1242,14,2005,36,1,3,55,7,663,68,167,0.407,0,0,-1,68,167,0.407,57,77,0.74,45,54,99,36,23,8,31,83,193
1242,15,2006,37,1,3,36,3,385,25,73,0.342,0,0,-1,25,73,0.342,21,30,0.7,18,35,53,23,12,6,11,40,71
1243,1,2008,23,1,4,25,0,149,18,34,0.529,0,0,-1,18,34,0.529,4,8,0.5,16,14,30,2,5,2,6,18,40
1246,1,2000,20,1,1,59,1,484,56,181,0.309,18,63,0.286,38,118,0.322,24,36,0.667,8,32,40,88,14,2,42,60,154
1246,2,2001,21,1,1,55,0,463,55,144,0.382,16,59,0.271,39,85,0.459,28,36,0.778,5,24,29,75,13,4,45,48,154
1246,3,2002,22,1,1,28,0,258,26,90,0.289,6,35,0.171,20,55,0.364,13,19,0.684,4,20,24,36,7,0,19,17,71
1247,1,1980,31,1,5,26,-1,560,27,60,0.45,0,0,-1,27,60,0.45,32,50,0.64,29,86,115,40,12,15,27,66,86
1247,2,1981,32,1,5,47,-1,607,44,93,0.473,0,0,-1,44,93,0.473,14,20,0.7,33,75,108,54,12,8,33,85,102
1247,3,1982,33,1,5,10,3,121,5,15,0.333,0,0,-1,5,15,0.333,5,9,0.556,7,7,14,8,1,2,6,28,15
1248,1,1983,26,1,4,80,77,1612,163,353,0.462,0,2,0,163,351,0.464,78,113,0.69,117,212,329,83,32,44,133,238,404
1248,2,1984,27,1,4,78,71,1532,149,322,0.463,0,2,0,149,320,0.466,97,131,0.74,91,219,310,95,36,55,124,222,395
1248,3,1985,28,1,4,12,10,156,12,31,0.387,0,0,-1,12,31,0.387,6,6,1,11,18,29,6,4,3,16,24,30
1248,3,1985,28,1,4,57,33,1178,150,323,0.464,0,4,0,150,319,0.47,81,122,0.664,84,191,275,113,31,32,103,193,381
1248,3,1985,28,1,4,69,43,1334,162,354,0.458,0,4,0,162,350,0.463,87,128,0.68,95,209,304,119,35,35,119,217,411
1248,4,1986,29,1,4,26,2,345,36,81,0.444,0,0,-1,36,81,0.444,33,48,0.688,21,56,77,29,10,3,21,54,105
1248,4,1986,29,1,4,42,7,669,74,163,0.454,0,2,0,74,161,0.46,43,67,0.642,42,90,132,53,22,14,51,109,191
1248,4,1986,29,1,4,68,9,1014,110,244,0.451,0,2,0,110,242,0.455,76,115,0.661,63,146,209,82,32,17,72,163,296
1248,5,1987,30,1,4,78,0,845,100,215,0.465,0,4,0,100,211,0.474,78,116,0.672,64,109,173,36,16,11,56,154,278
1248,6,1988,31,1,4,81,71,1238,143,308,0.464,0,2,0,143,306,0.467,78,99,0.788,94,174,268,67,23,25,83,162,364
1248,7,1989,32,1,4,77,50,796,72,163,0.442,0,1,0,72,162,0.444,36,44,0.818,41,91,132,32,11,13,52,99,180
1251,1,2006,25,1,5,43,1,237,32,60,0.533,0,1,0,32,59,0.542,10,20,0.5,19,37,56,2,6,25,16,47,74
1251,2,2008,27,1,5,16,0,130,9,23,0.391,0,0,-1,9,23,0.391,1,2,0.5,13,18,31,4,3,10,4,32,19
1251,2,2008,27,1,5,26,0,196,30,61,0.492,0,0,-1,30,61,0.492,4,10,0.4,15,26,41,6,4,16,8,38,64
1251,2,2008,27,1,5,42,0,326,39,84,0.464,0,0,-1,39,84,0.464,5,12,0.417,28,44,72,10,7,26,12,70,83
1251,3,2009,28,1,5,23,0,181,27,57,0.474,0,1,0,27,56,0.482,7,8,0.875,9,22,31,9,10,24,13,33,61
1251,4,2010,29,1,5,49,2,355,48,103,0.466,0,0,-1,48,103,0.466,9,19,0.474,32,55,87,8,5,29,15,54,105
1251,5,2011,30,1,5,41,0,330,23,49,0.469,0,0,-1,23,49,0.469,13,18,0.722,35,51,86,6,6,27,21,52,59
1257,1,1980,31,1,5,82,-1,2938,715,1416,0.505,4,12,0.333,711,1404,0.506,517,667,0.775,236,483,719,198,88,54,163,190,1951
1257,2,1981,32,1,5,80,-1,2641,614,1220,0.503,2,12,0.167,612,1208,0.507,519,684,0.759,229,447,676,158,83,53,130,249,1749
1257,3,1982,33,1,5,81,81,2472,651,1236,0.527,4,6,0.667,647,1230,0.526,546,655,0.834,174,434,608,179,67,55,169,245,1852
1257,4,1983,34,1,5,80,80,2431,661,1296,0.51,4,19,0.211,657,1277,0.514,400,479,0.835,151,445,596,223,83,43,174,227,1726
1257,5,1984,35,1,5,76,66,2076,569,1153,0.493,4,19,0.211,565,1134,0.498,364,428,0.85,112,401,513,173,60,44,122,182,1506
1257,6,1985,36,1,5,77,9,1684,363,791,0.459,1,7,0.143,362,784,0.462,257,319,0.806,80,251,331,137,65,31,93,171,984
1258,1,1992,24,1,1,52,21,1280,160,355,0.451,59,136,0.434,101,219,0.461,107,128,0.836,27,71,98,194,33,1,92,79,486
1258,2,1993,25,1,1,70,23,1769,221,478,0.462,54,144,0.375,167,334,0.5,114,149,0.765,31,109,140,328,49,6,129,101,610
1259,1,1997,21,1,1,76,74,3045,625,1504,0.416,155,455,0.341,470,1049,0.448,382,544,0.702,115,197,312,567,157,24,337,233,1787
1259,2,1998,22,1,2,80,80,3150,649,1407,0.461,70,235,0.298,579,1172,0.494,390,535,0.729,86,210,296,494,176,25,244,200,1758
1259,3,1999,23,1,2,48,48,1990,435,1056,0.412,58,199,0.291,377,857,0.44,356,474,0.751,66,170,236,223,110,7,167,98,1284
1259,4,2000,24,1,2,70,70,2853,729,1733,0.421,89,261,0.341,640,1472,0.435,442,620,0.713,71,196,267,328,144,5,230,162,1989
1259,5,2001,25,1,2,71,71,2979,762,1813,0.42,98,306,0.32,664,1507,0.441,585,719,0.814,50,223,273,325,178,20,237,147,2207
1259,6,2002,26,1,2,60,59,2622,665,1669,0.398,78,268,0.291,587,1401,0.419,475,585,0.812,44,225,269,331,168,13,237,102,1883
1259,7,2003,27,1,2,82,82,3485,804,1940,0.414,84,303,0.277,720,1637,0.44,570,736,0.774,68,276,344,454,225,13,286,149,2262
1259,8,2004,28,1,2,48,47,2040,435,1125,0.387,57,199,0.286,378,926,0.408,339,455,0.745,34,144,178,324,115,5,209,87,1266
1259,9,2005,29,1,1,75,75,3174,771,1818,0.424,104,338,0.308,667,1480,0.451,656,786,0.835,51,248,299,596,180,9,344,140,2302
1259,10,2006,30,1,1,72,72,3103,815,1822,0.447,72,223,0.323,743,1599,0.465,675,829,0.814,44,188,232,532,140,10,248,121,2377
1259,11,2007,31,1,1,15,15,640,151,366,0.413,12,53,0.226,139,313,0.444,154,174,0.885,7,34,41,109,33,1,66,21,468
1259,11,2007,31,1,2,50,49,2121,430,947,0.454,50,144,0.347,380,803,0.473,331,436,0.759,16,136,152,359,90,12,202,74,1241
1259,11,2007,31,1,2,65,64,2761,581,1313,0.442,62,197,0.315,519,1116,0.465,485,610,0.795,23,170,193,468,123,13,268,95,1709
1259,12,2008,32,1,2,82,82,3424,712,1556,0.458,95,275,0.345,617,1281,0.482,645,797,0.809,47,196,243,586,160,12,245,109,2164
1259,13,2009,33,1,2,3,3,123,18,40,0.45,2,8,0.25,16,32,0.5,18,25,0.72,3,5,8,20,3,1,10,3,56
1259,13,2009,33,1,1,54,50,1970,330,794,0.416,26,91,0.286,304,703,0.432,253,322,0.786,27,138,165,263,85,5,136,83,939
1259,13,2009,33,1,1,57,53,2093,348,834,0.417,28,99,0.283,320,735,0.435,271,347,0.781,30,143,173,283,88,6,146,86,995
1259,14,2010,34,1,2,25,24,798,121,290,0.417,8,24,0.333,113,266,0.425,98,119,0.824,15,60,75,102,18,2,57,43,348
1259,14,2010,34,1,2,28,24,865,136,316,0.43,9,25,0.36,127,291,0.436,104,131,0.794,16,63,79,113,19,2,64,48,385
1266,1,1980,31,1,5,81,-1,2412,303,677,0.448,0,1,0,303,676,0.448,137,185,0.741,172,473,645,460,111,109,211,307,743
1266,2,1981,32,1,5,82,-1,2228,237,536,0.442,1,5,0.2,236,531,0.444,92,117,0.786,131,453,584,399,95,120,182,302,567
1266,3,1982,33,1,5,54,6,650,64,149,0.43,0,1,0,64,148,0.432,27,35,0.771,20,83,103,73,20,37,54,137,155
1266,3,1982,33,1,5,56,7,670,67,154,0.435,0,1,0,67,153,0.438,27,37,0.73,20,87,107,77,22,38,56,139,161
1266,4,1983,34,1,5,60,33,1232,111,264,0.42,2,9,0.222,109,255,0.427,29,37,0.784,62,169,231,118,29,25,98,209,253
1269,1,1993,23,1,4,81,81,2823,503,1061,0.474,4,40,0.1,499,1021,0.489,462,553,0.835,171,537,708,223,105,83,275,290,1472
1269,2,1994,24,1,4,70,67,2428,396,883,0.448,6,25,0.24,390,858,0.455,375,479,0.783,160,442,602,307,87,86,259,264,1173
1269,3,1995,25,1,5,81,80,2770,450,920,0.489,13,40,0.325,437,880,0.497,409,500,0.818,164,449,613,234,101,87,225,302,1322
1269,4,1996,26,1,5,30,27,977,159,325,0.489,0,8,0,159,317,0.502,107,130,0.823,86,150,236,68,31,28,75,119,425
1269,4,1996,26,1,5,44,44,1518,283,582,0.486,9,31,0.29,274,551,0.497,217,266,0.816,98,204,302,129,40,43,112,157,792
1269,4,1996,26,1,5,74,71,2495,442,907,0.487,9,39,0.231,433,868,0.499,324,396,0.818,184,354,538,197,71,71,187,276,1217
1269,5,1997,27,1,4,82,82,3140,548,1128,0.486,31,88,0.352,517,1040,0.497,359,440,0.816,212,508,720,223,102,64,218,277,1486
1269,6,1998,28,1,4,74,49,2282,354,730,0.485,6,27,0.222,348,703,0.495,306,354,0.864,142,345,487,190,71,73,183,246,1020
1269,7,1999,29,1,4,16,0,337,38,106,0.358,1,3,0.333,37,103,0.359,44,57,0.772,21,33,54,24,15,12,19,30,121
1269,8,2000,30,1,5,82,82,2443,379,801,0.473,7,24,0.292,372,777,0.479,237,292,0.812,175,378,553,186,83,45,186,326,1002
1269,9,2001,31,1,4,25,13,733,112,228,0.491,3,10,0.3,109,218,0.5,103,122,0.844,43,110,153,57,31,19,67,83,330
1269,9,2001,31,1,5,53,35,930,165,323,0.511,1,3,0.333,164,320,0.513,67,82,0.817,75,137,212,67,40,27,70,159,398
1269,9,2001,31,1,5,78,48,1663,277,551,0.503,4,13,0.308,273,538,0.507,170,204,0.833,118,247,365,124,71,46,137,242,728
1269,10,2002,32,1,4,57,48,1441,168,362,0.464,2,10,0.2,166,352,0.472,66,76,0.868,74,227,301,151,60,25,85,129,404
1269,11,2003,33,1,4,76,66,2215,255,516,0.494,2,16,0.125,253,500,0.506,120,144,0.833,114,388,502,235,82,40,87,206,632
1269,12,2004,34,1,4,48,18,984,119,256,0.465,6,21,0.286,113,235,0.481,40,50,0.8,50,182,232,89,37,28,42,102,284
1269,13,2005,35,1,4,49,0,739,107,184,0.582,1,7,0.143,106,177,0.599,45,59,0.763,36,95,131,41,32,15,29,78,260
1270,1,1981,23,1,5,81,-1,2460,337,670,0.503,0,0,-1,337,670,0.503,117,153,0.765,266,427,693,216,56,78,132,332,791
1270,2,1982,24,1,5,50,4,894,119,253,0.47,3,6,0.5,116,247,0.47,93,120,0.775,124,153,277,45,22,30,61,170,334
1270,2,1982,24,1,5,30,30,935,146,283,0.516,1,7,0.143,145,276,0.525,91,112,0.813,110,230,340,55,17,34,60,126,384
1270,2,1982,24,1,5,80,34,1829,265,536,0.494,4,13,0.308,261,523,0.499,184,232,0.793,234,383,617,100,39,64,121,296,718
1270,3,1983,25,1,5,82,82,2871,436,877,0.497,2,13,0.154,434,864,0.502,245,310,0.79,282,711,993,263,51,118,176,320,1119
1270,4,1984,26,1,5,82,82,2864,553,1044,0.53,0,11,0,553,1033,0.535,316,365,0.866,329,674,1003,149,49,84,151,273,1422
1270,5,1985,27,1,5,82,82,2892,595,1177,0.506,4,18,0.222,591,1159,0.51,244,306,0.797,295,718,1013,154,69,71,129,308,1438
1270,6,1986,28,1,5,82,82,2891,545,1107,0.492,4,14,0.286,541,1093,0.495,266,319,0.834,305,770,1075,146,59,65,133,291,1360
1270,7,1987,29,1,5,82,82,2854,506,1010,0.501,6,21,0.286,500,989,0.506,245,274,0.894,243,712,955,151,72,69,120,283,1263
1270,8,1988,30,1,5,82,82,2897,455,923,0.493,13,39,0.333,442,884,0.5,187,214,0.874,165,667,832,199,66,78,136,284,1110
1270,9,1989,31,1,5,81,81,2640,449,900,0.499,30,86,0.349,419,814,0.515,178,212,0.84,138,638,776,177,51,100,129,259,1106
1270,10,1990,32,1,5,81,81,2675,380,785,0.484,57,158,0.361,323,627,0.515,164,192,0.854,166,614,780,171,57,84,98,278,981
1270,11,1991,33,1,5,82,81,2668,372,778,0.478,37,125,0.296,335,653,0.513,123,147,0.837,173,564,737,157,38,56,98,242,904
1270,12,1992,34,1,5,81,46,2234,342,727,0.47,32,85,0.376,310,642,0.483,67,75,0.893,104,347,451,160,51,54,102,225,783
1270,13,1993,35,1,5,79,41,1933,292,574,0.509,10,27,0.37,282,547,0.516,93,104,0.894,110,309,419,127,46,40,59,212,687
1270,14,1994,36,1,5,11,5,248,47,90,0.522,3,9,0.333,44,81,0.543,11,13,0.846,9,47,56,14,6,4,10,30,108
1271,1,1999,22,1,5,12,12,387,59,129,0.457,12,31,0.387,47,98,0.48,36,48,0.75,33,58,91,8,9,17,9,38,166
1271,2,2000,23,1,5,81,80,2435,392,879,0.446,60,183,0.328,332,696,0.477,162,236,0.686,170,471,641,97,42,180,96,292,1006
1271,3,2001,24,1,5,78,74,2457,387,812,0.477,51,139,0.367,336,673,0.499,183,262,0.698,173,434,607,107,37,206,97,290,1008
1271,4,2002,25,1,5,27,25,787,114,261,0.437,29,95,0.305,85,166,0.512,35,46,0.761,59,141,200,29,24,60,34,108,292
1271,4,2002,25,1,5,51,51,1668,307,659,0.466,75,173,0.434,232,486,0.477,70,105,0.667,117,262,379,60,31,153,60,173,759
1271,4,2002,25,1,5,78,76,2455,421,920,0.458,104,268,0.388,317,652,0.486,105,151,0.695,176,403,579,89,55,213,94,281,1051
1271,5,2003,26,1,5,69,43,1611,266,514,0.518,47,116,0.405,219,398,0.55,60,88,0.682,125,205,330,54,35,91,46,264,639
1271,6,2004,27,1,5,17,1,328,57,124,0.46,8,40,0.2,49,84,0.583,10,13,0.769,30,49,79,24,8,13,11,47,132
1271,7,2005,28,1,4,80,80,2196,341,688,0.496,82,225,0.364,259,463,0.559,120,148,0.811,154,399,553,98,42,99,70,262,884
1271,8,2006,29,1,4,82,63,2033,238,552,0.431,112,286,0.392,126,266,0.474,51,75,0.68,80,326,406,115,29,72,65,273,639
1271,9,2007,30,1,4,27,9,352,39,102,0.382,2,23,0.087,37,79,0.468,20,26,0.769,25,45,70,8,7,11,13,57,100
1271,10,2008,31,1,5,39,0,291,27,61,0.443,0,4,0,27,57,0.474,11,19,0.579,28,39,67,6,12,17,10,59,65
1274,1,1980,27,1,4,74,-1,1324,165,400,0.413,0,3,0,165,397,0.416,73,101,0.723,138,214,352,56,47,42,64,203,403
1274,2,1981,28,1,4,43,-1,475,65,160,0.406,0,2,0,65,158,0.411,18,23,0.783,27,63,90,24,12,5,17,74,148
1274,2,1981,28,1,4,46,-1,483,68,165,0.412,0,2,0,68,163,0.417,18,23,0.783,28,65,93,27,12,5,19,76,154
1274,3,1982,29,1,4,21,6,271,26,58,0.448,0,1,0,26,57,0.456,13,14,0.929,19,32,51,13,6,6,10,43,65
1274,3,1982,29,1,4,42,1,493,60,139,0.432,1,6,0.167,59,133,0.444,21,28,0.75,36,91,127,24,12,10,38,80,142
1274,3,1982,29,1,4,63,7,764,86,197,0.437,1,7,0.143,85,190,0.447,34,42,0.81,55,123,178,37,18,16,48,123,207
1275,1,2004,18,1,5,21,0,224,43,88,0.489,0,4,0,43,84,0.512,10,13,0.769,9,35,44,9,3,3,15,28,96
1275,2,2005,19,1,5,16,0,119,17,49,0.347,2,3,0.667,15,46,0.326,8,12,0.667,9,23,32,1,1,2,10,20,44
1275,2,2005,19,1,5,21,0,261,32,83,0.386,0,1,0,32,82,0.39,7,10,0.7,15,42,57,10,4,5,7,31,71
1275,2,2005,19,1,5,37,0,380,49,132,0.371,2,4,0.5,47,128,0.367,15,22,0.682,24,65,89,11,5,7,17,51,115
1277,1,2003,23,1,3,35,0,487,56,129,0.434,0,4,0,56,125,0.448,57,82,0.695,26,57,83,31,7,3,25,43,169
1278,1,1980,24,1,5,23,-1,374,66,137,0.482,0,0,-1,66,137,0.482,29,56,0.518,69,94,163,14,10,5,25,27,161
1278,1,1980,24,1,5,54,-1,1136,183,346,0.529,0,0,-1,183,346,0.529,87,166,0.524,157,293,450,32,23,17,75,113,453
1278,1,1980,24,1,5,77,-1,1510,249,483,0.516,0,0,-1,249,483,0.516,116,222,0.523,226,387,613,46,33,22,100,140,614
1278,2,1981,25,1,4,69,-1,1086,164,327,0.502,0,1,0,164,326,0.503,62,116,0.534,152,225,377,27,19,6,65,135,390
1278,3,1982,26,1,4,75,1,1134,144,329,0.438,0,2,0,144,327,0.44,33,65,0.508,164,237,401,32,10,7,49,134,321
1278,4,1983,27,1,4,39,4,356,43,102,0.422,0,0,-1,43,102,0.422,12,25,0.48,55,73,128,12,8,4,20,48,98
1278,5,1984,28,1,4,35,0,335,19,51,0.373,0,0,-1,19,51,0.373,15,26,0.577,42,77,119,10,6,3,21,32,53
1279,1,1989,22,1,4,54,1,550,109,256,0.426,0,7,0,109,249,0.438,43,112,0.384,87,113,200,60,20,4,50,105,261
1279,2,1990,23,1,4,67,46,956,145,309,0.469,0,5,0,145,304,0.477,44,120,0.367,144,217,361,105,53,17,85,189,334
1279,3,1991,24,1,4,62,25,1383,202,461,0.438,1,4,0.25,201,457,0.44,58,141,0.411,280,298,578,123,51,14,105,192,463
1279,4,1992,25,1,4,9,5,141,10,40,0.25,0,0,-1,10,40,0.25,8,19,0.421,22,22,44,13,2,1,10,18,28
1279,4,1992,25,1,4,14,5,177,14,46,0.304,0,0,-1,14,46,0.304,9,27,0.333,32,34,66,17,2,1,14,28,37
1279,5,1993,26,1,4,21,2,149,27,54,0.5,0,0,-1,27,54,0.5,5,20,0.25,24,29,53,17,12,3,7,32,59
1280,1,1989,22,1,5,62,25,526,60,117,0.513,0,0,-1,60,117,0.513,39,60,0.65,54,93,147,9,17,48,28,112,159
1280,2,1990,23,1,5,74,0,1011,97,174,0.557,0,0,-1,97,174,0.557,64,98,0.653,83,188,271,21,22,133,41,171,258
1280,3,1991,24,1,5,63,18,1152,109,189,0.577,0,1,0,109,188,0.58,93,130,0.715,113,190,303,27,17,127,45,168,311
1280,4,1992,25,1,5,81,71,1965,248,475,0.522,0,1,0,248,474,0.523,126,164,0.768,170,376,546,43,48,201,87,306,622
1280,5,1993,26,1,5,73,59,1861,149,351,0.425,1,5,0.2,148,346,0.428,87,114,0.763,136,300,436,79,46,141,89,261,386
1280,6,1994,27,1,5,82,0,1608,215,458,0.469,1,4,0.25,214,454,0.471,73,106,0.689,126,187,313,51,38,87,81,192,504
1280,7,1995,28,1,5,82,63,2340,320,677,0.473,2,3,0.667,318,674,0.472,152,188,0.809,154,302,456,72,45,144,108,271,794
1280,8,1996,29,1,5,20,18,550,72,171,0.421,1,2,0.5,71,169,0.42,30,38,0.789,42,79,121,3,7,41,30,63,175
1280,8,1996,29,1,5,51,51,1815,281,619,0.454,0,3,0,281,616,0.456,95,118,0.805,111,223,334,62,35,85,94,178,657
1280,8,1996,29,1,5,71,69,2365,353,790,0.447,1,5,0.2,352,785,0.448,125,156,0.801,153,302,455,65,42,126,124,241,832
1280,9,1997,30,1,5,52,52,1194,115,248,0.464,0,0,-1,115,248,0.464,44,61,0.721,94,184,278,25,26,47,39,140,274
1280,10,1998,31,1,5,57,0,692,54,143,0.378,0,1,0,54,142,0.38,44,57,0.772,56,97,153,16,18,27,33,101,152
1280,11,1999,32,1,5,21,13,386,32,99,0.323,0,0,-1,32,99,0.323,16,23,0.696,33,60,93,13,5,12,17,43,80
1280,12,2000,33,1,5,19,10,244,28,64,0.438,0,0,-1,28,64,0.438,3,7,0.429,16,44,60,3,8,6,5,31,59
1281,1,1996,23,1,3,41,0,367,41,77,0.532,0,2,0,41,75,0.547,34,47,0.723,17,36,53,12,14,12,24,61,116
1281,2,1997,24,1,4,64,1,843,68,162,0.42,0,6,0,68,156,0.436,35,48,0.729,52,75,127,33,33,30,50,111,171
1283,1,2000,23,1,2,10,0,145,15,40,0.375,8,19,0.421,7,21,0.333,11,11,1,4,11,15,11,5,0,6,16,49
1283,2,2001,24,1,2,65,5,1116,135,313,0.431,51,124,0.411,84,189,0.444,68,76,0.895,12,77,89,81,38,9,52,114,389
1283,3,2002,25,1,2,44,0,477,70,176,0.398,27,74,0.365,43,102,0.422,42,46,0.913,13,42,55,60,13,5,40,49,209
1287,1,2001,23,1,3,33,0,241,37,99,0.374,0,1,0,37,98,0.378,16,29,0.552,13,28,41,4,7,1,8,16,90
1287,2,2002,24,1,3,34,8,434,49,125,0.392,1,4,0.25,48,121,0.397,8,11,0.727,22,45,67,14,8,5,9,25,107
1287,3,2003,25,1,3,60,0,541,81,202,0.401,9,31,0.29,72,171,0.421,12,20,0.6,19,68,87,21,15,6,16,58,183
1290,1,2008,25,1,4,16,4,303,32,71,0.451,0,0,-1,32,71,0.451,19,32,0.594,26,27,53,3,13,22,15,35,83
1290,1,2008,25,1,4,15,4,303,32,71,0.451,0,0,-1,32,71,0.451,19,32,0.594,26,27,53,3,13,22,15,35,83
1291,1,1980,31,1,5,26,-1,739,147,283,0.519,1,1,1,146,282,0.518,113,144,0.785,44,135,179,62,36,29,49,70,408
1291,1,1980,31,1,5,37,-1,1392,319,584,0.546,0,5,0,319,579,0.551,164,210,0.781,108,265,373,122,38,60,113,130,802
1291,1,1980,31,1,5,63,-1,2131,466,867,0.537,1,6,0.167,465,861,0.54,277,354,0.782,152,400,552,184,74,89,162,200,1210
1291,2,1981,32,1,5,67,-1,1753,376,716,0.525,1,1,1,375,715,0.524,208,277,0.751,128,285,413,179,73,81,139,184,961
1291,3,1982,33,1,5,74,72,1986,407,729,0.558,0,2,0,407,727,0.56,182,242,0.752,92,296,388,219,72,56,166,211,996
1291,4,1983,34,1,5,39,35,978,163,332,0.491,0,1,0,163,331,0.492,91,133,0.684,58,142,200,105,34,24,82,125,417
1291,5,1984,35,1,5,72,72,2007,392,685,0.572,0,3,0,392,682,0.575,194,274,0.708,141,314,455,186,58,51,163,228,978
1292,1,1997,23,1,5,35,0,180,49,89,0.551,0,1,0,49,88,0.557,13,23,0.565,16,27,43,12,1,9,37,39,111
1292,2,1998,24,1,5,39,0,345,53,127,0.417,0,0,-1,53,127,0.417,38,69,0.551,27,73,100,21,7,17,46,63,144
1298,1,2008,23,1,1,56,6,865,95,237,0.401,7,34,0.206,88,203,0.433,38,48,0.792,12,45,57,113,29,0,56,73,235
1298,2,2009,24,1,1,55,1,560,52,139,0.374,9,29,0.31,43,110,0.391,49,60,0.817,6,52,58,86,11,3,29,43,162
1298,3,2010,25,1,1,12,1,135,21,45,0.467,4,12,0.333,17,33,0.515,20,27,0.741,3,11,14,16,4,0,12,8,66
1298,3,2010,25,1,1,26,1,234,35,75,0.467,5,16,0.313,30,59,0.508,38,49,0.776,3,14,17,26,11,1,17,16,113
1298,4,2011,26,1,1,40,0,632,78,167,0.467,6,30,0.2,72,137,0.526,41,54,0.759,9,43,52,70,28,0,33,51,203
1298,4,2011,26,1,1,51,0,726,81,186,0.435,6,36,0.167,75,150,0.5,47,64,0.734,12,51,63,84,32,0,43,61,215
1304,1,1980,22,1,1,77,-1,2123,330,656,0.503,3,19,0.158,327,637,0.513,180,221,0.814,57,127,184,417,127,28,205,197,843
1304,2,1981,23,1,1,79,-1,1686,258,548,0.471,2,17,0.118,256,531,0.482,124,149,0.832,30,104,134,384,97,15,189,160,642
1304,3,1982,24,1,1,79,61,2150,370,793,0.467,9,31,0.29,361,762,0.474,115,135,0.852,49,119,168,457,150,15,153,182,864
1304,4,1983,25,1,1,79,76,2602,439,1059,0.415,42,175,0.24,397,884,0.449,247,297,0.832,64,131,195,530,165,14,198,215,1167
1304,5,1984,26,1,1,82,27,2009,349,731,0.477,11,71,0.155,338,660,0.512,238,286,0.832,31,86,117,459,107,12,184,199,947
1304,6,1985,27,1,1,42,0,536,88,209,0.421,8,37,0.216,80,172,0.465,44,57,0.772,8,29,37,102,23,4,51,61,228
1304,7,1986,28,1,1,74,12,1190,212,458,0.463,24,67,0.358,188,391,0.481,135,158,0.854,6,61,67,234,58,8,88,126,583
1304,8,1987,29,1,1,53,11,1175,147,358,0.411,18,57,0.316,129,301,0.429,100,119,0.84,14,47,61,224,53,10,64,126,412
1304,9,1988,30,1,2,80,54,2150,291,666,0.437,19,88,0.216,272,578,0.471,218,251,0.869,22,126,148,405,124,9,130,162,819
1304,10,1989,31,1,2,55,3,627,65,188,0.346,5,41,0.122,60,147,0.408,44,60,0.733,13,40,53,127,25,5,62,61,179
1310,1,1991,23,1,3,48,0,265,19,71,0.268,3,15,0.2,16,56,0.286,25,28,0.893,7,23,30,34,11,2,20,39,66
1312,1,1980,27,1,1,30,-1,364,29,91,0.319,0,3,0,29,88,0.33,9,17,0.529,11,22,33,67,15,4,33,65,67
1312,1,1980,27,1,1,31,-1,803,84,214,0.393,22,56,0.393,62,158,0.392,35,53,0.66,29,61,90,174,84,13,68,107,225
1312,1,1980,27,1,1,61,-1,1167,113,305,0.37,22,59,0.373,91,246,0.37,44,70,0.629,40,83,123,241,99,17,101,172,292
1312,2,1981,28,1,1,82,-1,1829,113,323,0.35,2,13,0.154,111,310,0.358,113,156,0.724,65,155,220,362,166,29,173,260,341
1312,3,1982,29,1,1,81,7,1467,88,246,0.358,18,59,0.305,70,187,0.374,84,119,0.706,35,120,155,312,116,20,123,221,278
1319,1,1990,22,1,5,22,0,127,13,31,0.419,0,1,0,13,30,0.433,6,14,0.429,10,17,27,1,3,9,8,26,32
1321,1,1989,25,1,1,82,0,781,40,133,0.301,1,14,0.071,39,119,0.328,57,73,0.781,23,64,87,215,27,5,88,88,138
1321,2,1991,27,1,1,55,8,1399,119,268,0.444,71,154,0.461,48,114,0.421,86,103,0.835,18,93,111,299,57,4,75,141,395
1321,3,1992,28,1,1,62,5,712,74,192,0.385,45,131,0.344,29,61,0.475,38,47,0.809,11,52,63,143,31,3,42,58,231
1321,4,1993,29,1,1,73,0,881,110,259,0.425,66,154,0.429,44,105,0.419,42,50,0.84,20,69,89,169,40,7,48,81,328
1321,5,1994,30,1,1,18,0,169,13,34,0.382,8,18,0.444,5,16,0.313,11,13,0.846,5,8,13,39,7,1,11,16,45
1321,6,1995,31,1,1,24,0,188,11,38,0.289,5,23,0.217,6,15,0.4,23,27,0.852,6,20,26,44,4,0,21,28,50
1322,1,1996,22,1,2,30,0,323,53,141,0.376,36,101,0.356,17,40,0.425,34,43,0.791,12,40,52,31,6,1,23,31,176
1322,2,1997,23,1,2,73,47,2111,314,684,0.459,183,442,0.414,131,242,0.541,86,105,0.819,38,179,217,161,50,18,109,168,897
1322,3,1998,24,1,2,81,81,2621,363,854,0.425,153,378,0.405,210,476,0.441,141,179,0.788,72,220,292,180,58,16,99,219,1020
1322,4,1999,25,1,2,12,2,190,31,79,0.392,12,35,0.343,19,44,0.432,8,11,0.727,4,12,16,10,3,1,7,18,82
1322,5,2000,26,1,2,53,13,1434,228,560,0.407,89,228,0.39,139,332,0.419,84,106,0.792,37,116,153,136,41,15,80,127,629
1322,6,2001,27,1,2,80,58,2331,336,846,0.397,147,382,0.385,189,464,0.407,153,192,0.797,47,184,231,190,65,18,102,170,972
1322,7,2002,28,1,2,71,19,1665,315,769,0.41,89,240,0.371,226,529,0.427,94,120,0.783,38,145,183,130,59,25,91,105,813
1322,8,2003,29,1,2,63,24,1929,325,809,0.402,92,252,0.365,233,557,0.418,156,194,0.804,48,164,212,144,59,21,103,156,898
1322,9,2004,30,1,2,73,70,2233,394,933,0.422,106,289,0.367,288,644,0.447,144,182,0.791,46,154,200,151,61,12,101,177,1038
1322,10,2006,32,1,2,14,0,220,33,88,0.375,15,43,0.349,18,45,0.4,11,18,0.611,3,16,19,23,13,2,20,18,92
1322,10,2006,32,1,2,12,6,238,42,103,0.408,10,35,0.286,32,68,0.471,5,13,0.385,2,26,28,18,8,2,11,21,99
1322,10,2006,32,1,2,26,6,458,75,191,0.393,25,78,0.321,50,113,0.442,16,31,0.516,5,42,47,41,21,4,31,39,191
1323,1,1982,23,1,1,75,74,2252,329,657,0.501,4,8,0.5,325,649,0.501,208,256,0.813,75,138,213,362,80,14,185,158,870
1323,2,1983,24,1,1,65,38,1437,202,446,0.453,0,5,0,202,441,0.458,124,171,0.725,46,126,172,332,51,6,134,121,528
1323,3,1984,25,1,1,43,3,687,78,188,0.415,1,5,0.2,77,183,0.421,75,87,0.862,20,26,46,168,30,6,72,59,232
1323,4,1985,26,1,1,32,1,278,34,82,0.415,0,1,0,34,81,0.42,21,31,0.677,4,22,26,80,15,3,32,25,89
1323,5,1986,27,1,1,27,0,222,26,52,0.5,0,3,0,26,49,0.531,15,19,0.789,0,10,10,54,9,3,42,27,67
1330,1,1996,20,1,3,16,0,189,29,60,0.483,2,7,0.286,27,53,0.509,15,25,0.6,15,14,29,3,8,3,14,21,75
1332,1,1988,24,1,2,50,0,310,27,87,0.31,0,1,0,27,86,0.314,29,48,0.604,17,34,51,14,13,4,19,36,83
1332,2,1989,25,1,2,42,0,336,58,121,0.479,1,3,0.333,57,118,0.483,19,39,0.487,35,26,61,15,11,3,24,28,136
1333,1,1990,23,1,2,79,4,1326,250,514,0.486,0,14,0,250,500,0.5,130,174,0.747,49,102,151,116,55,13,95,145,630
1333,2,1991,24,1,2,29,25,860,166,378,0.439,14,47,0.298,152,331,0.459,59,69,0.855,49,63,112,72,46,8,33,65,405
1333,3,1992,25,1,2,68,10,1176,173,376,0.46,1,9,0.111,172,367,0.469,99,118,0.839,36,82,118,74,43,12,72,131,446
1333,4,1993,26,1,2,48,12,752,124,276,0.449,2,6,0.333,122,270,0.452,81,102,0.794,35,67,102,52,28,11,49,60,331
1333,5,1994,27,1,2,13,0,126,20,51,0.392,2,2,1,18,49,0.367,16,25,0.64,8,14,22,11,7,1,5,16,58
1334,1,1988,22,1,2,49,0,405,90,193,0.466,0,4,0,90,189,0.476,40,57,0.702,28,35,63,26,16,15,30,54,220
1334,2,1989,23,1,3,81,57,2657,604,1242,0.486,3,22,0.136,601,1220,0.493,284,361,0.787,116,261,377,218,124,72,142,258,1495
1334,3,1990,24,1,2,79,54,2522,540,1089,0.496,4,15,0.267,536,1074,0.499,256,317,0.808,109,238,347,225,88,63,120,216,1340
1334,4,1991,25,1,2,79,79,2878,598,1219,0.491,1,13,0.077,597,1206,0.495,281,340,0.826,119,291,410,201,98,85,147,234,1478
1334,5,1992,26,1,2,82,82,3070,703,1397,0.503,5,21,0.238,698,1376,0.507,292,343,0.851,117,277,394,185,125,105,136,258,1703
1334,6,1993,27,1,2,80,80,3144,663,1410,0.47,14,60,0.233,649,1350,0.481,326,376,0.867,88,259,347,298,118,77,133,248,1666
1335,1,1991,22,1,3,76,18,1171,216,513,0.421,17,57,0.298,199,456,0.436,58,92,0.63,117,104,221,64,48,19,71,153,507
1335,2,1992,23,1,3,75,13,1527,275,621,0.443,17,50,0.34,258,571,0.452,131,180,0.728,144,164,308,58,66,29,90,165,698
1335,3,1993,24,1,3,78,32,1585,252,620,0.406,22,59,0.373,230,561,0.41,102,156,0.654,131,204,335,105,64,21,79,143,628
1335,4,1994,25,1,3,35,0,274,36,116,0.31,10,27,0.37,26,89,0.292,18,37,0.486,26,30,56,15,11,4,22,29,100
1335,4,1994,25,1,3,38,0,285,40,123,0.325,10,28,0.357,30,95,0.316,19,39,0.487,26,35,61,17,11,4,24,34,109
1341,1,1997,21,1,1,64,0,981,100,229,0.437,9,22,0.409,91,207,0.44,42,65,0.646,32,62,94,155,39,12,102,107,251
1341,2,2000,24,1,1,79,15,1081,155,373,0.416,19,55,0.345,136,318,0.428,52,62,0.839,25,105,130,170,49,13,92,129,381
1341,3,2002,26,1,1,13,0,176,15,54,0.278,1,8,0.125,14,46,0.304,10,11,0.909,9,16,25,26,9,2,2,11,41
1341,4,2005,29,1,1,17,4,227,22,52,0.423,5,8,0.625,17,44,0.386,15,17,0.882,3,9,12,45,12,2,14,28,64
1343,1,1997,23,1,5,20,2,101,15,28,0.536,0,0,-1,15,28,0.536,4,8,0.5,4,14,18,4,10,5,11,25,34
1349,1,1982,22,1,3,71,13,1139,208,448,0.464,0,11,0,208,437,0.476,77,107,0.72,69,126,195,88,35,30,68,147,493
1349,2,1983,23,1,3,66,13,818,138,300,0.46,5,9,0.556,133,291,0.457,53,80,0.663,37,88,125,72,29,8,64,98,334
1349,3,1984,24,1,3,10,0,133,19,43,0.442,1,3,0.333,18,40,0.45,9,13,0.692,7,11,18,14,3,5,11,15,48
1349,3,1984,24,1,3,11,0,137,19,43,0.442,1,3,0.333,18,40,0.45,9,13,0.692,7,11,18,14,3,5,11,16,48
1350,1,1989,22,1,4,20,0,110,9,32,0.281,0,0,-1,9,32,0.281,12,15,0.8,14,18,32,4,3,4,13,15,30
1356,1,1988,23,1,4,70,4,718,122,246,0.496,3,13,0.231,119,233,0.511,50,62,0.806,46,92,138,49,20,41,59,123,297
1356,2,1989,24,1,4,29,10,476,93,216,0.431,1,7,0.143,92,209,0.44,46,57,0.807,37,77,114,17,9,30,28,60,233
1356,2,1989,24,1,4,48,15,738,117,270,0.433,0,4,0,117,266,0.44,35,46,0.761,47,95,142,49,21,26,49,101,269
1356,2,1989,24,1,4,77,25,1214,210,486,0.432,1,11,0.091,209,475,0.44,81,103,0.786,84,172,256,66,30,56,77,161,502
1356,3,1990,25,1,4,28,24,590,94,202,0.465,1,16,0.063,93,186,0.5,21,26,0.808,21,89,110,62,14,22,45,66,210
1356,3,1990,25,1,4,52,17,1353,211,461,0.458,46,121,0.38,165,340,0.485,54,77,0.701,77,211,288,106,44,66,64,145,522
1356,3,1990,25,1,4,80,41,1943,305,663,0.46,47,137,0.343,258,526,0.49,75,103,0.728,98,300,398,168,58,88,109,211,732
1356,4,1991,26,1,4,81,3,1219,179,415,0.431,33,119,0.277,146,296,0.493,37,54,0.685,59,158,217,75,50,74,60,170,428
1356,5,1992,27,1,4,70,8,1081,162,360,0.45,57,144,0.396,105,216,0.486,27,41,0.659,65,184,249,74,40,71,46,144,408
1356,6,1993,28,1,4,80,24,1766,283,614,0.461,85,230,0.37,198,384,0.516,73,101,0.723,59,217,276,127,47,74,93,178,724
1356,7,1994,29,1,4,67,2,962,102,281,0.363,46,134,0.343,56,147,0.381,20,29,0.69,33,117,150,62,30,55,58,142,270
1356,8,1995,30,1,4,61,1,730,97,231,0.42,63,155,0.406,34,76,0.447,10,15,0.667,28,74,102,43,20,25,29,85,267
1356,9,1996,31,1,4,32,1,273,39,96,0.406,27,65,0.415,12,31,0.387,2,3,0.667,5,28,33,17,2,7,9,34,107
1356,9,1996,31,1,4,23,7,325,32,79,0.405,24,57,0.421,8,22,0.364,2,2,1,2,29,31,27,8,10,11,36,90
1356,9,1996,31,1,4,55,8,598,71,175,0.406,51,122,0.418,20,53,0.377,4,5,0.8,7,57,64,44,10,17,20,70,197
1356,10,1998,33,1,4,9,0,102,7,21,0.333,4,14,0.286,3,7,0.429,1,3,0.333,3,9,12,5,1,2,3,10,19
1357,1,2002,29,1,4,63,27,989,120,244,0.492,0,0,-1,120,244,0.492,45,85,0.529,107,144,251,41,22,28,63,180,285
1357,2,2003,30,1,3,19,0,131,19,50,0.38,1,1,1,18,49,0.367,1,5,0.2,13,27,40,2,2,8,9,22,40
1357,2,2003,30,1,3,26,0,211,28,75,0.373,2,3,0.667,26,72,0.361,2,10,0.2,21,39,60,6,5,11,20,35,60
1358,1,1989,22,1,4,82,73,2435,336,692,0.486,0,5,0,336,687,0.489,304,406,0.749,240,306,546,149,122,48,201,337,976
1358,2,1990,23,1,4,81,31,1856,257,532,0.483,0,3,0,257,529,0.486,172,241,0.714,156,246,402,96,91,38,139,300,686
1358,3,1991,24,1,4,80,66,2514,276,561,0.492,1,6,0.167,275,555,0.495,181,230,0.787,225,343,568,176,119,43,156,295,734
1358,4,1992,25,1,4,82,82,3063,440,890,0.494,6,22,0.273,434,868,0.5,326,404,0.807,259,432,691,225,139,40,185,248,1212
1358,5,1993,26,1,4,76,62,2728,397,847,0.469,6,26,0.231,391,821,0.476,261,341,0.765,197,371,568,182,104,31,133,264,1061
1358,6,1994,27,1,4,69,59,2201,300,672,0.446,1,6,0.167,299,666,0.449,187,238,0.786,190,305,495,170,89,26,125,244,788
1358,7,1995,28,1,4,79,77,2579,337,704,0.479,11,31,0.355,326,673,0.484,238,315,0.756,190,405,595,127,107,34,151,232,923
1358,7,1995,28,1,4,81,79,2641,342,716,0.478,11,31,0.355,331,685,0.483,244,325,0.751,191,415,606,131,109,34,155,243,939
1358,8,1996,29,1,4,82,82,3008,395,838,0.471,31,86,0.36,364,752,0.484,257,337,0.763,248,540,788,183,108,34,157,233,1078
1358,9,1997,30,1,4,65,24,1166,123,275,0.447,17,47,0.362,106,228,0.465,63,84,0.75,88,134,222,39,43,6,48,106,326
1358,10,1998,31,1,4,40,17,739,50,117,0.427,0,4,0,50,113,0.442,41,57,0.719,57,93,150,25,29,12,22,91,141
1358,11,1999,32,1,4,50,13,1380,151,359,0.421,3,18,0.167,148,341,0.434,184,235,0.783,100,196,296,53,57,16,74,143,489
1358,12,2000,33,1,4,42,1,920,74,167,0.443,0,4,0,74,163,0.454,55,71,0.775,86,148,234,43,45,10,49,108,203
1358,13,2001,34,1,4,66,27,1507,140,319,0.439,4,15,0.267,136,304,0.447,112,157,0.713,76,198,274,83,72,15,62,160,396
1358,14,2002,35,1,4,66,56,1868,164,385,0.426,3,17,0.176,161,368,0.438,86,123,0.699,31,200,231,136,63,12,103,123,417
1358,15,2003,36,1,4,41,1,488,27,70,0.386,0,3,0,27,67,0.403,18,23,0.783,24,59,83,25,9,1,19,62,72
1361,1,1992,23,1,5,66,3,991,114,249,0.458,0,0,-1,114,249,0.458,53,80,0.663,67,190,257,53,35,64,83,157,281
1361,2,1993,24,1,5,55,25,1045,133,292,0.455,0,0,-1,133,292,0.455,53,74,0.716,71,169,240,51,47,77,88,169,319
1361,3,1994,25,1,5,27,17,513,85,176,0.483,0,0,-1,85,176,0.483,34,45,0.756,42,96,138,63,10,21,40,85,204
1361,3,1994,25,1,5,49,29,989,134,289,0.464,0,1,0,134,288,0.465,56,80,0.7,87,208,295,46,35,58,79,131,324
1361,3,1994,25,1,5,76,46,1502,219,465,0.471,0,1,0,219,464,0.472,90,125,0.72,129,304,433,109,45,79,119,216,528
1361,4,1995,26,1,5,55,0,1001,135,302,0.447,0,2,0,135,300,0.45,88,107,0.822,82,181,263,73,24,45,86,177,358
1361,5,1996,27,1,5,62,62,1641,242,502,0.482,0,0,-1,242,502,0.482,80,103,0.777,104,214,318,119,22,84,114,223,564
1361,6,1997,28,1,5,59,59,1472,221,485,0.456,0,2,0,221,483,0.458,95,120,0.792,121,211,332,141,23,66,111,191,537
1361,7,1998,29,1,5,58,58,1703,277,609,0.455,0,0,-1,277,609,0.455,109,148,0.736,113,228,341,161,34,62,130,206,663
1361,8,1999,30,1,5,39,39,933,140,290,0.483,0,0,-1,140,290,0.483,59,76,0.776,59,162,221,45,23,21,53,119,339
1361,9,2000,31,1,5,72,68,1417,186,399,0.466,0,0,-1,186,399,0.466,80,97,0.825,100,223,323,77,22,42,136,221,452
1361,10,2001,32,1,5,25,2,301,18,54,0.333,0,0,-1,18,54,0.333,13,17,0.765,26,40,66,7,3,9,22,51,49
1362,1,1999,24,1,2,47,32,1218,169,379,0.446,12,44,0.273,157,335,0.469,87,135,0.644,69,97,166,62,49,14,82,128,437
1362,2,2000,25,1,2,65,0,781,111,261,0.425,3,18,0.167,108,243,0.444,67,109,0.615,59,65,124,44,32,17,53,94,292
1362,3,2001,26,1,1,23,10,457,69,152,0.454,13,23,0.565,56,129,0.434,19,33,0.576,25,49,74,34,21,12,27,46,170
1362,3,2001,26,1,2,47,38,1108,142,326,0.436,6,29,0.207,136,297,0.458,90,123,0.732,30,130,160,73,41,18,56,110,380
1362,3,2001,26,1,2,70,48,1565,211,478,0.441,19,52,0.365,192,426,0.451,109,156,0.699,55,179,234,107,62,30,83,156,550
1362,4,2002,27,1,2,67,0,581,59,156,0.378,14,33,0.424,45,123,0.366,37,55,0.673,29,51,80,39,18,1,36,73,169
1363,1,2004,23,1,1,82,11,1617,223,517,0.431,25,85,0.294,198,432,0.458,101,117,0.863,24,131,155,305,62,2,174,200,572
1363,2,2005,24,1,1,31,15,518,57,135,0.422,20,45,0.444,37,90,0.411,27,33,0.818,7,32,39,123,22,3,47,78,161
1364,1,1995,22,1,2,37,2,672,106,223,0.475,3,14,0.214,103,209,0.493,57,88,0.648,24,47,71,101,28,1,57,42,272
1374,1,1980,26,1,1,80,-1,2763,388,830,0.467,12,42,0.286,376,788,0.477,222,289,0.768,61,159,220,602,138,3,184,196,1010
1374,2,1981,27,1,1,66,-1,1919,222,506,0.439,4,24,0.167,218,482,0.452,107,145,0.738,34,120,154,464,83,2,185,140,555
1374,3,1982,28,1,1,79,53,1940,263,618,0.426,2,22,0.091,261,596,0.438,138,176,0.784,40,126,166,551,95,6,156,105,666
1374,4,1983,29,1,1,35,0,386,62,131,0.473,0,5,0,62,126,0.492,21,42,0.5,8,21,29,102,25,1,47,18,145
1374,5,1984,30,1,1,63,39,1807,275,595,0.462,19,69,0.275,256,526,0.487,120,157,0.764,23,157,180,673,92,5,147,123,689
1374,6,1985,31,1,1,47,21,1158,206,446,0.462,21,66,0.318,185,380,0.487,103,129,0.798,21,64,85,318,62,2,102,78,536
1374,7,1986,32,1,1,65,65,2120,365,818,0.446,45,146,0.308,320,672,0.476,231,298,0.775,33,110,143,571,77,5,149,124,1006
1374,8,1987,33,1,1,43,40,1358,285,624,0.457,46,126,0.365,239,498,0.48,137,174,0.787,29,96,125,290,71,6,89,82,753
1374,9,1988,34,1,1,81,22,1766,281,631,0.445,51,151,0.338,230,480,0.479,130,162,0.802,29,130,159,392,88,3,125,102,743
1374,10,1989,35,1,1,74,8,842,119,299,0.398,18,68,0.265,101,231,0.437,54,77,0.701,22,57,79,260,60,1,66,53,310
1374,11,1990,36,1,1,49,18,938,109,291,0.375,26,87,0.299,83,204,0.407,42,55,0.764,19,71,90,238,45,2,85,59,286
1376,1,1999,21,1,1,15,0,188,28,65,0.431,7,16,0.438,21,49,0.429,12,21,0.571,2,4,6,25,5,0,11,28,75
1376,2,2000,22,1,1,8,0,146,19,39,0.487,4,8,0.5,15,31,0.484,6,8,0.75,2,10,12,17,3,0,9,17,48
1376,3,2001,23,1,1,38,1,468,50,117,0.427,11,34,0.324,39,83,0.47,19,24,0.792,5,27,32,45,19,0,27,54,130
1376,4,2002,24,1,1,71,0,1458,222,520,0.427,63,141,0.447,159,379,0.42,48,63,0.762,14,108,122,246,49,0,96,120,555
1376,5,2003,25,1,1,75,24,1986,248,573,0.433,60,176,0.341,188,397,0.474,91,104,0.875,22,127,149,263,47,1,77,151,647
1376,6,2004,26,1,1,76,69,2332,309,714,0.433,80,209,0.383,229,505,0.453,101,131,0.771,26,161,187,317,61,5,124,185,799
1376,7,2005,27,1,1,21,3,479,48,122,0.393,15,45,0.333,33,77,0.429,14,18,0.778,0,40,40,58,8,0,24,48,125
1376,7,2005,27,1,1,49,46,1528,247,532,0.464,40,110,0.364,207,422,0.491,128,147,0.871,14,95,109,264,25,0,81,120,662
1376,7,2005,27,1,1,70,49,2007,295,654,0.451,55,155,0.355,240,499,0.481,142,165,0.861,14,135,149,322,33,0,105,168,787
1376,8,2006,28,1,1,51,10,1234,192,418,0.459,58,127,0.457,134,291,0.46,118,138,0.855,13,69,82,157,26,3,75,113,560
1376,9,2007,29,1,1,56,17,1488,218,524,0.416,56,161,0.348,162,363,0.446,144,163,0.883,19,85,104,201,24,0,85,101,636
1376,10,2008,30,1,1,17,0,172,27,57,0.474,9,17,0.529,18,40,0.45,1,4,0.25,0,13,13,15,0,1,5,28,64
1376,10,2008,30,1,1,33,3,564,86,196,0.439,30,69,0.435,56,127,0.441,24,28,0.857,9,32,41,59,11,0,22,38,226
1376,10,2008,30,1,1,50,3,736,113,253,0.447,39,86,0.453,74,167,0.443,25,32,0.781,9,45,54,74,11,1,27,66,290
1376,11,2009,31,1,1,14,0,129,17,43,0.395,6,17,0.353,11,26,0.423,2,3,0.667,0,11,11,14,2,0,2,13,42
1376,11,2009,31,1,1,30,0,392,54,119,0.454,21,45,0.467,33,74,0.446,12,16,0.75,6,29,35,46,6,0,21,41,141
1376,11,2009,31,1,1,44,0,521,71,162,0.438,27,62,0.435,44,100,0.44,14,19,0.737,6,40,46,60,8,0,23,54,183
1378,1,1980,27,1,4,22,-1,708,128,261,0.49,0,4,0,128,257,0.498,79,102,0.775,58,154,212,83,19,27,70,82,335
1378,1,1980,27,1,4,41,-1,1176,243,552,0.44,2,5,0.4,241,547,0.441,100,137,0.73,85,240,325,125,23,35,148,141,588
1378,1,1980,27,1,4,63,-1,1884,371,813,0.456,2,9,0.222,369,804,0.459,179,239,0.749,143,394,537,208,42,62,218,223,923
1378,2,1981,28,1,4,68,-1,2162,404,835,0.484,0,2,0,404,833,0.485,191,254,0.752,153,422,575,173,57,59,176,260,999
1378,3,1982,29,1,4,80,74,2671,505,1001,0.504,0,3,0,505,998,0.506,253,349,0.725,274,629,903,179,68,70,173,309,1263
1378,4,1983,30,1,4,77,71,2586,495,1045,0.474,1,3,0.333,494,1042,0.474,278,356,0.781,201,598,799,219,56,43,221,274,1269
1378,5,1984,31,1,4,75,69,2309,451,908,0.497,0,5,0,451,903,0.499,293,383,0.765,208,517,725,203,55,39,177,235,1195
1378,6,1985,32,1,4,63,22,1670,346,727,0.476,0,4,0,346,723,0.479,150,200,0.75,138,419,557,145,39,17,151,183,842
1378,7,1986,33,1,4,77,8,1750,302,653,0.462,1,2,0.5,301,651,0.462,180,230,0.783,164,402,566,84,45,24,121,253,785
1378,8,1987,34,1,4,63,0,1120,175,388,0.451,0,5,0,175,383,0.457,150,187,0.802,88,219,307,65,34,21,75,171,500
1378,9,1988,35,1,4,73,0,1191,168,373,0.45,0,3,0,168,370,0.454,109,148,0.736,101,214,315,94,33,10,73,188,445
1383,1,1994,23,1,3,71,46,1762,291,573,0.508,0,5,0,291,568,0.512,99,166,0.596,220,190,410,96,102,27,87,177,681
1383,2,1995,24,1,3,56,15,953,138,295,0.468,3,21,0.143,135,274,0.493,62,86,0.721,75,109,184,62,51,10,73,86,341
1383,3,1996,25,1,3,76,6,1012,117,272,0.43,4,13,0.308,113,259,0.436,53,80,0.663,82,127,209,51,47,10,40,106,291
1383,4,1997,26,1,3,41,27,1059,137,291,0.471,8,31,0.258,129,260,0.496,60,97,0.619,98,163,261,76,63,17,64,97,342
1383,5,1998,27,1,3,82,0,1493,248,516,0.481,9,30,0.3,239,486,0.492,111,158,0.703,147,215,362,122,65,41,104,161,616
1383,6,1999,28,1,3,43,43,1315,147,349,0.421,9,23,0.391,138,326,0.423,53,84,0.631,110,169,279,76,85,22,79,142,356
1383,7,2000,29,1,3,75,75,2416,297,644,0.461,15,36,0.417,282,608,0.464,113,183,0.617,216,366,582,136,119,38,120,231,722
1383,8,2001,30,1,3,82,80,2649,274,616,0.445,15,57,0.263,259,559,0.463,123,171,0.719,200,390,590,139,99,30,109,222,686
1383,9,2002,31,1,3,45,18,893,73,198,0.369,1,6,0.167,72,192,0.375,25,40,0.625,70,116,186,54,40,14,41,75,172
1383,10,2003,32,1,2,81,32,1497,147,359,0.409,28,79,0.354,119,280,0.425,41,74,0.554,139,214,353,104,66,19,52,136,363
1383,11,2004,33,1,3,78,51,1701,149,375,0.397,43,139,0.309,106,236,0.449,34,51,0.667,96,216,312,117,48,18,64,159,375
1383,12,2005,34,1,3,44,27,933,68,189,0.36,11,37,0.297,57,152,0.375,17,23,0.739,55,119,174,88,32,12,57,83,164
1384,1,1992,23,1,2,55,3,819,93,223,0.417,3,8,0.375,90,215,0.419,35,46,0.761,30,55,85,83,37,9,44,107,224
1384,2,1993,24,1,2,40,8,324,30,59,0.508,0,1,0,30,58,0.517,26,38,0.684,12,23,35,25,11,6,24,44,86
1389,1,2000,23,1,4,47,9,432,44,140,0.314,13,44,0.295,31,96,0.323,19,27,0.704,24,64,88,25,14,8,22,55,120
1389,2,2001,24,1,4,27,0,127,18,43,0.419,5,9,0.556,13,34,0.382,15,20,0.75,19,20,39,5,6,3,10,21,56
1389,3,2002,25,1,4,75,1,1295,188,395,0.476,49,113,0.434,139,282,0.493,75,102,0.735,111,174,285,82,43,13,69,140,500
1389,4,2003,26,1,4,82,2,1321,170,423,0.402,45,133,0.338,125,290,0.431,81,107,0.757,83,189,272,86,41,24,70,148,466
1389,5,2004,27,1,4,58,5,547,74,167,0.443,28,65,0.431,46,102,0.451,24,32,0.75,46,93,139,23,12,13,22,73,200
1389,6,2005,28,1,4,66,0,942,98,233,0.421,50,126,0.397,48,107,0.449,29,40,0.725,47,138,185,55,33,10,30,119,275
1389,7,2006,29,1,4,62,1,718,71,201,0.353,42,121,0.347,29,80,0.363,27,34,0.794,56,109,165,41,28,12,21,90,211
1389,8,2007,30,1,4,24,0,198,15,49,0.306,8,29,0.276,7,20,0.35,6,11,0.545,11,34,45,8,4,3,8,33,44
1389,8,2007,30,1,4,31,0,231,16,56,0.286,8,33,0.242,8,23,0.348,6,13,0.462,16,38,54,8,5,3,9,35,46
1390,1,1992,22,1,1,72,0,894,115,272,0.423,0,10,0,115,262,0.439,102,127,0.803,32,65,97,140,40,4,92,101,332
1390,2,1993,23,1,1,77,1,1579,285,606,0.47,1,8,0.125,284,598,0.475,239,311,0.768,52,108,160,335,81,10,185,182,810
1390,3,1994,24,1,1,66,4,1382,223,503,0.443,6,29,0.207,217,474,0.458,179,236,0.758,25,98,123,356,81,9,204,147,631
1390,4,1995,25,1,1,42,32,1144,170,395,0.43,30,72,0.417,140,323,0.433,137,175,0.783,19,94,113,290,61,6,134,101,507
1390,5,1996,26,1,1,31,31,1084,190,444,0.428,26,98,0.265,164,346,0.474,154,182,0.846,29,103,132,242,62,1,114,68,560
1390,6,1997,27,1,1,20,11,597,79,219,0.361,9,38,0.237,70,181,0.387,62,73,0.849,13,47,60,127,35,3,67,56,229
1390,6,1997,27,1,1,34,31,1185,193,474,0.407,22,74,0.297,171,400,0.428,134,170,0.788,15,71,86,325,59,3,150,83,542
1390,6,1997,27,1,1,54,42,1782,272,693,0.392,31,112,0.277,241,581,0.415,196,243,0.807,28,118,146,452,94,6,217,139,771
1390,7,1998,28,1,1,12,10,292,33,98,0.337,3,6,0.5,30,92,0.326,25,36,0.694,8,26,34,42,20,1,38,17,94
1390,8,1999,29,1,1,25,0,468,75,174,0.431,0,4,0,75,170,0.441,72,88,0.818,9,27,36,81,20,1,49,41,222
1390,9,2000,30,1,1,29,22,665,96,230,0.417,4,11,0.364,92,219,0.42,63,78,0.808,7,35,42,168,31,3,76,44,259
1390,10,2001,31,1,1,74,11,1260,181,426,0.425,12,31,0.387,169,395,0.428,105,137,0.766,30,107,137,293,65,1,135,114,479
1390,11,2002,32,1,1,16,0,252,25,68,0.368,1,4,0.25,24,64,0.375,11,15,0.733,7,16,23,49,13,0,20,32,62
1390,12,2003,33,1,1,28,4,440,52,129,0.403,0,5,0,52,124,0.419,41,55,0.745,11,40,51,81,25,0,40,35,145
1390,13,2004,34,1,1,26,0,220,22,52,0.423,0,0,-1,22,52,0.423,5,6,0.833,4,14,18,27,12,1,16,20,49
1393,1,2000,21,1,1,53,0,394,43,98,0.439,0,2,0,43,96,0.448,22,37,0.595,17,34,51,48,20,0,44,32,108
1393,2,2001,22,1,1,58,6,1141,126,267,0.472,12,36,0.333,114,231,0.494,78,92,0.848,25,77,102,151,48,0,80,83,342
1393,3,2002,23,1,2,28,1,272,30,79,0.38,1,7,0.143,29,72,0.403,18,23,0.783,3,20,23,29,9,1,16,23,79
1393,3,2002,23,1,1,41,0,518,52,135,0.385,12,34,0.353,40,101,0.396,36,51,0.706,8,42,50,54,21,3,24,38,152
1393,3,2002,23,1,1,69,1,790,82,214,0.383,13,41,0.317,69,173,0.399,54,74,0.73,11,62,73,83,30,4,40,61,231
1393,4,2003,24,1,1,80,46,1976,162,388,0.418,8,37,0.216,154,351,0.439,65,87,0.747,48,187,235,259,68,16,131,168,397
1393,5,2004,25,1,1,59,13,1211,104,298,0.349,4,26,0.154,100,272,0.368,45,68,0.662,15,87,102,184,41,11,87,90,257
1393,6,2005,26,1,1,80,4,1533,175,392,0.446,2,12,0.167,173,380,0.455,115,155,0.742,26,108,134,279,48,13,104,126,467
1393,7,2006,27,1,1,71,18,1376,171,403,0.424,1,16,0.063,170,387,0.439,98,150,0.653,17,117,134,190,47,14,110,125,441
1399,1,2012,25,1,1,44,5,424,50,150,0.333,10,38,0.263,40,112,0.357,16,27,0.593,12,25,37,55,15,0,46,46,126
1399,2,2013,26,1,2,14,0,208,24,63,0.381,7,17,0.412,17,46,0.37,14,21,0.667,1,16,17,28,1,0,13,14,69
1399,2,2013,26,1,1,25,11,447,75,187,0.401,18,57,0.316,57,130,0.438,28,41,0.683,7,25,32,64,12,2,37,32,196
1399,2,2013,26,1,1,39,11,655,99,250,0.396,25,74,0.338,74,176,0.42,42,62,0.677,8,41,49,92,13,2,50,46,265
1401,1,1980,26,1,5,72,-1,2119,510,1006,0.507,0,1,0,510,1005,0.507,203,284,0.715,247,536,783,122,58,115,225,248,1223
1401,2,1981,27,1,5,82,78,2298,635,1166,0.545,0,1,0,635,1165,0.545,282,397,0.71,245,532,777,144,81,214,191,310,1552
1401,3,1982,28,1,5,80,78,2534,669,1235,0.542,0,0,-1,669,1235,0.542,252,355,0.71,288,578,866,140,68,192,221,267,1590
1401,4,1983,29,1,5,78,76,2459,619,1125,0.55,0,1,0,619,1124,0.551,271,388,0.698,260,567,827,141,79,148,185,222,1509
1401,5,1984,30,1,5,80,79,2867,623,1140,0.546,0,0,-1,623,1140,0.546,274,368,0.745,243,614,857,139,55,116,184,266,1520
1401,6,1985,31,1,5,79,78,2850,551,1016,0.542,0,0,-1,551,1016,0.542,292,393,0.743,263,577,840,125,56,101,186,223,1394
1401,7,1986,32,1,5,81,80,2567,530,966,0.549,0,0,-1,530,966,0.549,245,335,0.731,246,524,770,145,65,116,187,215,1305
1401,8,1987,33,1,5,80,80,2995,588,1057,0.556,0,1,0,588,1056,0.557,227,309,0.735,254,597,851,173,64,144,191,266,1403
1401,9,1988,34,1,5,74,73,2312,442,750,0.589,0,1,0,442,749,0.59,177,241,0.734,173,455,628,115,55,84,154,198,1061
1401,10,1989,35,1,5,80,80,2840,596,1045,0.57,0,0,-1,596,1045,0.57,294,409,0.719,342,654,996,175,79,116,200,209,1486
1401,11,1990,36,1,5,79,78,2396,505,871,0.58,0,0,-1,505,871,0.58,233,312,0.747,259,537,796,103,38,69,169,189,1243
1401,12,1991,37,1,5,81,81,2441,485,811,0.598,0,1,0,485,810,0.599,237,309,0.767,271,585,856,66,66,103,153,197,1207
1401,13,1992,38,1,5,79,79,2285,468,874,0.535,0,0,-1,468,874,0.535,179,232,0.772,219,486,705,70,68,97,131,172,1115
1401,14,1993,39,1,5,79,79,2146,416,777,0.535,0,0,-1,416,777,0.535,162,235,0.689,246,494,740,61,57,107,120,201,994
1401,15,1994,40,1,5,74,74,1987,356,725,0.491,0,0,-1,356,725,0.491,154,208,0.74,141,401,542,82,42,96,108,190,866
1401,16,1995,41,1,5,81,4,1352,159,372,0.427,0,0,-1,159,372,0.427,71,101,0.703,93,257,350,44,27,36,66,132,389
1401,17,1996,42,1,5,74,34,1086,120,241,0.498,0,0,-1,120,241,0.498,50,71,0.704,89,214,303,29,21,54,50,80,290
1401,18,1997,43,1,5,43,3,406,70,143,0.49,0,0,-1,70,143,0.49,21,31,0.677,42,47,89,22,6,19,28,40,161
1408,1,1980,24,1,3,82,-1,2849,483,988,0.489,0,2,0,483,986,0.49,237,302,0.785,166,298,464,254,173,32,163,195,1203
1408,2,1981,25,1,2,73,-1,1317,191,388,0.492,0,0,-1,191,388,0.492,94,128,0.734,101,93,194,106,67,13,84,112,476
1408,3,1982,26,1,3,71,0,899,116,245,0.473,0,0,-1,116,245,0.473,48,72,0.667,73,104,177,89,39,11,51,101,280
1410,1,1996,23,1,5,64,3,869,101,247,0.409,7,26,0.269,94,221,0.425,41,62,0.661,66,150,216,29,25,32,31,100,250
1410,2,1997,24,1,4,76,0,961,103,202,0.51,0,1,0,103,201,0.512,46,76,0.605,83,112,195,34,41,48,32,150,252
1410,3,1998,25,1,5,79,43,1703,224,449,0.499,0,1,0,224,448,0.5,110,169,0.651,140,297,437,53,36,86,66,237,558
1410,4,1999,26,1,5,48,41,1118,118,275,0.429,0,1,0,118,274,0.431,30,55,0.545,75,168,243,36,28,28,49,114,266
1410,5,2000,27,1,5,56,14,808,72,145,0.497,0,1,0,72,144,0.5,24,37,0.649,55,128,183,35,29,45,28,115,168
1410,6,2001,28,1,5,13,0,178,18,38,0.474,0,0,-1,18,38,0.474,12,17,0.706,13,27,40,7,6,11,10,20,48
1410,6,2001,28,1,5,52,31,876,116,236,0.492,0,6,0,116,230,0.504,19,27,0.704,58,131,189,39,19,25,31,102,251
1410,6,2001,28,1,5,65,31,1054,134,274,0.489,0,6,0,134,268,0.5,31,44,0.705,71,158,229,46,25,36,41,122,299
1410,7,2002,29,1,5,42,1,234,30,83,0.361,0,0,-1,30,83,0.361,3,8,0.375,24,34,58,10,7,8,14,34,63
1410,8,2003,30,1,4,30,18,648,82,163,0.503,1,2,0.5,81,161,0.503,23,38,0.605,46,86,132,21,16,20,18,52,188
1412,1,1990,23,1,3,28,1,181,27,79,0.342,0,1,0,27,78,0.346,18,22,0.818,15,15,30,10,3,7,21,37,72
1416,1,1999,23,1,4,35,0,284,43,97,0.443,0,5,0,43,92,0.467,28,36,0.778,30,35,65,15,19,7,22,62,114
1418,1,1999,23,1,3,24,2,144,21,51,0.412,1,6,0.167,20,45,0.444,22,31,0.71,17,13,30,2,5,3,12,16,65
1418,2,2000,24,1,3,81,74,2097,354,661,0.536,12,27,0.444,342,634,0.539,222,321,0.692,218,216,434,126,94,40,144,190,942
1418,3,2001,25,1,3,76,22,2059,370,749,0.494,2,36,0.056,368,713,0.516,246,361,0.681,183,199,382,161,103,45,155,176,988
1418,4,2002,26,1,3,75,13,1765,319,619,0.515,9,36,0.25,310,583,0.532,192,274,0.701,155,143,298,107,79,37,114,140,839
1418,5,2003,27,1,3,78,17,1655,254,516,0.492,3,20,0.15,251,496,0.506,138,220,0.627,120,144,264,101,73,29,117,161,649
1418,6,2004,28,1,3,73,1,1651,200,395,0.506,2,12,0.167,198,383,0.517,105,190,0.553,129,139,268,139,84,21,105,152,507
1418,7,2005,29,1,3,70,36,1957,319,601,0.531,2,25,0.08,317,576,0.55,169,282,0.599,126,147,273,138,106,21,143,164,809
1418,8,2006,30,1,2,26,20,736,139,256,0.543,1,6,0.167,138,250,0.552,65,112,0.58,45,45,90,67,34,9,68,71,344
1418,8,2006,30,1,3,45,2,1056,188,379,0.496,0,7,0,188,372,0.505,138,226,0.611,73,81,154,60,42,12,82,79,514
1418,8,2006,30,1,3,71,22,1792,327,635,0.515,1,13,0.077,326,622,0.524,203,338,0.601,118,126,244,127,76,21,150,150,858
1418,9,2007,31,1,3,81,53,2508,475,867,0.548,3,19,0.158,472,848,0.557,241,376,0.641,190,250,440,232,110,25,199,232,1194
1418,10,2008,32,1,3,20,5,327,39,86,0.453,0,2,0,39,84,0.464,24,43,0.558,24,40,64,17,21,7,27,37,102
1423,1,1990,23,1,3,35,4,216,47,108,0.435,4,10,0.4,43,98,0.439,16,18,0.889,11,15,26,10,7,6,20,37,114
1423,2,1991,24,1,3,47,6,444,68,189,0.36,4,18,0.222,64,171,0.374,26,29,0.897,17,49,66,16,10,6,21,43,166
1423,3,1992,25,1,3,49,3,353,65,145,0.448,5,12,0.417,60,133,0.451,9,13,0.692,13,41,54,17,16,8,19,34,144
1423,4,1993,26,1,3,13,0,154,38,90,0.422,4,18,0.222,34,72,0.472,4,4,1,4,20,24,18,5,2,7,15,84
1424,1,1984,23,1,1,49,0,458,61,137,0.445,4,22,0.182,57,115,0.496,16,26,0.615,4,29,33,149,10,2,32,47,142
1424,2,1985,24,1,1,78,1,1259,196,385,0.509,10,34,0.294,186,351,0.53,84,100,0.84,19,49,68,215,45,3,81,117,486
1424,3,1986,25,1,1,75,3,1570,153,328,0.466,15,50,0.3,138,278,0.496,74,92,0.804,18,76,94,274,55,2,63,172,395
1424,4,1987,26,1,1,82,64,2689,386,793,0.487,52,140,0.371,334,653,0.511,106,131,0.809,22,117,139,467,66,8,105,207,930
1424,5,1988,27,1,1,81,30,1888,287,582,0.493,33,95,0.347,254,487,0.522,33,45,0.733,16,88,104,303,49,1,64,154,640
1424,6,1989,28,1,1,78,20,1738,246,513,0.48,44,133,0.331,202,380,0.532,31,36,0.861,13,81,94,308,53,6,71,162,567
1424,7,1990,29,1,1,82,82,2365,365,708,0.516,33,92,0.359,332,616,0.539,56,68,0.824,27,92,119,335,83,6,85,176,819
1424,8,1991,30,1,1,82,82,1971,317,578,0.548,42,96,0.438,275,482,0.571,34,41,0.829,15,76,91,297,62,3,69,136,710
1424,9,1992,31,1,1,79,79,1946,257,487,0.528,12,44,0.273,245,443,0.553,29,37,0.784,21,75,96,241,49,9,44,142,555
1424,10,1993,32,1,1,59,8,1030,105,233,0.451,19,41,0.463,86,192,0.448,17,20,0.85,9,39,48,136,38,2,31,99,246
1424,11,1994,33,1,1,27,0,343,30,68,0.441,9,22,0.409,21,46,0.457,1,2,0.5,3,17,20,33,7,2,6,18,70
1425,1,1980,22,1,2,72,-1,1270,189,460,0.411,1,22,0.045,188,438,0.429,64,90,0.711,25,84,109,144,48,5,93,97,443
1425,2,1981,23,1,2,79,-1,2701,585,1092,0.536,2,30,0.067,583,1062,0.549,182,248,0.734,74,137,211,299,140,9,131,172,1354
1425,3,1982,24,1,2,82,82,2756,662,1258,0.526,8,35,0.229,654,1223,0.535,220,287,0.767,75,146,221,276,129,12,144,159,1552
1425,4,1983,25,1,2,81,81,2740,682,1323,0.515,4,25,0.16,678,1298,0.522,388,478,0.812,68,106,174,231,140,17,156,160,1756
1425,5,1984,26,1,2,81,81,2686,680,1322,0.514,17,59,0.288,663,1263,0.525,345,410,0.841,68,105,173,251,122,10,142,165,1722
1425,6,1985,27,1,2,68,57,2253,508,988,0.514,6,39,0.154,502,949,0.529,196,248,0.79,69,153,222,264,101,5,108,115,1218
1425,7,1986,28,1,2,75,31,1931,372,792,0.47,20,62,0.323,352,730,0.482,217,244,0.889,42,106,148,278,94,5,112,156,981
1425,8,1987,29,1,2,72,1,1798,337,733,0.46,26,98,0.265,311,635,0.49,174,216,0.806,41,98,139,237,76,12,108,134,874
1425,9,1988,30,1,2,17,1,263,43,107,0.402,3,8,0.375,40,99,0.404,14,18,0.778,8,10,18,27,7,1,11,29,103
1425,9,1988,30,1,2,28,2,538,94,191,0.492,2,13,0.154,92,178,0.517,54,61,0.885,7,20,27,49,23,4,28,44,244
1425,9,1988,30,1,2,45,3,801,137,298,0.46,5,21,0.238,132,277,0.477,68,79,0.861,15,30,45,76,30,5,39,73,347
1425,10,1989,31,1,1,57,7,1138,202,445,0.454,4,24,0.167,198,421,0.47,84,103,0.816,18,56,74,107,38,8,57,96,492
1425,11,1990,32,1,1,72,25,1283,191,422,0.453,5,20,0.25,186,402,0.463,73,90,0.811,24,53,77,137,33,5,54,115,460
1427,1,1980,31,1,5,37,-1,980,138,292,0.473,0,0,-1,138,292,0.473,43,82,0.524,92,173,265,70,22,39,57,86,319
1427,1,1980,31,1,5,47,-1,1213,189,381,0.496,0,1,0,189,380,0.497,66,100,0.66,95,226,321,118,47,45,58,127,444
1427,1,1980,31,1,5,84,-1,2193,327,673,0.486,0,1,0,327,672,0.487,109,182,0.599,187,399,586,188,69,84,115,213,763
1427,2,1981,32,1,4,81,-1,1659,262,517,0.507,0,3,0,262,514,0.51,75,153,0.49,111,280,391,105,28,72,89,182,599
1427,3,1982,33,1,5,65,3,807,89,226,0.394,0,0,-1,89,226,0.394,34,65,0.523,54,126,180,41,15,22,45,99,212
1427,4,1983,34,1,5,7,0,125,12,27,0.444,0,0,-1,12,27,0.444,1,2,0.5,10,23,33,4,5,6,6,14,25
1427,4,1983,34,1,5,57,0,695,89,200,0.445,0,0,-1,89,200,0.445,26,57,0.456,54,113,167,57,12,12,41,95,204
1427,4,1983,34,1,5,64,0,820,101,227,0.445,0,0,-1,101,227,0.445,27,59,0.458,64,136,200,61,17,18,47,109,229
1427,5,1984,35,1,5,40,4,486,36,88,0.409,0,0,-1,36,88,0.409,17,33,0.515,35,78,113,18,8,7,22,57,89
1427,6,1985,36,1,5,62,0,370,32,87,0.368,0,0,-1,32,87,0.368,18,28,0.643,24,72,96,16,6,11,30,51,82
1429,1,1991,22,1,1,82,82,2244,259,575,0.45,1,13,0.077,258,562,0.459,69,97,0.711,108,135,243,528,165,15,180,249,588
1429,2,1992,23,1,1,81,79,2549,331,734,0.451,3,23,0.13,328,711,0.461,99,148,0.669,123,172,295,506,147,21,174,248,764
1429,3,1993,24,1,1,82,78,2548,476,963,0.494,7,34,0.206,469,929,0.505,151,196,0.77,95,186,281,399,177,21,148,250,1110
1429,4,1994,25,1,1,82,82,2881,584,1159,0.504,15,54,0.278,569,1105,0.515,166,279,0.595,105,164,269,494,188,19,173,227,1349
1429,5,1995,26,1,1,82,82,3015,685,1345,0.509,70,232,0.302,615,1113,0.553,249,348,0.716,108,173,281,583,204,13,201,206,1689
1429,6,1996,27,1,1,81,81,3162,618,1276,0.484,98,299,0.328,520,977,0.532,229,306,0.748,104,235,339,608,231,19,260,221,1563
1429,7,1997,28,1,1,82,82,3213,706,1482,0.476,119,380,0.313,587,1102,0.533,254,355,0.715,106,272,378,583,197,13,215,208,1785
1429,8,1998,29,1,1,82,82,3145,579,1278,0.453,134,397,0.338,445,881,0.505,279,375,0.744,77,299,376,679,185,18,229,195,1571
1429,9,1999,30,1,1,50,50,2008,401,923,0.434,83,281,0.295,318,642,0.495,199,276,0.721,62,182,244,436,109,12,154,115,1084
1429,10,2000,31,1,1,82,82,3425,747,1666,0.448,177,520,0.34,570,1146,0.497,311,423,0.735,100,429,529,732,153,18,224,178,1982
1429,11,2001,32,1,1,79,79,3244,725,1591,0.456,102,272,0.375,623,1319,0.472,271,354,0.766,73,288,361,642,127,26,209,184,1823
1429,12,2002,33,1,1,82,82,3301,737,1578,0.467,74,236,0.314,663,1342,0.494,267,335,0.797,80,316,396,737,131,26,209,179,1815
1429,13,2003,34,1,1,28,28,1085,221,474,0.466,20,68,0.294,201,406,0.495,88,118,0.746,23,63,86,206,40,8,56,64,550
1429,13,2003,34,1,1,52,52,2123,444,992,0.448,34,114,0.298,410,878,0.467,162,234,0.692,56,192,248,457,93,12,131,117,1084
1429,13,2003,34,1,1,80,80,3208,665,1466,0.454,54,182,0.297,611,1284,0.476,250,352,0.71,79,255,334,663,133,20,187,181,1634
1429,14,2004,35,1,1,82,82,2825,482,1024,0.471,55,165,0.333,427,859,0.497,180,252,0.714,72,270,342,449,96,19,151,169,1199
1429,15,2005,36,1,1,77,77,2541,339,725,0.468,42,129,0.326,297,596,0.498,153,201,0.761,48,188,236,469,88,12,148,121,873
1429,16,2006,37,1,1,81,25,2305,230,547,0.42,66,230,0.287,164,317,0.517,100,126,0.794,34,199,233,257,71,10,102,169,626
1429,17,2007,38,1,1,68,28,1503,144,366,0.393,32,123,0.26,112,243,0.461,38,57,0.667,18,114,132,201,43,3,66,117,358
1433,1,2008,22,1,5,35,0,320,44,125,0.352,17,60,0.283,27,65,0.415,20,31,0.645,21,45,66,7,6,5,17,30,125
1433,2,2009,23,1,5,32,0,277,39,101,0.386,14,43,0.326,25,58,0.431,24,29,0.828,35,41,76,2,6,3,10,34,116
1433,3,2010,24,1,5,44,5,447,77,188,0.41,14,52,0.269,63,136,0.463,29,32,0.906,32,92,124,11,9,14,32,55,197
1434,1,1980,22,1,3,52,-1,628,73,169,0.432,0,2,0,73,167,0.437,34,55,0.618,66,117,183,33,17,23,48,100,180
1436,1,1993,23,1,2,77,11,1656,297,634,0.468,46,118,0.39,251,516,0.486,162,206,0.786,64,115,179,166,60,14,123,193,802
1436,2,1994,24,1,2,30,30,923,176,409,0.43,14,63,0.222,162,346,0.468,57,71,0.803,48,61,109,94,43,8,59,93,423
1436,3,1995,25,1,2,73,24,1559,285,659,0.432,84,216,0.389,201,443,0.454,102,128,0.797,62,106,168,122,52,13,82,143,756
1436,4,1996,26,1,2,73,12,1608,272,602,0.452,105,254,0.413,167,348,0.48,61,86,0.709,45,92,137,118,59,10,56,139,710
1436,5,1997,27,1,2,72,57,2291,402,1011,0.398,128,343,0.373,274,668,0.41,109,133,0.82,54,193,247,256,105,17,157,168,1041
1436,6,1998,28,1,2,8,8,202,35,72,0.486,5,19,0.263,30,53,0.566,4,6,0.667,6,14,20,23,9,0,6,16,79
1436,6,1998,28,1,2,30,24,991,155,348,0.445,48,106,0.453,107,242,0.442,32,41,0.78,31,72,103,114,52,6,45,81,390
1436,6,1998,28,1,2,38,32,1193,190,420,0.452,53,125,0.424,137,295,0.464,36,47,0.766,37,86,123,137,61,6,51,97,469
1436,7,1999,29,1,2,28,28,810,103,272,0.379,34,114,0.298,69,158,0.437,30,41,0.732,30,54,84,78,35,6,38,60,270
1436,8,2000,30,1,2,82,22,2073,316,725,0.436,85,255,0.333,231,470,0.491,87,109,0.798,58,174,232,195,62,10,85,171,804
1436,9,2001,31,1,2,75,41,2126,308,732,0.421,100,256,0.391,208,476,0.437,75,87,0.862,44,148,192,192,91,18,105,166,791
1436,10,2002,32,1,2,82,0,2060,288,684,0.421,111,283,0.392,177,401,0.441,50,58,0.862,37,169,206,177,61,11,76,137,737
1436,11,2003,33,1,2,82,39,2245,252,609,0.414,87,212,0.41,165,397,0.416,39,50,0.78,40,201,241,244,72,13,82,161,630
1436,12,2004,34,1,2,75,0,1391,156,348,0.448,68,141,0.482,88,207,0.425,51,61,0.836,31,122,153,120,56,10,77,103,431
1436,13,2005,35,1,2,40,0,529,56,150,0.373,25,65,0.385,31,85,0.365,16,18,0.889,14,51,65,57,18,2,28,39,153
1439,1,1980,28,1,4,44,-1,373,44,108,0.407,0,0,-1,44,108,0.407,21,30,0.7,28,64,92,18,12,12,18,70,109
1439,2,1981,29,1,4,77,-1,1472,186,380,0.489,0,1,0,186,379,0.491,81,116,0.698,122,234,356,48,50,92,99,228,453
1439,3,1982,30,1,4,69,4,1037,114,251,0.454,0,1,0,114,250,0.456,61,79,0.772,90,139,229,28,29,47,57,164,289
1440,1,2001,26,1,1,53,0,851,92,222,0.414,55,139,0.396,37,83,0.446,28,31,0.903,10,53,63,71,22,2,34,57,267
1446,1,1985,23,1,4,82,42,2317,347,736,0.471,9,36,0.25,338,700,0.483,200,244,0.82,189,416,605,135,63,63,102,236,903
1446,2,1986,24,1,4,80,79,2626,458,910,0.503,11,33,0.333,447,877,0.51,307,377,0.814,195,490,685,153,75,94,145,212,1234
1446,3,1987,25,1,4,80,80,2687,461,957,0.482,19,54,0.352,442,903,0.489,245,296,0.828,197,419,616,146,109,77,132,269,1186
1446,4,1988,26,1,4,75,75,2499,394,876,0.45,5,30,0.167,389,846,0.46,273,332,0.822,201,400,601,118,74,54,119,227,1066
1446,5,1989,27,1,4,78,77,2860,445,959,0.464,7,38,0.184,438,921,0.476,274,329,0.833,235,453,688,127,76,92,141,224,1171
1446,6,1990,28,1,3,76,70,2668,435,883,0.493,6,28,0.214,429,855,0.502,330,424,0.778,209,363,572,175,88,64,148,225,1206
1446,7,1991,29,1,4,73,66,2504,368,744,0.495,18,64,0.281,350,680,0.515,229,279,0.821,167,371,538,108,64,78,103,247,983
1446,8,1992,30,1,4,63,63,2332,361,803,0.45,15,69,0.217,346,734,0.471,304,372,0.817,192,364,556,141,64,62,83,192,1041
1446,9,1993,31,1,4,30,13,762,139,272,0.511,19,42,0.452,120,230,0.522,66,83,0.795,52,93,145,28,20,31,32,86,363
1446,9,1993,31,1,4,49,49,1589,242,527,0.459,5,29,0.172,237,498,0.476,184,222,0.829,111,268,379,128,40,51,76,139,673
1446,9,1993,31,1,4,79,62,2351,381,799,0.477,24,71,0.338,357,728,0.49,250,305,0.82,163,361,524,156,60,82,108,225,1036
1446,10,1994,32,1,4,81,41,2170,341,779,0.438,99,270,0.367,242,509,0.475,218,272,0.801,120,246,366,111,67,31,103,197,999
1446,11,1995,33,1,5,82,37,2356,346,742,0.466,136,343,0.397,210,399,0.526,215,269,0.799,96,302,398,135,72,45,77,186,1043
1446,12,1996,34,1,4,82,20,2169,325,797,0.408,129,363,0.355,196,434,0.452,191,241,0.793,101,266,367,120,83,48,82,174,970
1446,13,1997,35,1,5,81,4,1976,290,661,0.439,122,309,0.395,168,352,0.477,187,229,0.817,74,226,300,103,69,49,77,134,889
1446,14,1998,36,1,4,81,0,1675,196,471,0.416,87,222,0.392,109,249,0.438,101,128,0.789,53,202,255,113,62,29,62,158,580
1446,15,1999,37,1,4,48,0,789,80,200,0.4,35,90,0.389,45,110,0.409,43,60,0.717,36,102,138,25,15,14,22,74,238
1446,16,2000,38,1,4,81,0,1620,184,441,0.417,89,218,0.408,95,223,0.426,80,97,0.825,64,225,289,68,31,33,63,136,537
1446,17,2001,39,1,4,64,41,999,86,226,0.381,38,110,0.345,48,116,0.414,32,38,0.842,32,136,168,41,33,18,19,61,242
1449,1,1994,23,1,5,55,19,667,76,141,0.539,0,1,0,76,140,0.543,24,44,0.545,49,120,169,24,17,25,34,131,176
1450,1,1989,23,1,5,30,0,190,29,72,0.403,0,0,-1,29,72,0.403,8,14,0.571,18,27,45,11,4,6,15,38,66
1450,2,1990,24,1,5,77,11,884,111,268,0.414,0,5,0,111,263,0.422,72,104,0.692,88,126,214,46,19,26,65,150,294
1450,3,1991,25,1,5,74,3,972,116,235,0.494,0,3,0,116,232,0.5,75,112,0.67,122,214,336,47,23,57,75,147,307
1450,4,1992,26,1,5,77,7,1007,152,278,0.547,1,2,0.5,151,276,0.547,45,91,0.495,108,204,312,80,16,43,72,133,350
1450,5,1993,27,1,5,72,16,998,137,246,0.557,0,1,0,137,245,0.559,67,111,0.604,103,184,287,74,22,47,74,139,341
1450,6,1994,28,1,5,43,6,397,47,112,0.42,0,1,0,47,111,0.423,23,32,0.719,40,86,126,34,8,11,42,61,117
1450,7,1995,29,1,5,78,78,1592,254,459,0.553,0,1,0,254,458,0.555,113,194,0.582,211,311,522,90,26,56,116,220,621
1450,8,1996,30,1,5,80,22,1396,173,331,0.523,0,1,0,173,330,0.524,67,125,0.536,175,310,485,33,28,75,86,183,413
1450,9,1997,31,1,5,65,34,1918,233,410,0.568,0,0,-1,233,410,0.568,99,171,0.579,251,387,638,38,32,102,87,184,565
1450,10,1998,32,1,5,79,30,1491,162,295,0.549,0,1,0,162,294,0.551,70,133,0.526,177,358,535,57,22,50,81,137,394
1450,11,1999,33,1,5,37,1,445,38,60,0.633,0,0,-1,38,60,0.633,14,26,0.538,33,105,138,18,9,10,22,63,90
1450,12,2000,34,1,5,67,15,1012,59,168,0.351,0,0,-1,59,168,0.351,50,105,0.476,88,174,262,65,14,42,78,126,168
1452,1,1989,23,1,5,62,15,614,108,201,0.537,1,4,0.25,107,197,0.543,40,65,0.615,61,71,132,18,19,32,37,47,257
1452,2,1990,24,1,5,60,18,612,100,195,0.513,1,1,1,99,194,0.51,53,90,0.589,79,73,152,17,21,22,47,76,254
1452,3,1991,25,1,5,46,2,587,75,144,0.521,0,5,0,75,139,0.54,43,70,0.614,53,73,126,27,23,43,32,60,193
1452,4,1992,26,1,4,80,69,2483,413,789,0.523,3,8,0.375,410,781,0.525,153,215,0.712,204,347,551,134,44,116,141,237,982
1452,5,1993,27,1,4,81,51,2104,287,613,0.468,10,49,0.204,277,564,0.491,147,207,0.71,154,255,409,126,40,91,123,159,731
1452,6,1994,28,1,4,80,68,2336,272,625,0.435,73,200,0.365,199,425,0.468,102,176,0.58,117,287,404,94,60,82,80,154,719
1452,7,1995,29,1,4,42,1,446,27,78,0.346,0,14,0,27,64,0.422,22,40,0.55,38,51,89,12,10,15,21,51,76
1452,8,1996,30,1,4,22,1,167,23,47,0.489,3,7,0.429,20,40,0.5,3,6,0.5,15,20,35,6,2,10,7,11,52
1452,8,1996,30,1,4,30,1,254,31,65,0.477,4,8,0.5,27,57,0.474,5,9,0.556,21,27,48,8,4,13,10,16,71
1453,1,1995,23,1,2,78,56,1800,309,638,0.484,116,266,0.436,193,372,0.519,80,101,0.792,67,134,201,105,48,24,79,149,814
1453,2,1996,24,1,2,82,47,2609,390,877,0.445,117,313,0.374,273,564,0.484,148,192,0.771,56,265,321,138,55,22,89,148,1045
1453,3,1997,25,1,2,80,42,2326,409,903,0.453,171,414,0.413,238,489,0.487,91,114,0.798,68,224,292,123,86,20,76,102,1080
1453,4,1998,26,1,2,82,82,3198,440,957,0.46,192,447,0.43,248,510,0.486,132,170,0.776,65,298,363,188,129,49,110,108,1204
1453,5,1999,27,1,2,45,42,1342,198,437,0.453,75,200,0.375,123,237,0.519,32,53,0.604,19,123,142,80,37,16,41,52,503
1453,6,2000,28,1,2,79,38,2056,280,654,0.428,106,250,0.424,174,404,0.431,61,77,0.792,44,223,267,146,40,19,60,119,727
1453,7,2001,29,1,2,44,22,958,128,292,0.438,34,84,0.405,94,208,0.452,24,30,0.8,11,119,130,64,27,11,40,62,314
1453,8,2002,30,1,2,78,78,2793,467,944,0.495,143,322,0.444,324,622,0.521,99,124,0.798,50,244,294,173,77,37,74,93,1176
1453,9,2003,31,1,2,66,44,1941,274,601,0.456,100,231,0.433,174,370,0.47,79,97,0.814,24,168,192,112,42,19,56,64,727
1453,10,2004,32,1,2,9,0,132,13,39,0.333,8,19,0.421,5,20,0.25,6,6,1,2,23,25,5,3,1,4,5,40
1453,10,2004,32,1,2,16,0,284,33,107,0.308,11,43,0.256,22,64,0.344,6,8,0.75,2,16,18,23,5,2,16,11,83
1453,10,2004,32,1,2,33,0,621,80,168,0.476,36,76,0.474,44,92,0.478,19,25,0.76,12,62,74,38,11,6,18,22,215
1453,10,2004,32,1,2,58,0,1037,126,314,0.401,55,138,0.399,71,176,0.403,31,39,0.795,16,101,117,66,19,9,38,38,338
1453,11,2005,33,1,3,16,3,206,25,57,0.439,8,21,0.381,17,36,0.472,4,4,1,1,21,22,11,6,0,7,6,62
1453,11,2005,33,1,3,25,0,461,82,169,0.485,33,68,0.485,49,101,0.485,5,9,0.556,2,59,61,28,13,4,10,24,202
1453,11,2005,33,1,3,41,3,667,107,226,0.473,41,89,0.461,66,137,0.482,9,13,0.692,3,80,83,39,19,4,17,30,264
1454,1,1985,22,1,4,60,0,714,70,144,0.486,0,0,-1,70,144,0.486,50,66,0.758,44,103,147,29,14,32,71,125,190
1454,2,1986,23,1,4,82,20,1664,196,411,0.477,0,3,0,196,408,0.48,113,160,0.706,149,247,396,85,38,54,84,231,505
1454,3,1987,24,1,4,82,56,2403,386,755,0.511,0,4,0,386,751,0.514,152,209,0.727,177,380,557,127,43,102,152,268,924
1454,4,1988,25,1,4,69,50,1793,249,488,0.51,1,6,0.167,248,482,0.515,114,153,0.745,145,291,436,106,36,40,119,203,613
1454,5,1989,26,1,5,66,40,1633,278,606,0.459,0,8,0,278,598,0.465,115,154,0.747,121,292,413,81,47,68,147,236,671
1454,6,1990,27,1,5,43,19,592,60,141,0.426,0,1,0,60,140,0.429,52,73,0.712,49,111,160,23,17,20,36,103,172
1454,7,1991,28,1,5,62,21,834,114,236,0.483,1,4,0.25,113,232,0.487,50,76,0.658,69,131,200,27,13,41,48,153,279
1454,8,1992,29,1,4,27,2,169,18,40,0.45,0,2,0,18,38,0.474,7,10,0.7,12,33,45,9,5,6,5,35,43
1458,1,2001,23,1,2,80,49,1809,290,673,0.431,63,165,0.382,227,508,0.447,104,145,0.717,112,147,259,105,63,20,78,164,747
1458,2,2002,24,1,3,63,56,1988,336,768,0.438,84,231,0.364,252,537,0.469,127,169,0.751,91,132,223,153,73,11,86,174,883
1458,3,2003,25,1,3,82,80,2949,421,1073,0.392,116,344,0.337,305,729,0.418,195,247,0.789,97,266,363,188,88,32,128,232,1153
1458,4,2004,26,1,3,82,29,2148,238,587,0.405,126,340,0.371,112,247,0.453,76,94,0.809,35,226,261,113,88,14,69,206,678
1458,5,2005,27,1,2,82,61,2510,356,848,0.42,129,335,0.385,227,513,0.442,188,226,0.832,71,269,340,169,91,18,93,219,1029
1458,6,2006,28,1,2,82,77,3140,478,1096,0.436,177,448,0.395,301,648,0.465,241,294,0.82,65,316,381,190,104,15,126,223,1374
1458,7,2007,29,1,3,71,12,1515,222,517,0.429,106,295,0.359,116,222,0.523,84,123,0.683,32,205,237,47,45,12,53,126,634
1458,8,2008,30,1,2,76,76,1796,215,516,0.417,113,287,0.394,102,229,0.445,65,85,0.765,36,170,206,67,47,7,41,125,608
1458,9,2009,31,1,2,43,9,515,73,183,0.399,33,85,0.388,40,98,0.408,12,19,0.632,13,71,84,16,15,2,15,51,191
1458,10,2010,32,1,2,46,39,973,116,301,0.385,62,171,0.363,54,130,0.415,33,54,0.611,17,109,126,41,25,5,27,81,327
1460,1,1990,25,1,2,77,0,967,207,427,0.485,34,74,0.459,173,353,0.49,135,160,0.844,50,61,111,116,23,2,96,134,583
1460,2,1991,26,1,2,18,0,133,32,71,0.451,1,6,0.167,31,65,0.477,15,22,0.682,10,8,18,20,6,0,12,21,80
1460,2,1991,26,1,2,43,0,882,211,422,0.5,22,59,0.373,189,363,0.521,99,115,0.861,41,51,92,66,37,1,69,111,543
1460,2,1991,26,1,2,61,0,1015,243,493,0.493,23,65,0.354,220,428,0.514,114,137,0.832,51,59,110,86,43,1,81,132,623
1460,3,1992,27,1,2,82,82,3027,668,1315,0.508,123,277,0.444,545,1038,0.525,232,287,0.808,97,161,258,252,105,11,215,248,1691
1460,4,1993,28,1,2,70,67,2660,587,1134,0.518,75,167,0.449,512,967,0.529,315,362,0.87,42,148,190,247,94,13,204,237,1564
1467,1,1980,23,1,2,28,-1,541,126,260,0.485,2,4,0.5,124,256,0.484,73,83,0.88,26,44,70,32,15,4,49,52,327
1467,1,1980,23,1,2,50,-1,971,224,473,0.474,2,5,0.4,222,468,0.474,104,120,0.867,49,66,115,70,19,3,70,106,554
1467,1,1980,23,1,2,78,-1,1512,350,733,0.477,4,9,0.444,346,724,0.478,177,203,0.872,75,110,185,102,34,7,119,158,881
1467,2,1981,24,1,2,82,-1,2269,474,965,0.491,8,28,0.286,466,937,0.497,224,267,0.839,90,156,246,184,65,15,165,262,1180
1467,3,1982,25,1,2,27,8,566,104,214,0.486,4,13,0.308,100,201,0.498,36,45,0.8,28,43,71,53,16,2,33,61,248
1467,3,1982,25,1,2,54,1,617,129,293,0.44,1,18,0.056,128,275,0.465,49,64,0.766,33,50,83,61,20,6,33,91,308
1467,3,1982,25,1,2,81,9,1183,233,507,0.46,5,31,0.161,228,476,0.479,85,109,0.78,61,93,154,114,36,8,66,152,556
1467,4,1983,26,1,2,62,4,599,120,267,0.449,3,14,0.214,117,253,0.462,43,56,0.768,39,45,84,60,30,8,49,92,286
1468,1,1986,24,1,2,70,18,880,117,286,0.409,1,12,0.083,116,274,0.423,44,74,0.595,29,60,89,71,45,1,62,86,279
1468,2,1987,25,1,2,60,6,469,75,176,0.426,1,10,0.1,74,166,0.446,31,44,0.705,16,34,50,64,21,2,32,60,182
1470,1,1983,21,1,3,48,0,416,56,138,0.406,0,2,0,56,136,0.412,40,59,0.678,27,50,77,29,14,8,50,58,152
1473,1,1993,23,1,2,31,0,139,38,82,0.463,2,5,0.4,36,77,0.468,15,25,0.6,6,11,17,10,10,2,18,19,93
1473,2,1994,24,1,2,72,53,1531,242,514,0.471,1,12,0.083,241,502,0.48,113,157,0.72,71,141,212,133,67,12,63,135,598
1473,3,1995,25,1,2,80,79,2500,338,816,0.414,19,55,0.345,319,761,0.419,183,235,0.779,90,175,265,180,115,25,113,206,878
1473,4,1996,26,1,2,72,69,2530,386,826,0.467,93,211,0.441,293,615,0.476,186,240,0.775,62,199,261,271,102,27,126,192,1051
1473,5,1997,27,1,2,69,65,2375,328,766,0.428,85,216,0.394,243,550,0.442,125,174,0.718,63,182,245,233,113,21,135,174,866
1473,6,1998,28,1,2,62,61,1887,246,552,0.446,44,114,0.386,202,438,0.461,106,140,0.757,59,157,216,187,81,18,108,181,642
1473,7,1999,29,1,2,43,43,1574,215,497,0.433,68,172,0.395,147,325,0.452,115,168,0.685,39,135,174,149,60,25,92,124,613
1473,8,2000,30,1,2,28,9,825,152,335,0.454,30,91,0.33,122,244,0.5,47,65,0.723,17,54,71,79,41,8,48,72,381
1474,1,1995,24,1,2,81,11,1208,201,456,0.441,74,198,0.374,127,258,0.492,90,115,0.783,63,70,133,77,37,15,63,150,566
1474,2,1996,25,1,2,65,1,784,98,242,0.405,38,114,0.333,60,128,0.469,67,82,0.817,40,63,103,48,24,10,45,83,301
1474,3,1997,26,1,2,65,0,747,134,298,0.45,51,120,0.425,83,178,0.466,69,84,0.821,49,56,105,52,33,10,46,85,388
1474,4,1998,27,1,2,67,35,1740,257,568,0.452,106,259,0.409,151,309,0.489,140,170,0.824,70,166,236,85,51,12,80,137,760
1474,5,1999,28,1,2,49,38,1242,180,417,0.432,65,165,0.394,115,252,0.456,88,102,0.863,39,101,140,53,44,6,53,86,513
1474,6,2000,29,1,3,75,23,1712,238,573,0.415,93,243,0.383,145,330,0.439,85,100,0.85,74,148,222,81,44,13,57,140,654
1474,7,2001,30,1,2,81,40,2144,291,672,0.433,120,297,0.404,171,375,0.456,158,181,0.873,54,187,241,96,46,19,76,123,860
1474,8,2002,31,1,2,71,64,1718,207,471,0.439,111,238,0.466,96,233,0.412,101,113,0.894,43,141,184,112,41,12,64,110,626
1474,9,2003,32,1,2,62,26,1360,210,446,0.471,80,201,0.398,130,245,0.531,101,122,0.828,44,112,156,70,33,9,56,92,601
1474,10,2004,33,1,3,49,0,703,72,191,0.377,43,122,0.352,29,69,0.42,14,16,0.875,10,63,73,26,16,5,29,42,201
1474,11,2005,34,1,2,68,11,841,111,258,0.43,57,134,0.425,54,124,0.435,45,56,0.804,15,64,79,51,29,1,37,67,324
1474,12,2006,35,1,2,29,1,228,24,61,0.393,9,33,0.273,15,28,0.536,2,5,0.4,4,19,23,13,6,1,11,20,59
1474,13,2008,37,1,3,16,0,113,12,33,0.364,11,26,0.423,1,7,0.143,4,4,1,1,11,12,10,0,1,6,11,39
1475,1,1983,23,1,2,39,1,265,33,88,0.375,1,7,0.143,32,81,0.395,18,32,0.563,15,20,35,14,8,4,18,42,85
1475,2,1984,24,1,2,69,35,1280,268,570,0.47,0,9,0,268,561,0.478,149,173,0.861,59,76,135,60,27,13,81,143,685
1475,3,1985,25,1,2,44,3,882,165,307,0.537,1,4,0.25,164,303,0.541,102,124,0.823,49,68,117,94,34,5,63,117,433
1475,4,1986,26,1,2,81,8,2147,429,798,0.538,3,23,0.13,426,775,0.55,266,310,0.858,94,137,231,177,83,6,107,252,1127
1475,5,1987,27,1,2,79,31,2505,575,1077,0.534,3,28,0.107,572,1049,0.545,387,440,0.88,117,149,266,144,64,24,120,222,1540
1475,6,1988,28,1,2,37,0,965,248,486,0.51,3,14,0.214,245,472,0.519,107,122,0.877,30,53,83,73,21,7,57,94,606
1475,7,1989,29,1,2,75,4,2078,527,1018,0.518,8,36,0.222,519,982,0.529,255,297,0.859,82,115,197,156,77,19,112,193,1317
1475,8,1990,30,1,2,59,0,1709,503,987,0.51,46,133,0.346,457,854,0.535,307,366,0.839,64,103,167,133,50,7,129,158,1359
1475,9,1991,31,1,2,32,2,840,202,436,0.463,9,23,0.391,193,413,0.467,148,160,0.925,30,44,74,72,22,2,54,80,561
1475,9,1991,31,1,2,46,0,1327,359,720,0.499,37,93,0.398,322,627,0.514,282,311,0.907,37,80,117,96,38,11,93,90,1037
1475,9,1991,31,1,2,78,2,2167,561,1156,0.485,46,116,0.397,515,1040,0.495,430,471,0.913,67,124,191,168,60,13,147,170,1598
1475,10,1992,32,1,2,78,78,2658,620,1306,0.475,33,123,0.268,587,1183,0.496,417,455,0.916,93,140,233,241,86,20,189,213,1690
1475,11,1993,33,1,2,77,72,2218,524,1071,0.489,42,113,0.372,482,958,0.503,313,352,0.889,58,134,192,220,100,7,160,167,1403
1475,12,1994,34,1,2,51,0,1022,272,577,0.471,6,32,0.188,266,545,0.488,189,211,0.896,29,54,83,91,42,5,64,84,739
1475,13,1995,35,1,1,27,6,673,111,254,0.437,23,70,0.329,88,184,0.478,93,106,0.877,12,52,64,40,22,2,24,38,338
1475,14,1996,36,1,2,76,2,1404,264,590,0.447,35,104,0.337,229,486,0.471,174,205,0.849,40,96,136,101,57,6,93,188,737
1475,15,1997,37,1,2,33,10,600,120,260,0.462,12,39,0.308,108,221,0.489,83,92,0.902,17,36,53,31,14,5,38,49,335
1475,15,1997,37,1,2,27,17,650,119,237,0.502,30,56,0.536,89,181,0.492,56,63,0.889,19,49,68,49,14,4,30,48,324
1475,15,1997,37,1,2,60,27,1250,239,497,0.481,42,95,0.442,197,402,0.49,139,155,0.897,36,85,121,80,28,9,68,97,659
1475,16,1998,38,1,2,39,0,442,52,143,0.364,4,13,0.308,48,130,0.369,43,52,0.827,19,26,45,34,9,0,21,35,151
1476,1,1980,23,1,1,50,-1,577,91,179,0.508,9,36,0.25,82,143,0.573,37,46,0.804,26,19,45,94,25,4,51,52,228
1476,2,1981,24,1,2,36,-1,431,55,133,0.414,19,48,0.396,36,85,0.424,11,14,0.786,13,28,41,75,15,2,17,26,140
1476,2,1981,24,1,2,42,-1,461,57,138,0.413,19,48,0.396,38,90,0.422,11,14,0.786,13,29,42,77,15,2,22,28,144
1478,1,1986,22,1,3,80,24,1602,255,457,0.558,0,2,0,255,455,0.56,171,254,0.673,95,213,308,90,71,37,148,190,681
1478,2,1987,23,1,3,80,65,2250,290,497,0.584,0,2,0,290,495,0.586,257,348,0.739,179,401,580,116,86,54,135,196,837
1478,3,1988,24,1,4,79,7,1177,179,343,0.522,0,2,0,179,341,0.525,133,178,0.747,94,136,230,66,39,32,77,118,491
1478,4,1989,25,1,4,29,9,678,95,176,0.54,0,0,-1,95,176,0.54,103,129,0.798,60,88,148,44,29,23,38,77,293
1478,4,1989,25,1,4,51,24,1334,224,446,0.502,0,6,0,224,440,0.509,177,221,0.801,106,195,301,74,54,43,81,125,625
1478,4,1989,25,1,4,80,33,2012,319,622,0.513,0,6,0,319,616,0.518,280,350,0.8,166,283,449,118,83,66,119,202,918
1478,5,1990,26,1,4,77,50,1082,135,249,0.542,0,1,0,135,248,0.544,92,119,0.773,93,132,225,68,34,42,56,126,362
1478,6,1991,27,1,4,70,16,1165,131,243,0.539,0,1,0,131,242,0.541,104,116,0.897,155,186,341,45,61,43,45,147,366
1478,7,1992,28,1,4,81,36,1917,203,378,0.537,0,1,0,203,377,0.538,207,255,0.812,252,312,564,62,70,56,73,158,613
1478,8,1993,29,1,4,7,5,151,10,24,0.417,0,0,-1,10,24,0.417,12,13,0.923,14,29,43,1,4,7,8,13,32
1478,9,1994,30,1,4,76,35,1524,151,289,0.522,0,0,-1,151,289,0.522,92,125,0.736,160,318,478,62,58,44,62,131,394
1478,10,1995,31,1,4,62,17,835,48,97,0.495,0,0,-1,48,97,0.495,44,62,0.71,65,146,211,21,34,17,26,64,140
1478,11,1996,32,1,4,27,23,679,54,102,0.529,0,0,-1,54,102,0.529,42,55,0.764,74,102,176,22,33,11,23,55,150
1478,11,1996,32,1,4,47,24,1031,117,233,0.502,0,3,0,117,230,0.509,94,124,0.758,115,167,282,50,31,17,54,101,328
1478,11,1996,32,1,4,74,47,1710,171,335,0.51,0,3,0,171,332,0.515,136,179,0.76,189,269,458,72,64,28,77,156,478
1478,12,1997,33,1,4,27,0,273,23,43,0.535,0,0,-1,23,43,0.535,20,25,0.8,25,40,65,6,8,9,19,30,66
1479,1,2007,23,1,4,6,0,100,12,27,0.444,1,2,0.5,11,25,0.44,6,9,0.667,7,8,15,5,3,3,4,12,31
1482,1,2004,21,1,2,49,1,473,53,129,0.411,9,32,0.281,44,97,0.454,38,60,0.633,14,41,55,68,13,3,36,70,153
1482,2,2005,22,1,1,43,8,515,78,174,0.448,15,40,0.375,63,134,0.47,46,66,0.697,19,50,69,44,25,0,41,76,217
1482,3,2006,23,1,1,56,1,596,66,183,0.361,13,56,0.232,53,127,0.417,46,66,0.697,14,60,74,53,20,4,43,91,191
1484,1,1983,24,1,4,28,0,170,19,40,0.475,0,1,0,19,39,0.487,25,37,0.676,13,18,31,7,2,7,22,41,63
1484,2,1984,25,1,4,69,8,989,126,209,0.603,0,2,0,126,207,0.609,69,101,0.683,76,138,214,70,16,22,81,129,321
1484,3,1985,26,1,3,68,3,1001,107,227,0.471,0,2,0,107,225,0.476,109,146,0.747,90,137,227,69,20,21,100,144,323
1484,4,1986,27,1,4,69,17,1132,127,218,0.583,0,0,-1,127,218,0.583,99,141,0.702,99,147,246,58,37,23,107,140,353
1487,1,1988,22,1,3,79,0,1650,261,564,0.463,4,23,0.174,257,541,0.475,99,172,0.576,115,183,298,169,91,52,131,214,625
1487,2,1989,23,1,3,73,56,2413,413,867,0.476,21,77,0.273,392,790,0.496,201,301,0.668,138,307,445,256,139,61,199,261,1048
1487,3,1990,24,1,3,82,82,3148,562,1150,0.489,28,112,0.25,534,1038,0.514,199,295,0.675,150,397,547,444,211,101,278,298,1351
1487,4,1991,25,1,3,82,82,3014,600,1153,0.52,21,68,0.309,579,1085,0.534,240,340,0.706,163,432,595,511,193,93,232,270,1461
1487,5,1992,26,1,3,82,82,3164,687,1359,0.506,16,80,0.2,671,1279,0.525,330,434,0.76,185,445,630,572,155,93,253,242,1720
1487,6,1993,27,1,3,81,81,3123,628,1327,0.473,22,93,0.237,606,1234,0.491,232,350,0.663,203,418,621,507,173,73,246,219,1510
1487,7,1994,28,1,3,72,72,2759,627,1278,0.491,63,197,0.32,564,1081,0.522,270,409,0.66,173,456,629,403,211,58,232,227,1587
1487,8,1995,29,1,3,79,79,3014,634,1320,0.48,109,316,0.345,525,1004,0.523,315,440,0.716,175,464,639,409,232,89,271,238,1692
1487,9,1996,30,1,3,77,77,2825,563,1216,0.463,150,401,0.374,413,815,0.507,220,324,0.679,152,344,496,452,133,57,207,198,1496
1487,10,1997,31,1,3,82,82,3095,648,1366,0.474,156,424,0.368,492,942,0.522,204,291,0.701,160,371,531,467,154,45,214,213,1656
1487,11,1998,32,1,3,44,44,1652,315,704,0.447,61,192,0.318,254,512,0.496,150,193,0.777,53,174,227,254,79,43,109,116,841
1487,12,1999,33,1,3,50,50,2011,261,604,0.432,72,212,0.34,189,392,0.482,132,183,0.721,63,260,323,293,98,37,159,118,726
1487,13,2000,34,1,3,82,82,2749,388,860,0.451,86,263,0.327,302,597,0.506,160,223,0.717,114,399,513,406,117,41,208,208,1022
1487,14,2001,35,1,3,64,60,2133,269,596,0.451,64,186,0.344,205,410,0.5,119,161,0.739,70,263,333,294,94,35,154,158,721
1487,15,2002,36,1,3,62,60,1996,246,599,0.411,54,177,0.305,192,422,0.455,113,146,0.774,77,244,321,363,101,35,171,162,659
1487,16,2003,37,1,3,64,58,1911,265,597,0.444,38,133,0.286,227,464,0.489,121,148,0.818,57,221,278,285,105,25,164,149,689
1487,17,2004,38,1,3,23,6,412,53,140,0.379,13,48,0.271,40,92,0.435,17,27,0.63,20,48,68,50,21,9,29,38,136
1489,1,1998,22,1,5,33,0,317,35,70,0.5,0,0,-1,35,70,0.5,19,23,0.826,34,40,74,9,8,10,12,48,89
1489,2,1999,23,1,5,16,5,259,33,61,0.541,0,0,-1,33,61,0.541,16,23,0.696,38,44,82,4,8,18,5,41,82
1489,3,2000,24,1,5,76,5,1336,149,283,0.527,0,0,-1,149,283,0.527,114,159,0.717,168,236,404,43,55,59,50,213,412
1489,4,2001,25,1,5,77,8,1658,185,395,0.468,0,2,0,185,393,0.471,128,171,0.749,173,292,465,47,48,97,66,206,498
1489,5,2002,26,1,5,80,29,1881,197,358,0.55,0,0,-1,197,358,0.55,115,166,0.693,188,377,565,53,70,76,68,202,509
1489,6,2003,27,1,5,23,0,325,40,87,0.46,0,0,-1,40,87,0.46,23,38,0.605,46,60,106,6,13,15,15,50,103
1489,7,2004,28,1,5,61,3,678,47,114,0.412,0,0,-1,47,114,0.412,12,21,0.571,67,97,164,10,23,26,22,110,106
1489,8,2005,29,1,5,49,17,865,79,167,0.473,0,0,-1,79,167,0.473,33,49,0.673,85,120,205,18,30,24,31,123,191
1489,9,2006,30,1,5,45,32,771,70,154,0.455,0,0,-1,70,154,0.455,29,38,0.763,73,145,218,24,37,20,26,115,169
1489,10,2007,31,1,5,24,0,109,11,26,0.423,0,0,-1,11,26,0.423,2,4,0.5,15,16,31,3,4,1,4,27,24
1489,11,2008,32,1,5,22,0,173,12,23,0.522,0,0,-1,12,23,0.522,15,22,0.682,14,23,37,3,3,6,5,43,39
1492,1,1985,22,1,3,22,0,129,17,53,0.321,0,1,0,17,52,0.327,7,13,0.538,9,9,18,5,3,3,7,30,41
1493,1,1980,24,1,5,82,-1,2349,296,566,0.523,0,2,0,296,564,0.525,139,167,0.832,124,436,560,131,45,162,103,283,731
1493,2,1981,25,1,4,82,-1,2808,324,614,0.528,3,6,0.5,321,608,0.528,126,162,0.778,160,469,629,161,67,174,122,342,777
1493,3,1982,26,1,4,82,56,1698,220,428,0.514,3,10,0.3,217,418,0.519,97,120,0.808,117,294,411,94,51,65,69,235,540
1493,4,1983,27,1,4,75,50,2331,329,697,0.472,1,5,0.2,328,692,0.474,166,221,0.751,155,366,521,168,64,116,100,264,825
1493,5,1984,28,1,4,51,4,858,75,171,0.439,1,5,0.2,74,166,0.446,34,43,0.791,57,125,182,49,20,33,28,114,185
1493,6,1985,29,1,4,79,6,1656,210,457,0.46,3,17,0.176,207,440,0.47,109,137,0.796,148,325,473,79,47,58,70,220,532
1493,7,1986,30,1,4,81,3,1496,166,348,0.477,2,10,0.2,164,338,0.485,72,100,0.72,121,252,373,78,33,32,68,187,406
1493,8,1987,31,1,4,21,1,167,21,40,0.525,0,1,0,21,39,0.538,9,11,0.818,10,14,24,7,3,12,4,26,51
1493,8,1987,31,1,4,37,1,437,41,82,0.5,0,3,0,41,79,0.519,31,39,0.795,20,57,77,28,6,22,17,51,113
1493,8,1987,31,1,4,58,2,604,62,122,0.508,0,4,0,62,118,0.525,40,50,0.8,30,71,101,35,9,34,21,77,164
1494,1,2001,22,1,3,51,35,1147,173,445,0.389,0,5,0,173,440,0.393,94,141,0.667,89,100,189,61,45,6,59,111,440
1496,1,1986,22,1,1,79,3,1214,212,447,0.474,13,42,0.31,199,405,0.491,125,155,0.806,35,82,117,198,81,1,106,136,562
1496,2,1987,23,1,1,80,80,2714,376,770,0.488,13,60,0.217,363,710,0.511,280,334,0.838,70,267,337,715,159,9,255,192,1045
1496,3,1988,24,1,1,82,82,2991,462,890,0.519,24,69,0.348,438,821,0.533,274,324,0.846,65,313,378,831,150,16,244,204,1222
1496,4,1989,25,1,1,81,81,3102,540,1146,0.471,79,219,0.361,461,927,0.497,272,324,0.84,85,282,367,770,146,8,248,187,1431
1496,5,1990,26,1,1,80,80,2781,448,969,0.462,89,238,0.374,359,731,0.491,421,472,0.892,59,213,272,726,151,4,245,150,1406
1496,6,1991,27,1,1,81,81,2665,486,944,0.515,130,313,0.415,356,631,0.564,279,339,0.823,52,230,282,649,158,12,189,151,1381
1496,7,1992,28,1,1,82,82,2784,521,1129,0.461,128,324,0.395,393,805,0.488,315,368,0.856,51,204,255,477,127,12,188,155,1485
1496,8,1993,29,1,1,81,81,2883,503,1108,0.454,143,345,0.414,360,763,0.472,327,388,0.843,58,258,316,419,101,10,199,122,1476
1496,9,1994,30,1,1,77,34,2074,348,836,0.416,110,282,0.39,238,554,0.43,204,234,0.872,45,170,215,401,79,18,166,132,1010
1496,10,1995,31,1,1,35,9,770,105,267,0.393,44,114,0.386,61,153,0.399,58,82,0.707,18,63,81,133,30,2,58,60,312
1496,11,1996,32,1,1,82,40,2072,269,608,0.442,71,226,0.314,198,382,0.518,164,209,0.785,36,176,212,452,89,15,173,154,773
1496,12,1997,33,1,1,82,20,1568,187,449,0.416,67,200,0.335,120,249,0.482,127,166,0.765,31,145,176,295,54,11,128,104,568
1496,13,1998,34,1,1,82,8,1786,259,577,0.449,92,233,0.395,167,344,0.485,167,195,0.856,37,131,168,271,63,16,104,103,777
1496,14,1999,35,1,1,50,1,1365,172,370,0.465,58,141,0.411,114,229,0.498,123,148,0.831,13,127,140,146,48,11,74,97,525
1496,15,2000,36,1,1,68,8,1613,207,463,0.447,90,207,0.435,117,256,0.457,137,170,0.806,24,167,191,221,50,9,100,79,641
1496,16,2001,37,1,1,80,42,1678,197,440,0.448,87,205,0.424,110,235,0.468,92,116,0.793,24,177,201,251,52,11,104,88,573
1496,17,2002,38,1,1,72,0,1294,136,321,0.424,59,142,0.415,77,179,0.43,68,83,0.819,12,152,164,205,45,16,85,89,399
1498,1,2000,23,1,3,81,77,2052,230,536,0.429,82,220,0.373,148,316,0.468,120,150,0.8,85,232,317,146,98,33,95,207,662
1498,2,2001,24,1,3,82,82,2255,243,590,0.412,65,217,0.3,178,373,0.477,115,141,0.816,125,306,431,163,93,40,102,226,666
1498,3,2002,25,1,3,73,63,2238,277,736,0.376,67,237,0.283,210,499,0.421,161,203,0.793,109,320,429,180,114,39,127,224,782
1498,4,2003,26,1,3,25,24,872,121,324,0.373,24,88,0.273,97,236,0.411,86,102,0.843,38,107,145,78,29,6,66,63,352
1498,4,2003,26,1,3,58,47,1646,188,428,0.439,46,141,0.326,142,287,0.495,119,144,0.826,52,229,281,106,77,9,78,134,541
1498,4,2003,26,1,3,83,71,2518,309,752,0.411,70,229,0.306,239,523,0.457,205,246,0.833,90,336,426,184,106,15,144,197,893
1498,5,2004,27,1,2,82,82,2451,368,770,0.478,112,290,0.386,256,480,0.533,278,335,0.83,92,311,403,122,137,40,112,248,1126
1498,6,2005,28,1,3,50,18,1382,127,356,0.357,55,178,0.309,72,178,0.404,96,111,0.865,45,174,219,88,48,23,69,134,405
1498,7,2006,29,1,3,67,63,1914,159,395,0.403,117,290,0.403,42,105,0.4,48,61,0.787,33,286,319,89,54,20,58,196,483
1498,8,2007,30,1,3,71,19,1919,186,432,0.431,97,259,0.375,89,173,0.514,81,98,0.827,66,291,357,94,71,23,55,193,550
1498,9,2008,31,1,4,74,2,1821,173,414,0.418,106,279,0.38,67,135,0.496,93,115,0.809,30,292,322,114,72,19,65,182,545
1498,10,2009,32,1,2,75,0,2140,216,524,0.412,116,314,0.369,100,210,0.476,120,146,0.822,38,324,362,82,58,21,79,216,668
1498,11,2010,33,1,3,77,2,1731,126,345,0.365,81,242,0.335,45,103,0.437,66,80,0.825,32,297,329,117,42,19,51,204,399
1498,12,2011,34,1,3,49,0,839,81,241,0.336,67,212,0.316,14,29,0.483,11,15,0.733,10,137,147,34,24,6,24,103,240
1499,1,1997,21,1,5,80,3,1238,186,423,0.44,1,2,0.5,185,421,0.439,92,125,0.736,105,112,217,40,26,34,109,216,465
1499,2,1998,22,1,5,80,0,1412,234,488,0.48,0,1,0,234,487,0.48,102,144,0.708,110,203,313,57,27,28,132,198,570
1499,3,1999,23,1,5,17,12,467,55,126,0.437,0,1,0,55,125,0.44,33,49,0.673,23,71,94,16,11,16,28,53,143
1499,3,1999,23,1,5,33,32,927,149,286,0.521,0,0,-1,149,286,0.521,58,106,0.547,91,147,238,59,24,20,72,116,356
1499,3,1999,23,1,5,50,44,1394,204,412,0.495,0,1,0,204,411,0.496,91,155,0.587,114,218,332,75,35,36,100,169,499
1499,4,2000,24,1,5,79,72,1797,307,615,0.499,0,1,0,307,614,0.5,109,160,0.681,182,317,499,77,41,29,145,239,723
1499,5,2001,25,1,5,82,7,1901,248,521,0.476,0,0,-1,248,521,0.476,115,158,0.728,206,289,495,64,52,23,105,228,611
1499,6,2002,26,1,5,79,9,1343,137,301,0.455,0,0,-1,137,301,0.455,89,120,0.742,167,180,347,30,37,18,63,174,363
1499,7,2003,27,1,5,26,2,403,41,93,0.441,0,0,-1,41,93,0.441,22,29,0.759,25,64,89,4,9,8,25,46,104
1499,8,2004,28,1,5,65,39,1419,200,409,0.489,0,0,-1,200,409,0.489,59,92,0.641,101,188,289,53,22,28,77,161,459
1499,9,2005,29,1,5,33,1,335,45,87,0.517,0,1,0,45,86,0.523,27,31,0.871,30,48,78,9,7,3,12,53,117
1499,10,2006,30,1,5,24,12,321,32,64,0.5,0,0,-1,32,64,0.5,10,17,0.588,26,36,62,7,2,2,14,44,74
1499,10,2006,30,1,5,33,12,353,37,71,0.521,0,0,-1,37,71,0.521,10,17,0.588,27,37,64,9,2,2,16,50,84
1500,1,2001,22,1,2,26,0,169,17,54,0.315,3,11,0.273,14,43,0.326,22,27,0.815,8,17,25,5,4,2,17,12,59
1500,2,2002,23,1,2,23,0,179,28,84,0.333,6,26,0.231,22,58,0.379,31,41,0.756,2,14,16,5,6,0,11,7,93
1501,1,2007,23,1,5,63,2,720,79,177,0.446,0,2,0,79,175,0.451,106,144,0.736,97,118,215,10,14,22,47,104,264
1501,2,2008,24,1,5,56,5,809,154,269,0.572,0,1,0,154,268,0.575,137,193,0.71,95,132,227,15,15,16,43,127,445
1501,3,2009,25,1,4,70,7,1227,177,338,0.524,0,0,-1,177,338,0.524,184,267,0.689,145,200,345,46,24,38,76,192,538
1501,4,2010,26,1,3,20,2,236,21,49,0.429,0,0,-1,21,49,0.429,37,63,0.587,19,42,61,0,6,2,11,36,79
1501,5,2011,27,1,5,16,0,141,30,60,0.5,0,2,0,30,58,0.517,28,46,0.609,8,17,25,5,3,1,7,24,88
1501,5,2011,27,1,4,14,3,187,29,59,0.492,0,0,-1,29,59,0.492,12,26,0.462,16,22,38,2,7,3,5,20,70
1501,5,2011,27,1,5,30,3,328,59,119,0.496,0,2,0,59,117,0.504,40,72,0.556,24,39,63,7,10,4,12,44,158
1505,1,2008,26,1,3,11,4,304,35,95,0.368,8,33,0.242,27,62,0.435,6,9,0.667,8,36,44,18,9,2,5,18,84
1509,1,1983,24,1,2,79,18,1528,213,466,0.457,1,9,0.111,212,457,0.464,105,176,0.597,83,198,281,207,99,47,162,174,532
1509,2,1984,25,1,2,81,18,1730,276,528,0.523,2,9,0.222,274,519,0.528,120,200,0.6,102,180,282,252,86,50,157,241,674
1509,3,1985,26,1,3,80,80,2876,480,928,0.517,7,20,0.35,473,908,0.521,317,418,0.758,149,280,429,543,129,56,247,258,1284
1509,4,1986,27,1,3,80,80,2704,411,843,0.488,8,44,0.182,403,799,0.504,316,392,0.806,127,272,399,623,168,71,240,247,1146
1509,5,1987,28,1,3,61,60,2057,294,616,0.477,16,55,0.291,278,561,0.496,242,328,0.738,98,198,296,441,110,47,186,213,846
1509,6,1988,29,1,2,75,75,2484,345,702,0.491,8,39,0.205,337,663,0.508,285,357,0.798,130,245,375,523,112,34,198,233,983
1509,7,1989,30,1,2,67,62,2170,307,648,0.474,12,55,0.218,295,593,0.497,187,241,0.776,73,189,262,439,119,44,184,221,813
1509,8,1990,31,1,2,57,2,1400,239,506,0.472,6,43,0.14,233,463,0.503,144,190,0.758,59,113,172,244,71,23,109,149,628
1509,9,1991,32,1,2,70,18,1683,201,426,0.472,16,57,0.281,185,369,0.501,110,133,0.827,50,126,176,271,63,32,130,174,528
1509,10,1992,33,1,2,56,7,759,60,161,0.373,3,21,0.143,57,140,0.407,28,41,0.683,22,73,95,142,29,19,64,86,151
1509,11,1993,34,1,2,18,0,268,29,66,0.439,0,4,0,29,62,0.468,21,27,0.778,8,23,31,30,11,5,23,36,79
1510,1,1989,24,1,1,10,0,107,8,25,0.32,0,0,-1,8,25,0.32,5,9,0.556,3,11,14,22,4,0,11,9,21
1510,1,1989,24,1,1,13,0,124,9,31,0.29,0,2,0,9,29,0.31,5,9,0.556,3,12,15,26,4,0,11,11,23
1511,1,1987,23,1,3,67,23,913,134,317,0.423,7,28,0.25,127,289,0.439,35,48,0.729,68,108,176,120,40,21,63,96,310
1511,2,1988,24,1,3,80,49,2029,318,702,0.453,36,110,0.327,282,592,0.476,103,130,0.792,139,230,369,185,84,55,135,211,775
1511,3,1989,25,1,4,80,36,2257,383,873,0.439,119,295,0.403,264,578,0.457,96,123,0.78,216,269,485,174,93,76,124,215,981
1511,4,1990,26,1,3,72,10,1603,240,566,0.424,46,148,0.311,194,418,0.464,110,141,0.78,94,215,309,149,58,36,88,148,636
1517,1,1987,22,1,1,67,0,1217,173,424,0.408,23,70,0.329,150,354,0.424,95,114,0.833,33,84,117,202,43,4,105,75,464
1517,2,1988,23,1,1,80,79,2626,493,974,0.506,72,148,0.486,421,826,0.51,221,252,0.877,54,126,180,480,99,12,184,119,1279
1517,3,1989,24,1,1,75,74,2728,529,1006,0.526,93,211,0.441,436,795,0.548,263,292,0.901,48,178,226,631,115,7,212,98,1414
1517,4,1990,25,1,1,73,73,2706,489,1066,0.459,152,374,0.406,337,692,0.487,300,338,0.888,66,185,251,666,114,5,214,89,1430
1517,5,1991,26,1,1,16,16,571,97,195,0.497,18,53,0.34,79,142,0.556,59,62,0.952,8,37,45,166,42,2,56,23,271
1517,6,1992,27,1,1,72,72,2138,438,897,0.488,101,261,0.387,337,636,0.53,270,285,0.947,38,135,173,535,94,12,159,113,1247
1517,7,1993,28,1,1,75,74,2380,477,986,0.484,122,293,0.416,355,693,0.512,289,305,0.948,37,164,201,602,89,11,196,105,1365
1517,8,1994,29,1,1,76,73,2386,480,1005,0.478,118,297,0.397,362,708,0.511,238,268,0.888,39,189,228,589,103,11,189,93,1316
1517,9,1995,30,1,1,48,34,1375,253,612,0.413,103,253,0.407,150,359,0.418,148,162,0.914,25,87,112,335,35,4,142,50,757
1517,10,1996,31,1,1,7,1,127,18,60,0.3,10,30,0.333,8,30,0.267,10,10,1,1,6,7,18,6,0,10,7,56
1517,11,1997,32,1,1,70,49,1876,263,589,0.447,112,283,0.396,151,306,0.493,155,171,0.906,36,143,179,342,67,3,161,100,793
1517,12,1998,33,1,1,63,33,1430,229,531,0.431,52,155,0.335,177,376,0.471,87,103,0.845,24,105,129,297,53,5,162,92,597
1519,1,2009,22,1,2,47,0,366,31,101,0.307,14,48,0.292,17,53,0.321,17,21,0.81,9,34,43,39,15,3,19,34,93
1525,1,2003,27,1,5,22,8,364,43,96,0.448,0,0,-1,43,96,0.448,34,47,0.723,29,53,82,7,8,32,21,58,120
1525,2,2004,28,1,5,25,1,359,27,68,0.397,0,0,-1,27,68,0.397,44,59,0.746,43,68,111,0,8,24,17,58,98
1525,2,2004,28,1,5,28,1,366,27,69,0.391,0,0,-1,27,69,0.391,44,59,0.746,43,69,112,0,8,25,18,59,98
1526,1,2006,28,1,5,23,1,152,22,53,0.415,0,1,0,22,52,0.423,6,9,0.667,15,22,37,7,2,5,6,23,50
1532,1,2004,23,1,3,45,3,516,47,132,0.356,23,63,0.365,24,69,0.348,21,29,0.724,8,62,70,30,14,14,23,72,138
1532,2,2005,24,1,3,16,2,204,15,43,0.349,10,21,0.476,5,22,0.227,9,12,0.75,4,26,30,9,1,0,5,30,49
1532,2,2005,24,1,4,55,4,1137,146,368,0.397,65,175,0.371,81,193,0.42,88,105,0.838,20,132,152,65,28,16,68,153,445
1532,2,2005,24,1,4,71,6,1341,161,411,0.392,75,196,0.383,86,215,0.4,97,117,0.829,24,158,182,74,29,16,73,183,494
1532,3,2006,25,1,4,25,13,405,42,124,0.339,17,57,0.298,25,67,0.373,25,36,0.694,4,45,49,22,13,5,20,52,126
1532,3,2006,25,1,4,36,13,502,54,156,0.346,19,71,0.268,35,85,0.412,30,44,0.682,8,52,60,27,16,5,24,65,157
1532,4,2007,26,1,3,76,1,1532,226,495,0.457,112,265,0.423,114,230,0.496,132,164,0.805,27,226,253,61,30,26,69,183,696
1532,5,2008,27,1,4,75,1,1660,245,609,0.402,94,262,0.359,151,347,0.435,154,196,0.786,56,204,260,88,44,21,85,182,738
1533,1,2001,25,1,3,42,0,469,66,136,0.485,0,1,0,66,135,0.489,32,43,0.744,29,63,92,24,9,5,27,60,164
1533,2,2002,26,1,3,79,41,1912,369,764,0.483,1,2,0.5,368,762,0.483,112,150,0.747,103,188,291,94,59,17,96,175,851
1533,3,2003,27,1,3,38,0,405,84,190,0.442,0,1,0,84,189,0.444,42,51,0.824,32,38,70,26,6,3,32,46,210
1533,4,2004,28,1,4,27,0,300,63,138,0.457,0,0,-1,63,138,0.457,16,19,0.842,26,37,63,17,10,7,24,48,142
1533,4,2004,28,1,3,22,4,397,73,162,0.451,0,3,0,73,159,0.459,24,30,0.8,30,36,66,17,4,1,21,36,170
1533,4,2004,28,1,4,57,4,780,147,327,0.45,0,3,0,147,324,0.454,47,58,0.81,64,79,143,38,15,8,45,93,341
1533,5,2005,29,1,3,68,51,2017,415,869,0.478,0,2,0,415,867,0.479,133,165,0.806,128,170,298,109,36,16,110,190,963
1533,6,2006,30,1,4,22,0,237,40,80,0.5,0,0,-1,40,80,0.5,13,15,0.867,23,19,42,7,8,4,10,32,93
1534,1,1982,22,1,4,80,0,1186,227,436,0.521,0,1,0,227,435,0.522,75,117,0.641,95,161,256,82,42,71,104,169,529
1534,2,1983,23,1,4,82,82,2914,588,1069,0.55,1,3,0.333,587,1066,0.551,193,287,0.672,239,471,710,197,99,217,190,254,1370
1534,3,1984,24,1,4,82,82,2899,601,1044,0.576,0,7,0,601,1037,0.58,249,352,0.707,227,451,678,214,86,174,177,274,1451
1534,4,1985,25,1,4,61,55,2202,515,877,0.587,1,2,0.5,514,875,0.587,180,254,0.709,195,341,536,159,88,104,136,185,1211
1534,5,1986,26,1,4,73,69,2484,582,1001,0.581,0,8,0,582,993,0.586,310,444,0.698,169,449,618,240,70,130,210,247,1474
1534,6,1987,27,1,4,69,67,2569,585,1062,0.551,1,5,0.2,584,1057,0.553,381,493,0.773,188,411,599,233,86,148,149,223,1552
1534,7,1988,28,1,4,27,26,906,160,304,0.526,0,1,0,160,303,0.528,117,141,0.83,74,139,213,84,18,63,49,90,437
1534,7,1988,28,1,4,40,34,1477,327,616,0.531,2,5,0.4,325,611,0.532,187,249,0.751,119,275,394,123,45,96,106,152,843
1534,7,1988,28,1,4,67,60,2383,487,920,0.529,2,6,0.333,485,914,0.531,304,390,0.779,193,414,607,207,63,159,155,242,1280
1534,8,1989,29,1,4,73,72,2526,496,920,0.539,0,4,0,496,916,0.541,267,334,0.799,156,425,581,159,57,206,117,186,1259
1534,9,1990,30,1,4,62,53,2065,412,807,0.511,1,1,1,411,806,0.51,186,239,0.778,162,354,516,161,54,122,110,185,1011
1534,10,1991,31,1,4,80,78,2927,635,1211,0.524,2,8,0.25,633,1203,0.526,265,330,0.803,201,485,686,237,66,200,131,219,1537
1534,11,1992,32,1,4,81,81,2880,556,1032,0.539,0,6,0,556,1026,0.542,263,320,0.822,213,457,670,232,80,243,87,200,1375
1534,12,1993,33,1,4,77,77,2753,533,971,0.549,0,4,0,533,967,0.551,202,247,0.818,184,484,668,223,54,198,107,223,1268
1534,13,1994,34,1,4,33,19,909,153,314,0.487,0,0,-1,153,314,0.487,64,85,0.753,77,150,227,49,27,55,38,96,370
1535,1,1980,30,1,5,81,-1,2860,443,799,0.554,0,2,0,443,797,0.556,196,273,0.718,352,864,1216,233,45,37,257,259,1082
1535,2,1981,31,1,5,82,-1,2809,517,935,0.553,0,0,-1,517,935,0.553,244,307,0.795,295,722,1017,199,49,46,211,295,1278
1535,3,1982,32,1,5,21,7,575,101,175,0.577,1,1,1,100,174,0.575,59,79,0.747,46,146,192,30,6,9,48,64,262
1535,4,1984,34,1,5,69,0,829,124,253,0.49,0,1,0,124,252,0.492,63,91,0.692,81,183,264,27,25,7,68,150,311
1537,1,2001,24,1,4,40,4,431,58,111,0.523,1,3,0.333,57,108,0.528,14,33,0.424,41,54,95,27,13,8,17,48,131
1537,2,2002,25,1,4,62,11,1357,150,300,0.5,0,2,0,150,298,0.503,100,148,0.676,149,193,342,38,56,30,40,156,400
1537,3,2003,26,1,3,48,12,1103,129,231,0.558,0,1,0,129,230,0.561,62,91,0.681,90,133,223,47,40,22,23,129,320
1537,4,2004,27,1,3,58,7,720,72,162,0.444,2,4,0.5,70,158,0.443,30,46,0.652,67,89,156,25,35,19,29,90,176
1537,5,2005,28,1,4,26,0,575,75,150,0.5,0,6,0,75,144,0.521,29,46,0.63,49,76,125,28,23,14,29,77,179
1537,5,2005,28,1,4,42,4,610,70,172,0.407,6,15,0.4,64,157,0.408,29,45,0.644,53,65,118,37,18,10,32,71,175
1537,5,2005,28,1,4,68,4,1185,145,322,0.45,6,21,0.286,139,301,0.462,58,91,0.637,102,141,243,65,41,24,61,148,354
1537,6,2006,29,1,4,64,3,1449,127,301,0.422,4,12,0.333,123,289,0.426,89,114,0.781,128,197,325,52,53,34,54,165,347
1537,7,2007,30,1,4,75,36,1658,204,354,0.576,1,12,0.083,203,342,0.594,88,123,0.715,131,179,310,64,73,26,56,207,497
1537,8,2008,31,1,4,78,3,1664,174,368,0.473,53,147,0.361,121,221,0.548,63,89,0.708,113,224,337,95,69,40,59,199,464
1537,9,2009,32,1,4,27,0,319,33,74,0.446,5,25,0.2,28,49,0.571,8,22,0.364,17,50,67,19,10,4,18,50,79
1537,10,2010,33,1,4,13,2,204,20,53,0.377,3,17,0.176,17,36,0.472,6,12,0.5,12,26,38,15,9,2,12,33,49
1537,10,2010,33,1,4,33,3,481,42,93,0.452,16,47,0.34,26,46,0.565,8,12,0.667,22,55,77,14,17,12,13,61,108
1537,10,2010,33,1,4,46,5,685,62,146,0.425,19,64,0.297,43,82,0.524,14,24,0.583,34,81,115,29,26,14,25,94,157
1537,11,2011,34,1,4,31,0,372,26,72,0.361,11,34,0.324,15,38,0.395,6,11,0.545,14,30,44,20,11,6,13,52,69
1537,12,2012,35,1,4,22,0,270,24,64,0.375,8,29,0.276,16,35,0.457,2,4,0.5,11,39,50,12,19,4,7,40,58
1538,1,1980,23,1,3,25,-1,811,201,419,0.48,2,4,0.5,199,415,0.48,107,139,0.77,66,112,178,57,24,12,65,57,511
1538,1,1980,23,1,3,53,-1,2046,421,879,0.479,1,5,0.2,420,874,0.481,199,280,0.711,173,340,513,112,78,22,133,148,1042
1538,1,1980,23,1,3,78,-1,2857,622,1298,0.479,3,9,0.333,619,1289,0.48,306,419,0.73,239,452,691,169,102,34,198,205,1553
1538,2,1981,24,1,3,74,-1,2111,395,794,0.497,4,8,0.5,391,786,0.497,200,283,0.707,149,282,431,159,73,18,163,188,994
1538,3,1982,25,1,3,75,71,2599,515,894,0.576,2,8,0.25,513,886,0.579,294,392,0.75,193,420,613,150,62,36,140,175,1326
1538,4,1983,26,1,3,80,80,2879,644,1187,0.543,3,20,0.15,641,1167,0.549,339,428,0.792,214,385,599,171,63,29,203,184,1630
1538,5,1984,27,1,3,79,74,2638,500,857,0.583,2,17,0.118,498,840,0.593,275,345,0.797,166,310,476,179,69,22,166,218,1277
1538,6,1985,28,1,4,78,76,2657,685,1255,0.546,0,3,0,685,1252,0.547,447,564,0.793,209,401,610,238,75,33,190,182,1817
1538,7,1986,29,1,4,69,62,2007,469,930,0.504,2,6,0.333,467,924,0.505,278,347,0.801,125,311,436,164,58,13,130,143,1218
1538,8,1988,31,1,4,27,7,533,102,208,0.49,0,1,0,102,207,0.493,54,73,0.74,35,61,96,47,13,3,30,43,258
1538,9,1989,32,1,3,14,0,168,22,50,0.44,0,1,0,22,49,0.449,22,31,0.71,12,34,46,7,6,1,11,13,66
1538,9,1989,32,1,3,10,0,185,25,66,0.379,0,0,-1,25,66,0.379,35,48,0.729,16,16,32,11,2,2,19,19,85
1538,9,1989,32,1,3,24,0,353,47,116,0.405,0,1,0,47,115,0.409,57,79,0.722,28,50,78,18,8,3,30,32,151
1538,10,1990,33,1,3,14,0,164,20,31,0.645,0,0,-1,20,31,0.645,17,22,0.773,10,25,35,9,1,0,5,14,57
1540,1,2008,27,1,2,82,30,2117,308,766,0.402,156,432,0.361,152,334,0.455,124,146,0.849,34,176,210,177,48,1,134,94,896
1546,1,2009,23,1,1,13,5,171,24,54,0.444,0,3,0,24,51,0.471,5,14,0.357,6,18,24,13,9,2,15,24,53
1549,1,1999,23,1,3,50,36,1288,182,405,0.449,35,96,0.365,147,309,0.476,104,133,0.782,57,118,175,82,77,20,53,143,503
1549,2,2000,24,1,2,73,39,2317,364,915,0.398,94,281,0.335,270,634,0.426,151,191,0.791,82,193,275,121,75,31,102,205,973
1549,3,2001,25,1,2,14,12,333,40,123,0.325,10,46,0.217,30,77,0.39,18,23,0.783,16,26,42,11,10,4,10,28,108
1549,3,2001,25,1,3,48,22,1223,149,407,0.366,39,134,0.291,110,273,0.403,67,83,0.807,35,96,131,65,41,16,55,127,404
1549,3,2001,25,1,3,62,34,1556,189,530,0.357,49,180,0.272,140,350,0.4,85,106,0.802,51,122,173,76,51,20,65,155,512
1549,4,2002,26,1,3,70,9,1498,183,421,0.435,13,47,0.277,170,374,0.455,64,93,0.688,105,213,318,91,61,22,49,164,443
1550,1,1997,24,1,2,10,0,113,16,37,0.432,0,6,0,16,31,0.516,8,10,0.8,3,5,8,17,9,0,8,12,40
1551,1,1988,22,1,5,35,0,295,18,49,0.367,0,0,-1,18,49,0.367,7,14,0.5,20,53,73,16,7,11,21,78,43
1551,1,1988,22,1,5,44,0,336,20,52,0.385,0,0,-1,20,52,0.385,8,18,0.444,23,59,82,16,8,12,23,89,48
1553,1,2000,23,1,5,82,55,1723,206,433,0.476,0,2,0,206,431,0.478,59,103,0.573,135,244,379,93,21,85,71,262,471
1553,2,2001,24,1,5,73,39,1233,147,319,0.461,0,1,0,147,318,0.462,34,65,0.523,99,187,286,45,25,63,55,189,328
1553,3,2002,25,1,5,82,82,2218,324,657,0.493,0,1,0,324,656,0.494,39,71,0.549,200,334,534,75,45,109,94,262,687
1553,4,2003,26,1,5,77,77,2337,400,762,0.525,0,2,0,400,760,0.526,61,95,0.642,146,358,504,114,39,116,99,256,861
1553,5,2004,27,1,5,82,82,2353,328,700,0.469,0,0,-1,328,700,0.469,54,114,0.474,257,376,633,114,51,165,107,247,710
1553,6,2005,28,1,5,70,70,1785,198,430,0.46,0,0,-1,198,430,0.46,14,30,0.467,184,275,459,71,31,117,73,207,410
1553,7,2006,29,1,5,80,51,1515,172,334,0.515,0,2,0,172,332,0.518,18,30,0.6,114,195,309,33,21,88,53,209,362
1553,8,2007,30,1,5,80,73,1676,230,421,0.546,0,1,0,230,420,0.548,34,50,0.68,115,245,360,74,37,84,56,193,494
1553,9,2008,31,1,5,71,39,1486,257,467,0.55,1,3,0.333,256,464,0.552,37,49,0.755,130,212,342,82,20,52,60,132,552
1553,10,2009,32,1,5,70,19,1214,224,437,0.513,0,1,0,224,436,0.514,25,32,0.781,93,147,240,109,30,38,63,171,473
1553,11,2010,33,1,5,42,8,413,81,149,0.544,0,0,-1,81,149,0.544,1,5,0.2,37,52,89,25,10,17,16,54,163
1557,1,1993,25,1,2,33,1,311,42,113,0.372,1,8,0.125,41,105,0.39,34,60,0.567,19,18,37,57,23,1,32,42,119
1558,1,2001,26,1,3,27,6,184,21,55,0.382,4,9,0.444,17,46,0.37,8,16,0.5,13,22,35,6,2,4,7,18,54
1558,2,2002,27,1,3,42,35,1273,131,263,0.498,1,7,0.143,130,256,0.508,75,88,0.852,80,142,222,45,38,20,49,117,338
1558,3,2003,28,1,3,73,45,1931,231,467,0.495,32,84,0.381,199,383,0.52,70,90,0.778,86,185,271,99,50,26,69,174,564
1558,4,2004,29,1,3,64,25,1245,108,276,0.391,2,19,0.105,106,257,0.412,36,46,0.783,65,90,155,72,25,19,54,109,254
1558,5,2005,30,1,2,74,69,1832,182,424,0.429,19,53,0.358,163,371,0.439,55,69,0.797,78,142,220,91,50,18,61,144,438
1558,6,2006,31,1,2,36,3,353,17,57,0.298,3,13,0.231,14,44,0.318,11,16,0.688,21,35,56,9,5,10,12,47,48
1558,7,2007,32,1,3,15,1,129,16,37,0.432,8,15,0.533,8,22,0.364,6,10,0.6,13,17,30,2,6,0,3,17,46
1558,8,2008,33,1,2,41,13,650,71,158,0.449,15,45,0.333,56,113,0.496,20,26,0.769,41,73,114,14,27,7,31,64,177
1558,8,2008,33,1,2,49,13,698,76,174,0.437,16,49,0.327,60,125,0.48,20,26,0.769,47,78,125,18,28,8,34,69,188
1559,1,1980,31,1,2,78,-1,2510,611,1329,0.46,45,152,0.296,566,1177,0.481,367,415,0.884,101,163,264,314,115,4,231,195,1634
1559,2,1981,32,1,2,79,-1,2911,632,1272,0.497,10,30,0.333,622,1242,0.501,414,466,0.888,78,141,219,299,87,9,248,237,1688
1559,3,1982,33,1,2,76,32,1507,286,615,0.465,7,23,0.304,279,592,0.471,126,147,0.857,36,55,91,170,33,3,104,194,705
1560,1,1987,23,1,3,59,0,630,113,275,0.411,1,22,0.045,112,253,0.443,66,76,0.868,36,34,70,27,20,7,46,67,293
1560,2,1988,24,1,3,77,25,1589,270,620,0.435,26,93,0.28,244,527,0.463,207,246,0.841,87,72,159,62,72,11,103,204,773
1560,3,1989,25,1,3,81,80,2336,455,957,0.475,97,287,0.338,358,670,0.534,286,351,0.815,93,113,206,162,111,23,153,259,1293
1560,4,1990,26,1,3,80,69,2277,374,786,0.476,45,142,0.317,329,644,0.511,239,299,0.799,60,131,191,180,95,22,143,254,1032
1560,5,1991,27,1,3,81,81,2477,478,1017,0.47,30,84,0.357,448,933,0.48,385,476,0.809,94,160,254,188,100,17,189,278,1371
1560,6,1992,28,1,3,55,55,1651,295,618,0.477,13,46,0.283,282,572,0.493,236,308,0.766,71,108,179,146,70,14,129,181,839
1560,7,1993,29,1,3,64,27,1471,279,534,0.522,12,45,0.267,267,489,0.546,194,240,0.808,72,71,143,117,45,19,90,154,764
1560,8,1994,30,1,3,18,18,429,91,174,0.523,4,16,0.25,87,158,0.551,48,59,0.814,21,37,58,29,18,5,28,44,234
1560,8,1994,30,1,3,63,0,1268,222,490,0.453,20,74,0.27,202,416,0.486,134,166,0.807,65,57,122,43,51,22,62,152,598
1560,8,1994,30,1,3,81,18,1697,313,664,0.471,24,90,0.267,289,574,0.503,182,225,0.809,86,94,180,72,69,27,90,196,832
1560,9,1995,31,1,3,82,11,1896,226,488,0.463,45,128,0.352,181,360,0.503,137,171,0.801,72,101,173,91,69,13,86,234,634
1560,10,1996,32,1,2,82,82,2690,321,649,0.495,61,162,0.377,260,487,0.534,186,232,0.802,66,134,200,154,90,15,108,257,889
1560,11,1997,33,1,3,82,4,2060,246,547,0.45,34,98,0.347,212,449,0.472,189,247,0.765,66,120,186,116,73,17,115,257,715
1560,12,1998,34,1,3,74,15,2176,344,799,0.431,36,105,0.343,308,694,0.444,365,445,0.82,50,91,141,138,77,24,147,208,1089
1560,13,1999,35,1,3,50,2,949,106,251,0.422,23,61,0.377,83,190,0.437,68,84,0.81,15,60,75,41,28,12,41,126,303
1560,14,2000,36,1,3,82,9,1763,278,623,0.446,72,190,0.379,206,433,0.476,192,229,0.838,39,115,154,65,53,11,89,207,820
1560,15,2001,37,1,2,82,17,2049,291,695,0.419,59,176,0.335,232,519,0.447,254,297,0.855,34,142,176,115,63,10,106,229,895
1560,16,2002,38,1,3,47,17,724,67,148,0.453,22,57,0.386,45,91,0.495,42,58,0.724,9,40,49,14,29,4,21,88,198
1565,1,1981,22,1,1,27,-1,493,65,149,0.436,0,1,0,65,148,0.439,35,59,0.593,13,36,49,80,28,2,63,52,165
1565,1,1981,22,1,1,40,-1,616,107,210,0.51,0,3,0,107,207,0.517,36,67,0.537,24,37,61,69,32,1,53,89,250
1565,1,1981,22,1,1,67,-1,1109,172,359,0.479,0,4,0,172,355,0.485,71,126,0.563,37,73,110,149,60,3,116,141,415
1565,2,1982,23,1,2,80,1,1322,252,555,0.454,0,5,0,252,550,0.458,85,150,0.567,67,94,161,89,66,4,101,184,589
1565,3,1983,24,1,2,9,2,148,26,59,0.441,0,1,0,26,58,0.448,11,17,0.647,8,18,26,11,6,0,11,17,63
1568,1,1981,25,1,3,44,-1,231,48,138,0.348,2,4,0.5,46,134,0.343,17,37,0.459,26,32,58,15,8,1,25,41,115
1571,1,2007,22,1,4,68,0,792,65,177,0.367,17,53,0.321,48,124,0.387,37,43,0.86,42,81,123,65,25,9,40,77,184
1572,1,1990,22,1,3,20,0,109,14,39,0.359,0,0,-1,14,39,0.359,11,16,0.688,8,18,26,5,3,1,7,15,39
1574,1,2005,25,1,3,81,38,1892,241,601,0.401,25,97,0.258,216,504,0.429,170,222,0.766,69,317,386,122,37,34,135,208,677
1574,2,2006,26,1,4,82,43,2239,383,831,0.461,93,238,0.391,290,593,0.489,204,242,0.843,89,411,500,117,40,52,120,252,1063
1574,3,2007,27,1,4,53,31,1406,273,584,0.467,80,209,0.383,193,375,0.515,123,145,0.848,42,259,301,57,27,24,104,164,749
1574,4,2008,28,1,3,82,27,2021,379,877,0.432,126,346,0.364,253,531,0.476,196,243,0.807,48,294,342,95,25,43,133,245,1080
1574,5,2009,29,1,3,23,16,713,113,252,0.448,45,102,0.441,68,150,0.453,45,59,0.763,20,119,139,42,13,17,40,85,316
1574,5,2009,29,1,4,53,2,1278,186,449,0.414,79,209,0.378,107,240,0.446,100,124,0.806,34,188,222,60,26,16,73,176,551
1574,5,2009,29,1,4,76,18,1991,299,701,0.427,124,311,0.399,175,390,0.449,145,183,0.792,54,307,361,102,39,33,113,261,867
1574,6,2010,30,1,3,75,28,1477,234,587,0.399,96,249,0.386,138,338,0.408,71,99,0.717,32,190,222,75,32,26,67,160,635
1574,7,2011,31,1,3,54,17,931,118,277,0.426,42,118,0.356,76,159,0.478,49,61,0.803,19,150,169,45,14,15,47,100,327
1579,1,1988,23,1,3,66,28,1435,241,500,0.482,0,10,0,241,490,0.492,87,170,0.512,100,163,263,78,44,34,103,123,569
1579,2,1989,24,1,3,80,79,3020,638,1271,0.502,4,21,0.19,634,1250,0.507,170,270,0.63,245,422,667,277,106,66,206,223,1450
1579,3,1990,25,1,3,70,64,2334,484,949,0.51,7,16,0.438,477,933,0.511,153,242,0.632,143,327,470,160,78,59,190,196,1128
1579,4,1991,26,1,3,70,45,2309,520,1037,0.501,6,32,0.188,514,1005,0.511,173,275,0.629,177,320,497,159,63,63,139,192,1219
1579,5,1992,27,1,3,77,24,2009,402,821,0.49,4,28,0.143,398,793,0.502,121,226,0.535,158,290,448,125,53,66,100,145,929
1579,6,1993,28,1,3,76,71,2477,498,975,0.511,10,38,0.263,488,937,0.521,131,220,0.595,209,362,571,165,59,58,125,156,1137
1579,7,1994,29,1,3,82,75,2539,412,919,0.448,63,189,0.333,349,730,0.478,92,183,0.503,169,331,500,222,58,46,150,209,979
1579,8,1995,30,1,3,74,27,1879,388,856,0.453,98,285,0.344,290,571,0.508,64,140,0.457,103,259,362,94,34,20,96,154,938
1579,9,1996,31,1,3,34,28,770,127,273,0.465,33,84,0.393,94,189,0.497,17,48,0.354,40,92,132,63,15,16,46,68,304
1579,10,1997,32,1,3,17,0,220,27,94,0.287,6,38,0.158,21,56,0.375,4,12,0.333,8,31,39,12,7,3,18,17,64
1580,1,1983,22,1,5,30,0,311,26,63,0.413,0,0,-1,26,63,0.413,14,30,0.467,25,44,69,24,13,2,33,61,66
1580,2,1984,23,1,5,79,1,1157,124,246,0.504,0,0,-1,124,246,0.504,104,149,0.698,82,175,257,76,30,34,114,231,352
1580,3,1985,24,1,5,78,13,1117,133,245,0.543,0,3,0,133,242,0.55,135,203,0.665,90,160,250,47,42,33,100,221,401
1581,1,1980,22,1,5,17,-1,189,18,43,0.419,0,0,-1,18,43,0.419,4,6,0.667,10,33,43,6,3,12,19,41,40
1587,1,1998,22,1,2,30,0,234,26,69,0.377,0,3,0,26,66,0.394,12,15,0.8,14,19,33,17,9,1,9,15,64
1587,2,1999,23,1,2,18,1,165,24,56,0.429,0,1,0,24,55,0.436,8,8,1,18,16,34,12,2,3,8,22,56
1588,1,1996,23,1,2,64,29,1253,156,400,0.39,10,56,0.179,146,344,0.424,77,108,0.713,65,103,168,63,44,11,62,95,399
1588,2,1997,24,1,3,19,0,175,17,72,0.236,1,10,0.1,16,62,0.258,11,12,0.917,9,27,36,11,5,2,6,19,46
1588,2,1997,24,1,3,45,5,634,76,207,0.367,17,60,0.283,59,147,0.401,20,23,0.87,41,71,112,28,24,10,14,78,189
1588,2,1997,24,1,3,64,5,809,93,279,0.333,18,70,0.257,75,209,0.359,31,35,0.886,50,98,148,39,29,12,20,97,235
1604,1,1981,22,1,3,79,-1,2473,365,751,0.486,5,18,0.278,360,733,0.491,135,212,0.637,179,299,478,252,86,27,146,243,870
1604,2,1982,23,1,3,80,32,2018,383,778,0.492,8,23,0.348,375,755,0.497,135,189,0.714,111,194,305,192,83,13,147,175,909
1604,3,1983,24,1,3,46,14,803,136,259,0.525,2,9,0.222,134,250,0.536,34,48,0.708,42,72,114,82,42,11,62,67,308
1604,4,1984,25,1,3,73,25,1191,186,385,0.483,5,28,0.179,181,357,0.507,53,87,0.609,71,104,175,95,34,11,75,148,430
1604,5,1985,26,1,3,43,29,1119,194,393,0.494,8,21,0.381,186,372,0.5,42,67,0.627,46,120,166,102,32,16,51,115,438
1604,6,1986,27,1,3,67,11,1031,160,336,0.476,7,27,0.259,153,309,0.495,23,39,0.59,33,102,135,118,29,9,54,134,350
1604,7,1987,28,1,3,15,0,123,16,42,0.381,0,2,0,16,40,0.4,0,2,0,6,8,14,13,2,0,6,10,32
1605,1,1993,20,1,5,81,81,3071,733,1304,0.562,0,2,0,733,1302,0.563,427,721,0.592,342,780,1122,152,60,286,307,321,1893
1605,2,1994,21,1,5,81,81,3224,953,1591,0.599,0,2,0,953,1589,0.6,471,850,0.554,384,688,1072,195,76,231,222,281,2377
1605,3,1995,22,1,5,79,79,2923,930,1594,0.583,0,5,0,930,1589,0.585,455,854,0.533,328,573,901,214,73,192,204,258,2315
1605,4,1996,23,1,5,54,52,1946,592,1033,0.573,1,2,0.5,591,1031,0.573,249,511,0.487,182,414,596,155,34,115,155,193,1434
1605,5,1997,24,1,5,51,51,1941,552,991,0.557,0,4,0,552,987,0.559,232,479,0.484,195,445,640,159,46,147,146,180,1336
1605,6,1998,25,1,5,60,57,2175,670,1147,0.584,0,0,-1,670,1147,0.584,359,681,0.527,208,473,681,142,39,144,175,193,1699
1605,7,1999,26,1,5,49,49,1705,510,885,0.576,0,1,0,510,884,0.577,269,498,0.54,187,338,525,114,36,82,122,155,1289
1605,8,2000,27,1,5,79,79,3163,956,1665,0.574,0,1,0,956,1664,0.575,432,824,0.524,336,742,1078,299,36,239,223,255,2344
1605,9,2001,28,1,5,74,74,2924,813,1422,0.572,0,2,0,813,1420,0.573,499,972,0.513,291,649,940,277,47,204,218,256,2125
1605,10,2002,29,1,5,67,66,2422,712,1229,0.579,0,1,0,712,1228,0.58,398,717,0.555,235,480,715,200,41,137,171,199,1822
1605,11,2003,30,1,5,67,66,2535,695,1211,0.574,0,0,-1,695,1211,0.574,451,725,0.622,259,483,742,206,38,159,196,229,1841
1605,12,2004,31,1,5,67,67,2464,554,948,0.584,0,0,-1,554,948,0.584,331,676,0.49,246,523,769,196,34,166,195,225,1439
1605,13,2005,32,1,5,73,73,2492,658,1095,0.601,0,0,-1,658,1095,0.601,353,765,0.461,253,507,760,200,36,171,203,262,1669
1605,14,2006,33,1,5,59,58,1806,480,800,0.6,0,0,-1,480,800,0.6,221,471,0.469,172,369,541,113,23,104,168,230,1181
1605,15,2007,34,1,5,40,39,1135,283,479,0.591,0,0,-1,283,479,0.591,124,294,0.422,97,200,297,79,8,55,95,139,690
1605,16,2008,35,1,5,28,28,803,140,229,0.611,0,0,-1,140,229,0.611,82,160,0.513,67,229,296,48,13,34,83,94,362
1605,16,2008,35,1,5,33,33,945,191,329,0.581,0,0,-1,191,329,0.581,88,178,0.494,99,159,258,45,19,54,98,134,470
1605,16,2008,35,1,5,61,61,1748,331,558,0.593,0,0,-1,331,558,0.593,170,338,0.503,166,388,554,93,32,88,181,228,832
1605,17,2009,36,1,5,75,75,2252,512,841,0.609,0,1,0,512,840,0.61,309,519,0.595,187,446,633,126,49,108,168,253,1333
1605,18,2010,37,1,5,53,53,1240,262,463,0.566,0,1,0,262,462,0.567,112,226,0.496,93,262,355,80,15,62,105,169,636
1605,19,2011,38,1,5,37,36,752,134,201,0.667,0,0,-1,134,201,0.667,73,131,0.557,48,130,178,26,16,42,56,120,341
1606,1,1986,22,1,4,77,30,1772,281,541,0.519,0,3,0,281,538,0.522,178,269,0.662,255,409,664,133,68,30,175,250,740
1606,2,1987,23,1,4,82,81,2980,468,1052,0.445,11,30,0.367,457,1022,0.447,245,357,0.686,299,775,1074,296,85,36,299,315,1192
1606,3,1988,24,1,4,82,82,2816,375,776,0.483,3,12,0.25,372,764,0.487,261,359,0.727,326,740,1066,248,68,28,241,272,1014
1606,4,1989,25,1,4,82,82,2604,426,835,0.51,12,48,0.25,414,787,0.526,197,255,0.773,343,518,861,187,104,14,248,270,1061
1606,5,1990,26,1,4,61,61,2196,336,641,0.524,0,3,0,336,638,0.527,217,285,0.761,258,469,727,146,64,16,165,220,889
1606,6,1991,27,1,4,76,74,2739,307,595,0.516,0,2,0,307,593,0.518,239,305,0.784,305,615,920,204,62,17,215,288,853
1606,7,1992,28,1,4,82,82,2309,210,402,0.522,0,3,0,210,399,0.526,86,117,0.735,256,444,700,133,67,15,123,258,506
1606,8,1993,29,1,4,82,82,2230,219,431,0.508,0,1,0,219,430,0.509,127,176,0.722,288,420,708,126,85,15,124,289,565
1606,9,1994,30,1,4,82,82,2932,363,760,0.478,0,3,0,363,757,0.48,243,313,0.776,349,616,965,218,110,18,193,293,969
1606,10,1995,31,1,4,50,49,1567,192,393,0.489,3,12,0.25,189,381,0.496,119,150,0.793,155,290,445,126,60,7,103,179,506
1606,11,1996,32,1,4,53,51,1775,211,448,0.471,7,26,0.269,204,422,0.483,175,210,0.833,162,298,460,137,58,14,104,195,604
1606,12,1997,33,1,4,80,80,2873,339,694,0.488,5,19,0.263,334,675,0.495,181,224,0.808,246,535,781,221,111,21,171,305,864
1606,13,1998,34,1,4,79,79,2734,307,698,0.44,0,6,0,307,692,0.444,97,114,0.851,218,506,724,201,123,22,126,280,711
1606,14,1999,35,1,4,50,50,1633,140,327,0.428,1,5,0.2,139,322,0.432,67,83,0.807,96,278,374,168,46,21,96,182,348
1606,15,2000,36,1,4,80,80,2431,234,560,0.418,14,41,0.341,220,519,0.424,66,85,0.776,117,423,540,253,102,45,154,294,548
1606,16,2001,37,1,4,78,77,2767,305,786,0.388,11,49,0.224,294,737,0.399,127,152,0.836,142,599,741,264,76,48,139,258,748
1606,17,2002,38,1,4,57,36,1383,97,263,0.369,1,6,0.167,96,257,0.374,21,28,0.75,72,271,343,114,49,11,87,175,216
1606,18,2003,39,1,5,42,1,514,23,55,0.418,0,0,-1,23,55,0.418,28,34,0.824,37,70,107,40,13,6,21,90,74
1607,1,2006,30,1,5,59,0,490,44,93,0.473,0,2,0,44,91,0.484,15,27,0.556,57,66,123,27,9,11,28,91,103
1607,2,2007,31,1,4,79,33,1365,158,281,0.562,0,0,-1,158,281,0.562,33,51,0.647,131,237,368,68,25,24,69,213,349
1607,3,2008,32,1,4,82,64,1644,180,296,0.608,0,1,0,180,295,0.61,37,61,0.607,153,277,430,95,37,20,51,203,397
1607,4,2009,33,1,5,54,11,677,61,104,0.587,0,1,0,61,103,0.592,20,35,0.571,65,77,142,59,7,11,38,95,142
1607,5,2010,34,1,5,57,20,650,35,56,0.625,0,0,-1,35,56,0.625,13,17,0.765,34,71,105,51,11,9,36,121,83
1610,1,1991,23,1,5,31,1,261,24,55,0.436,0,2,0,24,53,0.453,6,10,0.6,15,34,49,2,6,27,8,53,54
1610,2,1992,24,1,5,43,0,367,46,84,0.548,0,0,-1,46,84,0.548,16,30,0.533,30,44,74,7,5,28,19,73,108
1612,1,2003,23,1,4,72,9,1366,180,423,0.426,38,112,0.339,142,311,0.457,96,131,0.733,117,218,335,71,25,39,66,167,494
1612,2,2004,24,1,4,71,33,1580,251,542,0.463,18,48,0.375,233,494,0.472,162,209,0.775,160,261,421,69,36,63,101,138,682
1612,3,2005,25,1,5,82,25,2304,354,756,0.468,17,63,0.27,337,693,0.486,329,387,0.85,194,422,616,166,32,68,141,227,1054
1612,4,2006,26,1,4,82,82,2945,519,1128,0.46,80,234,0.342,439,894,0.491,354,454,0.78,211,535,746,194,40,73,163,285,1472
1612,5,2007,27,1,5,80,80,2664,490,1061,0.462,129,336,0.384,361,725,0.498,296,387,0.765,160,419,579,156,36,38,125,257,1405
1612,6,2008,28,1,5,72,72,2390,374,841,0.445,114,294,0.388,260,547,0.475,185,230,0.804,132,424,556,145,55,29,104,236,1047
1612,7,2009,29,1,5,72,72,2409,431,888,0.485,90,202,0.446,341,686,0.497,273,334,0.817,124,433,557,120,54,53,132,219,1225
1612,8,2010,30,1,5,73,73,2149,355,775,0.458,82,213,0.385,273,562,0.486,196,239,0.82,132,383,515,119,38,81,127,223,988
1612,9,2011,31,1,5,13,0,168,22,62,0.355,5,16,0.313,17,46,0.37,15,20,0.75,9,21,30,19,4,4,7,18,64
1612,10,2012,32,1,5,17,14,454,52,139,0.374,23,72,0.319,29,67,0.433,3,5,0.6,22,59,81,30,9,5,25,45,130
1613,1,1985,22,1,5,82,82,2914,677,1258,0.538,0,0,-1,677,1258,0.538,338,551,0.613,440,534,974,111,99,220,234,344,1692
1613,2,1986,23,1,5,68,68,2467,625,1188,0.526,0,0,-1,625,1188,0.526,347,538,0.645,333,448,781,137,134,231,195,271,1597
1613,3,1987,24,1,5,75,75,2760,677,1332,0.508,1,5,0.2,676,1327,0.509,400,570,0.702,315,543,858,220,140,254,228,294,1755
1613,4,1988,25,1,5,79,79,2825,712,1385,0.514,0,4,0,712,1381,0.516,381,548,0.695,302,657,959,163,162,214,243,324,1805
1613,5,1989,26,1,5,82,82,3024,790,1556,0.508,0,10,0,790,1546,0.511,454,652,0.696,338,767,1105,149,213,282,275,329,2034
1613,6,1990,27,1,5,82,82,3124,806,1609,0.501,1,6,0.167,805,1603,0.502,382,536,0.713,299,850,1149,234,174,376,316,314,1995
1613,7,1991,28,1,5,56,50,2062,487,959,0.508,0,4,0,487,955,0.51,213,277,0.769,219,551,770,131,121,221,174,221,1187
1613,8,1992,29,1,5,70,69,2636,591,1177,0.502,0,1,0,591,1176,0.503,328,428,0.766,246,599,845,157,127,304,187,263,1510
1613,9,1993,30,1,5,82,82,3242,848,1603,0.529,0,8,0,848,1595,0.532,444,570,0.779,283,785,1068,291,150,342,262,305,2140
1613,10,1994,31,1,5,80,80,3277,894,1694,0.528,8,19,0.421,886,1675,0.529,388,542,0.716,229,726,955,287,128,297,271,289,2184
1613,11,1995,32,1,5,72,72,2853,798,1545,0.517,3,16,0.188,795,1529,0.52,406,537,0.756,172,603,775,255,133,242,237,250,2005
1613,12,1996,33,1,5,72,72,2797,768,1494,0.514,3,14,0.214,765,1480,0.517,397,548,0.724,176,608,784,257,113,207,247,242,1936
1613,13,1997,34,1,5,78,78,2852,727,1426,0.51,5,16,0.313,722,1410,0.512,351,446,0.787,173,543,716,236,117,173,281,249,1810
1613,14,1998,35,1,5,47,45,1633,306,633,0.483,0,3,0,306,630,0.486,160,212,0.755,116,344,460,143,84,96,126,152,772
1613,15,1999,36,1,5,50,50,1784,373,725,0.514,4,13,0.308,369,712,0.518,195,272,0.717,106,372,478,88,82,123,139,160,945
1613,16,2000,37,1,5,44,28,1049,193,421,0.458,0,2,0,193,419,0.461,69,112,0.616,65,209,274,61,41,70,73,88,455
1613,17,2001,38,1,5,58,55,1545,283,568,0.498,0,1,0,283,567,0.499,123,198,0.621,124,307,431,72,70,88,81,141,689
1613,18,2002,39,1,5,61,37,1378,194,418,0.464,0,2,0,194,416,0.466,47,84,0.56,98,268,366,66,74,90,98,147,435
1614,1,1980,23,1,3,75,-1,2111,291,609,0.478,0,3,0,291,606,0.48,210,264,0.795,83,335,418,327,67,22,180,274,792
1614,2,1981,24,1,3,82,-1,2408,348,685,0.508,1,7,0.143,347,678,0.512,315,380,0.829,146,325,471,277,75,31,202,307,1012
1614,3,1982,25,1,4,68,63,2098,333,705,0.472,2,12,0.167,331,693,0.478,273,338,0.808,118,321,439,202,57,29,139,253,941
1614,4,1983,26,1,4,80,31,1817,251,522,0.481,2,12,0.167,249,510,0.488,194,248,0.782,108,250,358,131,50,9,152,246,698
1614,5,1984,27,1,4,81,81,2160,249,504,0.494,0,1,0,249,503,0.495,261,318,0.821,119,326,445,192,50,28,166,291,759
1614,6,1985,28,1,4,81,62,2277,265,528,0.502,0,3,0,265,525,0.505,293,352,0.832,139,374,513,243,56,11,185,298,823
1614,7,1986,29,1,4,81,64,2157,225,403,0.558,0,2,0,225,401,0.561,162,210,0.771,113,310,423,266,43,23,148,276,612
1614,8,1987,30,1,4,76,0,1002,69,165,0.418,0,1,0,69,164,0.421,116,131,0.885,50,135,185,91,18,9,56,144,254
1619,1,2002,23,1,1,20,0,139,17,46,0.37,2,13,0.154,15,33,0.455,6,9,0.667,0,8,8,21,3,0,11,16,42
1620,1,1998,25,1,1,16,0,214,14,42,0.333,0,0,-1,14,42,0.333,18,25,0.72,6,15,21,32,6,0,16,16,46
1620,1,1998,25,1,1,19,0,216,23,56,0.411,0,1,0,23,55,0.418,31,45,0.689,3,15,18,33,7,0,28,15,77
1620,1,1998,25,1,1,35,0,430,37,98,0.378,0,1,0,37,97,0.381,49,70,0.7,9,30,39,65,13,0,44,31,123
1620,2,2000,27,1,1,40,0,290,22,49,0.449,0,0,-1,22,49,0.449,28,37,0.757,4,27,31,46,10,0,10,27,72
1620,3,2001,28,1,1,19,0,161,5,27,0.185,0,0,-1,5,27,0.185,12,19,0.632,3,20,23,25,5,0,9,14,22
1620,3,2001,28,1,1,51,4,764,71,165,0.43,1,3,0.333,70,162,0.432,51,70,0.729,13,59,72,121,25,1,40,70,194
1620,3,2001,28,1,1,70,4,925,76,192,0.396,1,3,0.333,75,189,0.397,63,89,0.708,16,79,95,146,30,1,49,84,216
1620,4,2002,29,1,1,29,0,577,40,100,0.4,0,0,-1,40,100,0.4,78,97,0.804,7,49,56,98,26,1,26,33,158
1620,4,2002,29,1,1,52,17,1146,97,253,0.383,1,2,0.5,96,251,0.382,109,130,0.838,18,110,128,193,36,1,80,64,304
1620,4,2002,29,1,1,81,17,1723,137,353,0.388,1,2,0.5,136,351,0.387,187,227,0.824,25,159,184,291,62,2,106,97,462
1620,5,2003,30,1,1,29,1,770,82,186,0.441,1,1,1,81,185,0.438,66,87,0.759,13,70,83,110,32,1,36,51,231
1620,5,2003,30,1,1,53,4,1127,117,255,0.459,1,5,0.2,116,250,0.464,68,91,0.747,12,87,99,181,37,4,36,71,303
1620,5,2003,30,1,1,82,5,1897,199,441,0.451,2,6,0.333,197,435,0.453,134,178,0.753,25,157,182,291,69,5,72,122,534
1620,6,2004,31,1,1,82,7,1401,95,257,0.37,4,9,0.444,91,248,0.367,147,176,0.835,23,147,170,234,51,8,81,119,341
1620,7,2005,32,1,1,26,0,158,11,31,0.355,0,0,-1,11,31,0.355,6,9,0.667,3,16,19,19,5,0,6,16,28
1620,8,2006,33,1,2,70,23,1069,75,174,0.431,1,3,0.333,74,171,0.433,41,49,0.837,13,85,98,101,33,3,29,103,192
1620,9,2007,34,1,1,53,23,919,81,187,0.433,0,2,0,81,185,0.438,37,45,0.822,8,66,74,130,21,1,47,76,199
1620,10,2008,35,1,2,40,0,300,29,69,0.42,0,1,0,29,68,0.426,12,15,0.8,4,15,19,38,10,0,5,28,70
1620,11,2009,36,1,1,50,21,850,61,150,0.407,0,1,0,61,149,0.409,80,96,0.833,13,62,75,117,19,4,34,79,202
1620,12,2010,37,1,1,25,0,263,18,45,0.4,0,1,0,18,44,0.409,8,8,1,3,22,25,20,9,0,6,16,44
1622,1,1999,23,1,5,45,36,1279,172,399,0.431,0,0,-1,172,399,0.431,57,118,0.483,120,237,357,25,27,55,85,137,401
1622,2,2000,24,1,5,80,77,2493,330,756,0.437,0,0,-1,330,756,0.437,123,189,0.651,194,462,656,38,35,140,177,304,783
1622,3,2001,25,1,5,82,82,2127,308,708,0.435,0,0,-1,308,708,0.435,85,156,0.545,168,357,525,46,30,108,169,250,701
1622,4,2002,26,1,5,80,79,2568,384,886,0.433,0,0,-1,384,886,0.433,117,188,0.622,164,547,711,90,55,145,175,217,885
1622,5,2003,27,1,5,36,36,1369,186,436,0.427,0,0,-1,186,436,0.427,69,105,0.657,57,271,328,47,18,79,98,110,441
1622,6,2004,28,1,5,43,25,925,121,285,0.425,0,0,-1,121,285,0.425,36,61,0.59,78,167,245,24,16,68,54,137,278
1622,7,2005,29,1,5,62,34,1215,161,353,0.456,0,0,-1,161,353,0.456,46,69,0.667,106,218,324,29,15,56,68,193,368
1622,8,2006,30,1,5,16,0,167,20,45,0.444,0,0,-1,20,45,0.444,5,8,0.625,5,36,41,6,3,6,14,22,45
1622,8,2006,30,1,5,32,24,752,87,195,0.446,0,0,-1,87,195,0.446,19,39,0.487,45,134,179,17,19,27,41,100,193
1622,8,2006,30,1,5,48,24,919,107,240,0.446,0,0,-1,107,240,0.446,24,47,0.511,50,170,220,23,22,33,55,122,238
1622,9,2007,31,1,5,24,0,234,19,46,0.413,0,0,-1,19,46,0.413,2,3,0.667,14,34,48,5,8,13,17,48,40
1625,1,1981,22,1,3,82,-1,1787,348,709,0.491,0,6,0,348,703,0.495,163,202,0.807,172,189,361,132,55,25,123,153,859
1625,2,1982,23,1,3,80,41,1951,357,719,0.497,1,8,0.125,356,711,0.501,203,254,0.799,127,204,331,134,56,26,137,182,918
1625,3,1983,24,1,3,82,14,1666,274,593,0.462,0,2,0,274,591,0.464,140,175,0.8,94,134,228,94,64,24,93,134,688
1625,4,1984,25,1,3,78,20,1640,262,572,0.458,0,0,-1,262,572,0.458,173,211,0.82,101,127,228,61,66,17,95,142,697
1625,5,1985,26,1,4,79,31,2452,372,766,0.486,1,10,0.1,371,756,0.491,262,334,0.784,171,220,391,134,100,27,138,195,1007
1625,6,1986,27,1,3,74,64,2237,330,741,0.445,0,4,0,330,737,0.448,218,278,0.784,123,189,312,179,61,26,118,177,878
1625,7,1987,28,1,3,65,8,1440,166,389,0.427,1,5,0.2,165,384,0.43,125,172,0.727,102,130,232,110,47,18,70,123,458
1625,8,1988,29,1,3,29,0,180,16,50,0.32,0,1,0,16,49,0.327,8,16,0.5,13,21,34,9,6,0,14,27,40
1626,1,1989,25,1,4,51,15,327,55,125,0.44,0,1,0,55,124,0.444,31,52,0.596,30,28,58,11,8,7,36,40,141
1629,1,1996,22,1,5,57,10,661,86,182,0.473,0,0,-1,86,182,0.473,36,54,0.667,57,118,175,5,5,63,25,91,208
1629,2,1997,23,1,5,77,70,1818,210,408,0.515,0,4,0,210,404,0.52,139,205,0.678,180,385,565,27,24,152,74,233,559
1629,3,1998,24,1,5,63,23,1288,115,239,0.481,0,0,-1,115,239,0.481,67,140,0.479,134,240,374,25,28,132,74,166,297
1629,4,1999,25,1,5,48,48,1340,99,208,0.476,0,0,-1,99,208,0.476,75,121,0.62,105,243,348,23,12,131,45,140,273
1629,5,2000,26,1,5,81,3,1606,124,267,0.464,0,1,0,124,266,0.466,119,187,0.636,172,310,482,18,20,172,79,196,367
1629,6,2001,27,1,5,81,3,1491,139,281,0.495,1,2,0.5,138,279,0.495,84,151,0.556,164,251,415,22,22,142,63,215,363
1629,7,2002,28,1,5,74,14,1107,91,201,0.453,0,0,-1,91,201,0.453,63,130,0.485,125,188,313,50,15,109,51,152,245
1629,8,2003,29,1,5,81,74,1926,169,326,0.518,0,0,-1,169,326,0.518,100,196,0.51,180,323,503,55,20,147,104,235,438
1629,9,2004,30,1,5,78,51,2153,208,437,0.476,0,1,0,208,436,0.477,113,195,0.579,221,357,578,123,30,139,99,228,529
1629,10,2005,31,1,5,56,3,556,37,84,0.44,0,2,0,37,82,0.451,13,38,0.342,55,112,167,37,7,40,24,88,87
1629,11,2006,32,1,5,60,22,807,61,124,0.492,0,0,-1,61,124,0.492,24,48,0.5,82,143,225,58,6,66,46,129,146
1633,1,1994,22,1,3,37,14,871,98,167,0.587,0,2,0,98,165,0.594,61,103,0.592,81,131,212,36,36,37,31,94,257
1633,2,1995,23,1,4,81,31,1655,170,325,0.523,0,5,0,170,320,0.531,82,186,0.441,121,192,313,84,90,151,78,227,422
1633,3,1996,24,1,4,80,3,985,107,186,0.575,0,3,0,107,183,0.585,72,162,0.444,87,113,200,50,44,91,45,127,286
1633,4,1997,25,1,4,82,25,2195,254,417,0.609,0,8,0,254,409,0.621,117,232,0.504,174,280,454,157,94,142,107,227,625
1633,5,1998,26,1,4,82,76,2953,301,543,0.554,1,4,0.25,300,539,0.557,180,313,0.575,255,382,637,216,107,181,175,260,783
1633,6,1999,27,1,4,31,22,851,84,154,0.545,0,3,0,84,151,0.556,35,81,0.432,54,113,167,56,40,43,58,79,203
1633,7,2000,28,1,4,82,55,2326,204,339,0.602,0,3,0,204,336,0.607,82,162,0.506,202,323,525,245,113,148,133,203,490
1633,8,2001,29,1,4,80,69,2534,226,368,0.614,1,2,0.5,225,366,0.615,129,225,0.573,211,408,619,225,105,137,141,241,582
1633,9,2002,30,1,4,10,0,160,13,21,0.619,0,0,-1,13,21,0.619,8,18,0.444,15,14,29,5,9,9,11,23,34
1633,9,2002,30,1,4,73,36,1768,153,278,0.55,1,2,0.5,152,276,0.551,35,84,0.417,132,203,335,122,61,83,85,182,342
1633,9,2002,30,1,4,83,36,1928,166,299,0.555,1,2,0.5,165,297,0.556,43,102,0.422,147,217,364,127,70,92,96,205,376
1633,10,2003,31,1,5,80,20,1800,153,278,0.55,0,2,0,153,276,0.554,72,116,0.621,134,234,368,112,50,71,76,194,378
1633,11,2004,32,1,4,82,1,1606,159,312,0.51,0,4,0,159,308,0.516,61,116,0.526,125,217,342,90,73,70,69,170,379
1633,12,2005,33,1,4,39,0,214,12,34,0.353,0,0,-1,12,34,0.353,5,9,0.556,16,37,53,13,6,12,8,29,29
1633,13,2006,34,1,4,32,0,355,35,58,0.603,0,0,-1,35,58,0.603,5,8,0.625,31,46,77,14,10,12,17,50,75
1633,14,2007,35,1,4,41,0,460,34,51,0.667,0,0,-1,34,51,0.667,13,22,0.591,47,59,106,16,17,6,21,57,81
1638,1,2011,28,1,3,5,0,112,12,26,0.462,5,10,0.5,7,16,0.438,2,5,0.4,1,10,11,7,7,5,5,14,31
1638,1,2011,28,1,3,12,0,143,15,32,0.469,6,13,0.462,9,19,0.474,4,9,0.444,1,14,15,8,9,5,5,18,40
1640,1,1992,22,1,4,80,77,2510,468,891,0.525,1,9,0.111,467,882,0.529,204,312,0.654,243,396,639,188,90,65,179,276,1141
1640,2,1993,23,1,4,37,37,1201,247,493,0.501,1,11,0.091,246,482,0.51,117,183,0.639,108,156,264,144,35,28,106,105,612
1640,3,1994,24,1,4,79,72,2738,492,971,0.507,3,15,0.2,489,956,0.512,199,326,0.61,230,410,640,326,83,60,214,269,1186
1640,4,1995,25,1,2,70,60,2296,403,820,0.491,2,22,0.091,401,798,0.503,194,313,0.62,203,299,502,246,80,30,204,205,1002
1640,5,1996,26,1,3,22,11,594,84,200,0.42,5,12,0.417,79,188,0.42,45,70,0.643,49,76,125,70,19,16,51,60,218
1640,5,1996,26,1,3,40,40,1388,239,473,0.505,0,6,0,239,467,0.512,112,177,0.633,94,192,286,134,30,22,113,132,590
1640,5,1996,26,1,3,62,51,1982,323,673,0.48,5,18,0.278,318,655,0.485,157,247,0.636,143,268,411,204,49,38,164,192,808
1640,6,1997,27,1,3,66,56,1995,299,640,0.467,25,72,0.347,274,568,0.482,101,145,0.697,134,258,392,187,62,25,133,187,724
1640,7,1998,28,1,3,78,78,2348,338,728,0.464,26,70,0.371,312,658,0.474,116,197,0.589,170,412,582,219,93,38,153,231,818
1640,8,1999,29,1,3,21,19,451,65,165,0.394,5,11,0.455,60,154,0.39,28,35,0.8,35,45,80,38,12,4,33,37,163
1640,9,2000,30,1,3,16,4,386,38,100,0.38,2,7,0.286,36,93,0.387,25,42,0.595,36,73,109,38,7,5,24,47,103
1640,9,2000,30,1,4,46,7,919,112,258,0.434,9,27,0.333,103,231,0.446,38,64,0.594,63,129,192,59,26,16,61,119,271
1640,9,2000,30,1,4,62,11,1305,150,358,0.419,11,34,0.324,139,324,0.429,63,106,0.594,99,202,301,97,33,21,85,166,374
1640,10,2001,31,1,4,45,14,793,88,230,0.383,3,20,0.15,85,210,0.405,19,40,0.475,84,121,205,55,32,12,39,93,198
1641,1,1980,30,1,5,76,-1,2337,518,1008,0.514,1,2,0.5,517,1006,0.514,213,283,0.753,189,384,573,194,45,53,174,270,1250
1641,2,1981,31,1,4,79,-1,1843,322,630,0.511,0,4,0,322,626,0.514,191,250,0.764,165,291,456,140,36,47,130,273,835
1641,3,1982,32,1,4,74,40,1599,299,636,0.47,1,2,0.5,298,634,0.47,181,226,0.801,142,230,372,127,41,37,137,259,780
1641,4,1983,33,1,5,49,4,725,81,192,0.422,0,0,-1,81,192,0.422,45,66,0.682,66,120,186,44,12,14,48,115,207
1642,1,1997,24,1,4,57,1,592,75,180,0.417,1,5,0.2,74,175,0.423,26,46,0.565,64,99,163,15,15,20,23,86,177
1643,1,2001,19,1,5,30,1,221,18,37,0.486,0,0,-1,18,37,0.486,9,12,0.75,24,43,67,2,7,10,11,40,45
1643,2,2002,20,1,5,36,1,221,22,41,0.537,0,0,-1,22,41,0.537,11,18,0.611,27,52,79,4,4,2,14,36,55
1643,3,2003,21,1,5,27,3,145,10,23,0.435,0,0,-1,10,23,0.435,7,11,0.636,10,40,50,5,5,3,5,30,27
1648,1,2004,22,1,3,41,3,427,52,129,0.403,21,44,0.477,31,85,0.365,20,24,0.833,19,36,55,14,13,2,21,41,145
1648,2,2005,23,1,3,81,14,1491,269,671,0.401,80,194,0.412,189,477,0.396,70,85,0.824,32,132,164,61,40,6,46,132,688
1648,3,2006,24,1,3,51,2,665,79,177,0.446,21,53,0.396,58,124,0.468,28,33,0.848,12,59,71,37,7,3,20,89,207
1648,4,2007,25,1,3,67,35,1767,278,563,0.494,108,210,0.514,170,353,0.482,66,74,0.892,26,154,180,81,38,2,70,135,730
1648,5,2008,26,1,3,81,7,1530,243,498,0.488,57,118,0.483,186,380,0.489,37,43,0.86,31,89,120,65,34,2,58,131,580
1648,6,2009,27,1,2,80,12,1831,261,604,0.432,98,229,0.428,163,375,0.435,34,42,0.81,26,137,163,105,22,3,70,144,654
1648,7,2010,28,1,3,57,12,976,126,301,0.419,63,171,0.368,63,130,0.485,9,15,0.6,14,52,66,39,21,6,34,80,324
1648,8,2011,29,1,3,24,2,112,7,28,0.25,1,8,0.125,6,20,0.3,1,2,0.5,3,8,11,4,2,1,2,4,16
1648,9,2012,30,1,2,27,0,269,21,55,0.382,8,27,0.296,13,28,0.464,4,4,1,2,12,14,11,3,0,6,21,54
1651,1,1981,21,1,4,16,-1,199,37,81,0.457,0,1,0,37,80,0.463,43,62,0.694,28,39,67,5,6,1,16,44,117
1651,2,1982,22,1,4,35,0,248,26,49,0.531,0,0,-1,26,49,0.531,29,42,0.69,26,35,61,14,4,3,16,55,81
1655,1,2005,24,1,5,45,0,356,47,98,0.48,0,1,0,47,97,0.485,24,43,0.558,52,76,128,8,8,13,26,86,118
1655,2,2006,25,1,5,28,0,213,31,69,0.449,0,0,-1,31,69,0.449,18,23,0.783,24,36,60,3,2,3,15,69,80
1663,1,1983,21,1,4,81,81,2761,680,1420,0.479,4,18,0.222,676,1402,0.482,261,352,0.741,340,520,860,223,141,43,217,298,1625
1663,2,1984,22,1,4,79,79,2676,619,1193,0.519,7,21,0.333,612,1172,0.522,261,340,0.768,230,489,719,234,121,28,218,242,1506
1663,3,1985,23,1,4,77,65,2449,562,1112,0.505,7,14,0.5,555,1098,0.505,301,396,0.76,224,500,724,244,86,26,231,247,1432
1663,4,1986,24,1,4,19,12,568,139,294,0.473,4,13,0.308,135,281,0.48,53,69,0.768,51,117,168,57,28,8,61,59,335
1664,1,1993,22,1,4,82,6,1549,188,376,0.5,0,1,0,188,375,0.501,166,237,0.7,171,261,432,80,57,16,100,195,542
1664,2,1994,23,1,4,63,1,763,96,213,0.451,0,0,-1,96,213,0.451,81,111,0.73,77,124,201,34,20,9,60,80,273
1664,3,1995,24,1,3,75,0,1270,172,298,0.577,0,0,-1,172,298,0.577,117,173,0.676,135,192,327,30,36,25,62,141,461
1664,4,1996,25,1,4,82,0,1708,180,346,0.52,0,4,0,180,342,0.526,139,201,0.692,176,279,455,64,51,41,88,174,499
1664,5,1997,26,1,5,62,0,915,82,160,0.513,0,1,0,82,159,0.516,71,103,0.689,75,141,216,32,30,13,45,97,235
1664,6,1998,27,1,5,80,75,2047,229,424,0.54,0,0,-1,229,424,0.54,162,200,0.81,179,259,438,89,52,24,71,172,620
1664,7,1999,28,1,4,44,0,642,56,124,0.452,0,4,0,56,120,0.467,62,89,0.697,51,91,142,28,16,12,33,63,174
1664,8,2000,29,1,5,62,3,604,53,130,0.408,0,1,0,53,129,0.411,29,36,0.806,45,91,136,34,17,13,46,90,135
1664,9,2001,30,1,4,67,13,836,64,159,0.403,1,3,0.333,63,156,0.404,39,63,0.619,90,119,209,36,28,20,40,102,168
1667,1,1980,26,1,5,23,-1,373,43,85,0.506,0,0,-1,43,85,0.506,47,60,0.783,44,74,118,50,28,17,46,58,133
1667,1,1980,26,1,5,57,-1,1466,186,399,0.466,0,3,0,186,396,0.47,197,250,0.788,156,241,397,128,50,79,152,215,569
1667,1,1980,26,1,5,80,-1,1839,229,484,0.473,0,3,0,229,481,0.476,244,310,0.787,200,315,515,178,78,96,198,273,702
1667,2,1981,27,1,5,81,-1,1686,196,387,0.506,0,2,0,196,385,0.509,175,231,0.758,131,310,441,282,79,63,209,210,567
1667,3,1982,28,1,5,81,39,1892,236,505,0.467,0,1,0,236,504,0.468,167,223,0.749,168,329,497,293,64,71,244,292,639
1667,4,1983,29,1,5,38,0,565,59,141,0.418,0,0,-1,59,141,0.418,55,70,0.786,61,111,172,59,21,18,53,115,173
1667,4,1983,29,1,5,32,23,780,71,152,0.467,0,0,-1,71,152,0.467,87,105,0.829,70,162,232,79,33,21,65,106,229
1667,4,1983,29,1,5,70,23,1345,130,293,0.444,0,0,-1,130,293,0.444,142,175,0.811,131,273,404,138,54,39,118,221,402
1667,5,1984,30,1,5,75,30,1674,132,264,0.5,0,0,-1,132,264,0.5,124,162,0.765,140,350,490,157,55,29,148,273,388
1667,6,1985,31,1,5,77,34,1276,103,216,0.477,0,2,0,103,214,0.481,84,112,0.75,118,232,350,120,42,30,124,227,290
1667,7,1986,32,1,5,37,0,324,28,49,0.571,0,2,0,28,47,0.596,18,22,0.818,29,52,81,43,10,3,22,62,74
1669,1,1980,22,1,3,50,-1,1233,280,593,0.472,3,15,0.2,277,578,0.479,146,203,0.719,124,152,276,108,60,34,140,176,709
1669,2,1981,23,1,3,25,-1,654,120,285,0.421,0,2,0,120,283,0.424,68,106,0.642,53,67,120,45,34,29,78,89,308
1669,3,1982,24,1,3,11,0,183,35,86,0.407,0,3,0,35,83,0.422,27,41,0.659,13,26,39,12,5,7,22,32,97
1669,3,1982,24,1,3,49,10,558,81,185,0.438,0,0,-1,81,185,0.438,78,119,0.655,67,87,154,45,13,14,62,99,240
1669,3,1982,24,1,3,60,10,741,116,271,0.428,0,3,0,116,268,0.433,105,160,0.656,80,113,193,57,18,21,84,131,337
1669,4,1983,25,1,3,80,9,1507,247,450,0.549,0,3,0,247,447,0.553,173,257,0.673,158,245,403,97,52,35,149,243,667
1669,5,1984,26,1,3,80,21,1783,313,603,0.519,2,6,0.333,311,597,0.521,250,356,0.702,188,203,391,91,68,31,195,249,878
1669,6,1985,27,1,3,10,0,114,21,53,0.396,0,1,0,21,52,0.404,20,28,0.714,6,13,19,13,7,0,12,16,62
1671,1,1990,20,1,4,81,1,1120,203,424,0.479,2,12,0.167,201,412,0.488,117,159,0.736,146,200,346,26,47,70,107,204,525
1671,2,1991,21,1,4,81,66,2442,462,909,0.508,2,12,0.167,460,897,0.513,288,436,0.661,267,412,679,144,77,123,202,319,1214
1671,3,1992,22,1,4,64,23,1808,362,718,0.504,0,3,0,362,715,0.506,270,361,0.748,264,401,665,86,70,124,156,261,994
1671,4,1993,23,1,4,78,68,2582,515,1047,0.492,0,4,0,515,1043,0.494,358,503,0.712,287,546,833,155,119,146,217,327,1388
1671,5,1994,24,1,4,79,73,2597,533,990,0.538,1,4,0.25,532,986,0.54,364,491,0.741,312,539,851,207,142,166,259,312,1431
1671,6,1995,25,1,4,82,79,2679,545,997,0.547,2,7,0.286,543,990,0.548,438,585,0.749,318,575,893,149,102,122,259,337,1530
1671,7,1996,26,1,4,79,76,2631,526,937,0.561,5,12,0.417,521,925,0.563,493,664,0.742,276,628,904,173,93,127,315,299,1550
1671,8,1997,27,1,4,81,75,2750,526,1032,0.51,12,33,0.364,514,999,0.515,452,609,0.742,275,532,807,156,125,81,280,320,1516
1671,9,1998,28,1,4,80,80,2769,518,1164,0.445,2,8,0.25,516,1156,0.446,404,556,0.727,219,526,745,197,108,90,271,310,1442
1671,10,1999,29,1,4,42,42,1475,277,575,0.482,1,2,0.5,276,573,0.482,307,389,0.789,131,257,388,101,48,45,127,159,862
1671,11,2000,30,1,5,82,82,2492,484,1160,0.417,2,6,0.333,482,1154,0.418,493,635,0.776,231,494,725,138,100,96,291,371,1463
1671,12,2001,31,1,4,68,3,1083,168,413,0.407,4,11,0.364,164,402,0.408,101,131,0.771,63,196,259,65,45,23,99,184,441
1671,13,2002,32,1,4,75,5,1232,175,407,0.43,0,4,0,175,403,0.434,104,131,0.794,90,198,288,52,43,33,81,184,454
1671,14,2003,33,1,5,79,55,1633,211,505,0.418,0,1,0,211,504,0.419,115,155,0.742,147,304,451,55,66,33,102,239,537
1676,1,1980,27,1,4,78,-1,2798,647,1333,0.485,1,9,0.111,646,1324,0.488,270,345,0.783,258,517,775,231,111,18,232,192,1565
1676,2,1981,28,1,3,77,-1,2161,454,946,0.48,0,0,-1,454,946,0.48,180,245,0.735,179,219,398,120,75,18,161,160,1088
1676,3,1982,29,1,4,60,30,1036,192,412,0.466,0,0,-1,192,412,0.466,50,88,0.568,72,108,180,65,30,7,82,71,434
1676,4,1983,30,1,4,11,0,121,17,39,0.436,0,0,-1,17,39,0.436,7,11,0.636,13,13,26,5,1,0,6,13,41
1676,4,1983,30,1,4,32,7,624,100,212,0.472,0,1,0,100,211,0.474,35,46,0.761,52,65,117,34,21,9,39,49,235
1676,4,1983,30,1,4,48,7,770,119,257,0.463,0,1,0,119,256,0.465,42,57,0.737,66,81,147,39,23,9,47,64,280
1679,1,2000,22,1,4,22,0,132,13,32,0.406,0,0,-1,13,32,0.406,8,12,0.667,12,22,34,1,4,3,10,20,34
1681,1,1991,24,1,5,78,18,1259,199,468,0.425,0,4,0,199,464,0.429,88,131,0.672,115,221,336,31,17,26,108,189,486
1681,2,1992,25,1,4,77,4,1197,158,383,0.413,0,0,-1,158,383,0.413,94,115,0.817,114,200,314,34,17,32,58,185,410
1681,3,1993,26,1,4,40,2,415,57,122,0.467,5,11,0.455,52,111,0.468,36,47,0.766,25,66,91,14,4,12,21,63,155
1683,1,1985,22,1,3,77,0,958,178,372,0.478,0,3,0,178,369,0.482,117,181,0.646,95,111,206,63,49,29,66,147,473
1683,2,1986,23,1,3,79,2,1217,258,470,0.549,0,6,0,258,464,0.556,156,229,0.681,137,156,293,83,85,32,113,208,672
1683,3,1987,24,1,3,82,8,2088,373,733,0.509,1,23,0.043,372,710,0.524,262,364,0.72,201,295,496,194,122,77,149,328,1009
1683,4,1988,25,1,3,79,75,2888,611,1225,0.499,3,15,0.2,608,1210,0.502,291,396,0.735,211,446,657,243,127,65,161,302,1516
1683,5,1989,26,1,3,76,76,2716,533,1137,0.469,6,21,0.286,527,1116,0.472,258,372,0.694,246,383,629,243,137,84,167,277,1330
1683,6,1990,27,1,3,82,82,2843,519,1085,0.478,3,20,0.15,516,1065,0.485,269,390,0.69,251,439,690,188,121,63,144,304,1310
1683,7,1991,28,1,3,73,72,2359,424,887,0.478,4,13,0.308,420,874,0.481,232,327,0.709,169,312,481,227,101,76,149,251,1084
1683,8,1992,29,1,3,77,76,2553,398,852,0.467,1,8,0.125,397,844,0.47,174,262,0.664,241,392,633,243,114,71,151,254,971
1683,9,1993,30,1,3,65,50,1719,281,642,0.438,8,28,0.286,273,614,0.445,116,183,0.634,126,280,406,121,80,41,84,181,686
1683,10,1994,31,1,3,78,6,1276,203,469,0.433,1,8,0.125,202,461,0.438,101,135,0.748,130,201,331,75,71,49,63,213,508
1683,11,1995,32,1,3,63,0,1143,203,489,0.415,7,27,0.259,196,462,0.424,95,124,0.766,93,163,256,82,52,35,64,173,508
1683,12,1996,33,1,3,76,58,1620,205,500,0.41,3,17,0.176,202,483,0.418,97,147,0.66,154,209,363,114,91,45,75,205,510
1683,13,1997,34,1,3,70,44,1766,194,449,0.432,17,65,0.262,177,384,0.461,71,118,0.602,112,251,363,89,119,49,74,219,476
1683,14,1998,35,1,3,37,2,717,97,233,0.416,1,10,0.1,96,223,0.43,39,65,0.6,56,79,135,44,52,14,36,104,234
1683,15,1999,36,1,3,45,0,699,68,200,0.34,3,14,0.214,65,186,0.349,6,14,0.429,42,88,130,41,37,14,30,92,145
1683,16,2000,37,1,3,72,18,1310,146,354,0.412,0,9,0,146,345,0.423,29,41,0.707,58,167,225,69,67,47,51,161,321
1683,17,2001,38,1,3,22,2,243,32,69,0.464,0,1,0,32,68,0.471,8,16,0.5,8,37,45,15,14,8,6,36,72
1685,1,1989,23,1,1,26,0,157,20,46,0.435,8,17,0.471,12,29,0.414,6,9,0.667,3,14,17,24,7,0,6,12,54
1685,2,1990,24,1,1,78,5,1664,192,432,0.444,73,144,0.507,119,288,0.413,63,73,0.863,12,86,98,248,45,7,74,59,520
1685,3,1991,25,1,1,57,4,905,99,223,0.444,28,62,0.452,71,161,0.441,45,53,0.849,5,32,37,131,29,4,40,52,271
1685,4,1992,26,1,1,48,20,847,121,237,0.511,32,74,0.432,89,163,0.546,45,54,0.833,14,64,78,110,27,10,31,29,319
1685,5,1993,27,1,2,47,0,440,48,112,0.429,6,24,0.25,42,88,0.477,20,22,0.909,5,33,38,59,8,1,25,34,122
1685,5,1993,27,1,2,52,0,481,53,122,0.434,6,26,0.231,47,96,0.49,22,24,0.917,5,40,45,70,10,1,27,36,134
1685,6,1994,28,1,1,82,0,2036,287,577,0.497,52,124,0.419,235,453,0.519,83,97,0.856,26,105,131,210,75,3,57,97,709
1685,7,1995,29,1,1,82,0,1839,261,495,0.527,89,170,0.524,172,325,0.529,63,81,0.778,20,99,119,151,44,3,48,114,674
1685,8,1996,30,1,1,82,0,1919,244,482,0.506,122,237,0.515,122,245,0.498,78,84,0.929,25,85,110,192,63,2,42,109,688
1685,9,1997,31,1,1,82,0,1861,249,467,0.533,110,237,0.464,139,230,0.604,54,67,0.806,29,101,130,175,67,3,43,98,662
1685,10,1998,32,1,1,50,0,1119,137,302,0.454,57,130,0.438,80,172,0.465,45,49,0.918,14,63,77,96,26,5,27,71,376
1685,11,1999,33,1,1,44,0,734,68,174,0.391,25,80,0.313,43,94,0.457,31,35,0.886,6,38,44,49,23,3,22,28,192
1685,12,2000,34,1,1,32,0,268,32,74,0.432,16,31,0.516,16,43,0.372,9,11,0.818,3,16,19,12,4,0,7,14,89
1685,13,2001,35,1,1,55,1,650,67,159,0.421,33,77,0.429,34,82,0.415,14,15,0.933,6,29,35,57,16,1,21,30,181
1685,14,2002,36,1,1,65,0,775,102,217,0.47,26,66,0.394,76,151,0.503,39,40,0.975,6,54,60,63,13,1,24,49,269
1685,15,2003,37,1,1,75,0,952,110,256,0.43,49,124,0.395,61,132,0.462,30,34,0.882,12,48,60,70,27,3,35,49,299
1686,1,2005,22,1,3,32,5,523,54,124,0.435,4,11,0.364,50,113,0.442,23,42,0.548,28,80,108,25,20,18,33,80,135
1686,2,2006,23,1,3,69,53,1492,158,342,0.462,10,30,0.333,148,312,0.474,77,111,0.694,114,193,307,88,50,29,84,209,403
1686,3,2007,24,1,4,33,0,231,27,70,0.386,0,6,0,27,64,0.422,19,26,0.731,20,37,57,21,10,1,16,53,73
1686,4,2008,25,1,4,9,0,105,12,31,0.387,0,1,0,12,30,0.4,8,14,0.571,6,14,20,8,6,0,6,11,32
1687,1,1995,21,1,1,79,79,2668,330,857,0.385,70,257,0.272,260,600,0.433,192,275,0.698,152,278,430,607,151,24,250,146,922
1687,2,1996,22,1,1,81,81,3034,493,1293,0.381,133,396,0.336,360,897,0.401,229,331,0.692,203,350,553,783,175,26,328,155,1348
1687,3,1997,23,1,1,22,22,791,75,203,0.369,21,65,0.323,54,138,0.391,46,69,0.667,30,60,90,200,45,8,66,42,217
1687,3,1997,23,1,1,33,23,1173,138,326,0.423,40,100,0.4,98,226,0.434,66,96,0.688,34,125,159,296,79,12,76,72,382
1687,3,1997,23,1,1,55,45,1964,213,529,0.403,61,165,0.37,152,364,0.418,112,165,0.679,64,185,249,496,124,20,142,114,599
1687,4,1998,24,1,1,82,82,3118,357,859,0.416,73,233,0.313,284,626,0.454,167,209,0.799,108,402,510,745,162,26,261,142,954
1687,5,1999,25,1,1,50,50,2060,310,698,0.444,45,123,0.366,265,575,0.461,181,239,0.757,87,252,339,539,114,19,150,108,846
1687,6,2000,26,1,1,67,67,2616,350,855,0.409,56,166,0.337,294,689,0.427,203,245,0.829,96,387,483,678,134,28,226,148,959
1687,7,2001,27,1,1,77,76,3065,451,1097,0.411,69,232,0.297,382,865,0.442,328,403,0.814,91,403,494,753,166,23,286,171,1299
1687,8,2002,28,1,1,82,82,3056,445,1138,0.391,117,364,0.321,328,774,0.424,201,247,0.814,130,465,595,808,175,20,286,136,1208
1687,9,2003,29,1,1,80,80,2989,515,1244,0.414,126,370,0.341,389,874,0.445,339,403,0.841,110,394,504,711,179,25,296,127,1495
1687,10,2004,30,1,1,67,66,2450,368,959,0.384,94,293,0.321,274,666,0.411,206,249,0.827,85,343,428,618,122,14,214,110,1036
1687,11,2005,31,1,1,66,65,2435,340,855,0.398,129,358,0.36,211,497,0.425,142,192,0.74,94,394,488,545,123,9,167,110,951
1687,12,2006,32,1,1,80,80,2975,366,905,0.404,139,395,0.352,227,510,0.445,194,244,0.795,86,494,580,672,150,29,192,157,1065
1687,13,2007,33,1,1,80,80,2933,369,908,0.406,124,361,0.343,245,547,0.448,179,230,0.778,135,520,655,736,127,23,213,146,1041
1687,14,2008,34,1,1,29,29,1011,104,244,0.426,35,76,0.461,69,168,0.411,44,54,0.815,36,152,188,276,62,11,81,75,287
1687,14,2008,34,1,1,51,51,1895,201,549,0.366,84,236,0.356,117,313,0.374,91,111,0.82,58,354,412,530,74,15,185,90,577
1687,14,2008,34,1,1,80,80,2906,305,793,0.385,119,312,0.381,186,481,0.387,135,165,0.818,94,506,600,806,136,26,266,165,864
1687,15,2009,35,1,1,81,81,2886,257,618,0.416,131,323,0.406,126,295,0.427,86,105,0.819,85,415,500,702,160,39,185,168,731
1687,16,2010,36,1,1,80,80,2881,284,671,0.423,176,414,0.425,108,257,0.42,80,99,0.808,48,397,445,724,145,35,195,142,824
1687,17,2011,37,1,1,80,80,2653,215,596,0.361,133,391,0.34,82,205,0.4,67,77,0.87,35,316,351,655,134,29,179,119,630
1687,18,2012,38,1,1,48,48,1379,99,273,0.363,79,223,0.354,20,50,0.4,22,28,0.786,15,183,198,264,82,10,91,83,299
1687,19,2013,39,1,2,76,48,2043,152,409,0.372,114,325,0.351,38,84,0.452,40,48,0.833,50,273,323,249,125,25,76,125,458
1688,1,1994,23,1,4,68,14,884,100,169,0.592,0,0,-1,100,169,0.592,47,86,0.547,76,157,233,19,19,23,44,129,247
1689,1,1980,28,1,3,26,-1,212,32,96,0.333,0,0,-1,32,96,0.333,18,25,0.72,12,28,40,19,10,2,30,43,82
1694,1,1991,24,1,2,62,22,1004,159,418,0.38,19,65,0.292,140,353,0.397,92,119,0.773,42,77,119,76,30,8,77,158,429
1694,2,1992,25,1,2,34,0,277,44,111,0.396,4,13,0.308,40,98,0.408,20,31,0.645,13,19,32,17,10,6,15,37,112
1695,1,1981,22,1,2,12,-1,106,14,45,0.311,0,0,-1,14,45,0.311,10,13,0.769,0,9,9,10,2,1,8,9,38
1695,1,1981,22,1,2,29,-1,247,38,96,0.396,0,0,-1,38,96,0.396,4,5,0.8,7,17,24,35,9,5,22,24,80
1695,1,1981,22,1,2,41,-1,353,52,141,0.369,0,0,-1,52,141,0.369,14,18,0.778,7,26,33,45,11,6,30,33,118
1696,1,2000,27,1,3,62,28,1060,139,277,0.502,0,0,-1,139,277,0.502,49,66,0.742,84,166,250,49,34,15,41,132,327
1696,2,2001,28,1,3,45,3,706,90,176,0.511,0,0,-1,90,176,0.511,36,45,0.8,39,90,129,31,14,11,47,94,216
1700,1,1996,22,1,2,62,1,868,110,255,0.431,5,34,0.147,105,221,0.475,54,77,0.701,43,67,110,88,21,13,60,76,279
1702,1,1980,22,1,4,82,-1,2052,257,499,0.515,0,1,0,257,498,0.516,159,219,0.726,184,382,566,106,69,31,100,230,673
1702,2,1981,23,1,4,81,-1,2743,472,867,0.544,0,0,-1,472,867,0.544,264,386,0.684,235,551,786,122,102,41,164,227,1208
1702,3,1982,24,1,3,80,76,2609,383,752,0.509,0,0,-1,383,752,0.509,201,285,0.705,162,361,523,173,84,29,155,221,967
1702,4,1983,25,1,3,58,5,995,104,225,0.462,0,0,-1,104,225,0.462,73,96,0.76,91,149,240,58,28,11,65,94,281
1702,5,1984,26,1,3,77,42,2086,233,448,0.52,0,2,0,233,446,0.522,136,206,0.66,134,336,470,179,54,24,127,159,602
1702,6,1985,27,1,3,60,5,860,63,149,0.423,0,0,-1,63,149,0.423,41,59,0.695,44,78,122,53,28,11,42,74,167
1703,1,1992,22,1,5,40,2,213,27,71,0.38,0,1,0,27,70,0.386,34,45,0.756,20,29,49,12,4,5,18,42,88
1705,1,1990,23,1,4,82,2,1777,267,530,0.504,0,1,0,267,529,0.505,194,267,0.727,169,215,384,87,38,58,119,215,728
1705,2,1991,24,1,4,76,6,1198,156,334,0.467,0,2,0,156,332,0.47,107,152,0.704,72,136,208,65,24,42,91,134,419
1705,3,1992,25,1,4,79,12,1268,215,425,0.506,2,5,0.4,213,420,0.507,119,158,0.753,87,118,205,77,21,25,76,129,551
1705,4,1993,26,1,5,76,3,1059,160,340,0.471,2,6,0.333,158,334,0.473,86,122,0.705,105,102,207,71,26,20,70,128,408
1705,5,1994,27,1,5,18,15,516,78,170,0.459,0,0,-1,78,170,0.459,57,83,0.687,40,69,109,19,13,30,40,57,213
1705,5,1994,27,1,5,31,15,537,68,171,0.398,0,2,0,68,169,0.402,36,53,0.679,50,82,132,39,18,12,43,64,172
1705,5,1994,27,1,5,49,30,1053,146,341,0.428,0,2,0,146,339,0.431,93,136,0.684,90,151,241,58,31,42,83,121,385
1705,6,1995,28,1,4,50,10,792,99,212,0.467,0,1,0,99,211,0.469,68,102,0.667,54,111,165,26,24,20,64,126,266
1705,7,1996,29,1,4,15,0,156,17,36,0.472,0,0,-1,17,36,0.472,4,8,0.5,9,14,23,2,7,2,18,39,38
1705,8,1997,30,1,5,11,0,103,11,22,0.5,0,0,-1,11,22,0.5,2,7,0.286,11,16,27,1,2,1,6,14,24
1708,1,2007,22,1,2,48,12,967,139,304,0.457,13,46,0.283,126,258,0.488,78,98,0.796,29,68,97,41,53,1,46,57,369
1708,2,2009,24,1,2,50,3,277,31,69,0.449,7,18,0.389,24,51,0.471,33,38,0.868,10,28,38,10,12,0,22,34,102
1715,1,1986,24,1,5,80,18,1180,160,344,0.465,0,0,-1,160,344,0.465,94,130,0.723,113,260,373,46,24,34,107,224,414
1715,2,1987,25,1,5,79,31,1658,256,543,0.471,0,1,0,256,542,0.472,110,140,0.786,173,310,483,71,35,30,90,213,622
1715,3,1988,26,1,5,82,60,1999,324,686,0.472,0,0,-1,324,686,0.472,153,188,0.814,179,400,579,93,28,59,107,228,801
1715,4,1989,27,1,5,28,2,498,59,129,0.457,0,1,0,59,128,0.461,53,64,0.828,49,88,137,32,15,5,37,66,171
1715,4,1989,27,1,5,47,11,913,116,303,0.383,0,1,0,116,302,0.384,81,88,0.92,75,166,241,35,18,18,67,126,313
1715,4,1989,27,1,5,75,13,1411,175,432,0.405,0,2,0,175,430,0.407,134,152,0.882,124,254,378,67,33,23,104,192,484
1715,5,1990,28,1,5,81,4,1365,176,367,0.48,0,4,0,176,363,0.485,83,100,0.83,117,238,355,46,15,27,64,170,435
1715,6,1991,29,1,5,72,1,850,102,218,0.468,0,2,0,102,216,0.472,54,69,0.783,71,173,244,21,15,14,53,108,258
1715,7,1992,30,1,5,70,3,991,144,293,0.491,4,8,0.5,140,285,0.491,34,48,0.708,94,202,296,32,23,14,27,99,326
1715,8,1993,31,1,5,78,3,1129,108,267,0.404,0,6,0,108,261,0.414,41,58,0.707,113,233,346,39,17,17,37,123,257
1715,9,1994,32,1,5,74,4,848,125,256,0.488,5,11,0.455,120,245,0.49,30,39,0.769,50,143,193,45,14,19,35,118,285
1715,10,1995,33,1,5,75,42,968,119,265,0.449,0,2,0,119,263,0.452,42,49,0.857,82,177,259,39,14,18,35,174,280
1715,11,1996,34,1,5,56,9,663,71,169,0.42,2,7,0.286,69,162,0.426,20,25,0.8,36,96,132,44,13,6,37,113,164
1715,12,1997,35,1,5,23,10,365,32,80,0.4,1,1,1,31,79,0.392,13,18,0.722,21,59,80,12,9,6,20,47,78
1715,12,1997,35,1,5,28,0,453,35,82,0.427,1,2,0.5,34,80,0.425,13,18,0.722,39,75,114,23,8,12,21,57,84
1715,12,1997,35,1,5,59,10,848,69,170,0.406,2,3,0.667,67,167,0.401,28,38,0.737,62,141,203,35,17,18,41,110,168
1715,13,1998,36,1,5,46,1,397,39,106,0.368,0,0,-1,39,106,0.368,15,18,0.833,27,50,77,30,4,5,28,63,93
1715,14,1999,37,1,5,31,5,374,30,74,0.405,0,2,0,30,72,0.417,8,12,0.667,27,40,67,12,8,1,10,46,68
1718,1,1984,22,1,5,35,1,197,30,66,0.455,0,0,-1,30,66,0.455,5,16,0.313,27,35,62,7,1,5,20,42,65
1718,2,1985,23,1,5,55,4,424,33,88,0.375,0,0,-1,33,88,0.375,22,32,0.688,38,51,89,17,3,10,29,84,88
1718,3,1986,24,1,5,64,2,464,34,91,0.374,0,1,0,34,90,0.378,15,39,0.385,35,93,128,17,3,28,32,81,83
1718,4,1987,25,1,5,74,1,745,47,110,0.427,0,1,0,47,109,0.431,29,76,0.382,61,108,169,27,17,46,34,148,123
1718,5,1988,26,1,5,40,19,977,83,182,0.456,0,1,0,83,181,0.459,39,73,0.534,75,165,240,45,16,50,64,137,205
1718,5,1988,26,1,5,53,19,1063,92,205,0.449,0,1,0,92,204,0.451,40,79,0.506,85,179,264,47,19,58,73,153,224
1718,6,1989,27,1,5,12,12,213,16,30,0.533,0,0,-1,16,30,0.533,6,10,0.6,15,38,53,7,4,8,12,43,38
1718,6,1989,27,1,5,58,12,729,49,121,0.405,0,0,-1,49,121,0.405,14,31,0.452,66,124,190,29,23,46,46,118,112
1718,6,1989,27,1,5,70,24,942,65,151,0.43,0,0,-1,65,151,0.43,20,41,0.488,81,162,243,36,27,54,58,161,150
1718,7,1990,28,1,5,71,47,1515,101,234,0.432,1,1,1,100,233,0.429,27,54,0.5,131,246,377,76,31,51,76,201,230
1718,8,1991,29,1,5,82,82,2225,166,338,0.491,0,0,-1,166,338,0.491,63,123,0.512,189,399,588,59,25,81,102,298,395
1718,9,1992,30,1,5,72,44,1479,94,215,0.437,0,1,0,94,214,0.439,40,68,0.588,156,246,402,44,30,57,61,212,228
1718,10,1993,31,1,5,64,1,640,38,84,0.452,0,1,0,38,83,0.458,13,24,0.542,66,127,193,10,13,12,35,133,89
1718,11,1994,32,1,5,29,0,309,13,35,0.371,0,0,-1,13,35,0.371,8,22,0.364,22,48,70,4,2,12,17,61,34
1720,1,1980,27,1,3,75,-1,1910,385,722,0.533,4,15,0.267,381,707,0.539,212,262,0.809,136,225,361,155,82,9,132,96,986
1720,2,1981,28,1,2,82,-1,2385,546,1025,0.533,3,19,0.158,543,1006,0.54,341,410,0.832,191,219,410,157,84,12,177,155,1436
1720,3,1982,29,1,3,81,19,1803,378,764,0.495,9,32,0.281,369,732,0.504,233,282,0.826,97,160,257,118,63,14,137,132,998
1720,4,1983,30,1,2,80,54,2262,512,984,0.52,3,19,0.158,509,965,0.527,343,408,0.841,152,172,324,192,66,8,193,143,1370
1720,5,1984,31,1,3,75,39,1885,358,729,0.491,4,14,0.286,354,715,0.495,243,283,0.859,89,166,255,160,54,6,155,122,963
1720,6,1985,32,1,2,16,0,189,31,69,0.449,1,1,1,30,68,0.441,13,16,0.813,10,12,22,21,2,1,13,14,76
1720,6,1985,32,1,3,52,1,611,125,285,0.439,10,24,0.417,115,261,0.441,51,57,0.895,40,56,96,59,14,1,57,48,311
1720,6,1985,32,1,3,68,1,800,156,354,0.441,11,25,0.44,145,329,0.441,64,73,0.877,50,68,118,80,16,2,70,62,387
1722,1,1998,22,1,1,80,76,2483,261,592,0.441,0,7,0,261,585,0.446,201,251,0.801,67,186,253,656,196,18,194,271,723
1722,2,1999,23,1,1,39,38,1186,134,315,0.425,0,5,0,134,310,0.432,105,141,0.745,16,115,131,302,70,7,105,115,373
1722,3,2000,24,1,1,65,46,1754,230,558,0.412,2,10,0.2,228,548,0.416,140,184,0.761,38,155,193,458,107,21,157,185,602
1722,4,2001,25,1,1,47,43,1364,137,356,0.385,1,10,0.1,136,346,0.393,49,60,0.817,22,139,161,286,95,3,84,138,324
1722,4,2001,25,1,1,53,43,1457,139,371,0.375,1,10,0.1,138,361,0.382,54,66,0.818,23,145,168,311,101,4,91,155,333
1722,5,2002,26,1,1,53,11,1151,141,334,0.422,2,8,0.25,139,326,0.426,87,115,0.757,11,98,109,302,79,7,111,135,371
1722,6,2003,27,1,1,55,4,928,97,228,0.425,2,8,0.25,95,220,0.432,20,37,0.541,15,66,81,233,69,2,94,123,216
1722,7,2004,28,1,1,21,1,420,46,105,0.438,1,3,0.333,45,102,0.441,30,38,0.789,3,45,48,98,29,0,25,56,123
1722,7,2004,28,1,1,32,12,598,58,138,0.42,1,5,0.2,57,133,0.429,19,27,0.704,11,50,61,102,52,0,44,50,136
1722,7,2004,28,1,1,56,13,1037,105,246,0.427,2,8,0.25,103,238,0.433,49,65,0.754,14,98,112,204,84,1,72,107,261
1722,8,2005,29,1,1,66,61,1944,248,587,0.422,3,20,0.15,245,567,0.432,167,196,0.852,21,149,170,591,131,5,147,192,666
1722,9,2006,30,1,1,69,67,2351,308,772,0.399,3,13,0.231,305,759,0.402,252,314,0.803,35,188,223,610,157,4,164,202,871
1722,10,2007,31,1,1,45,25,1273,152,363,0.419,1,18,0.056,151,345,0.438,103,128,0.805,14,101,115,296,67,3,95,113,408
1722,11,2008,32,1,1,74,39,1674,138,342,0.404,0,6,0,138,336,0.411,62,71,0.873,15,127,142,328,100,11,71,160,338
1722,12,2009,33,1,1,74,0,938,66,189,0.349,0,6,0,66,183,0.361,48,64,0.75,13,75,88,190,68,4,66,98,180
1724,1,1997,22,1,5,71,14,1156,140,275,0.509,0,0,-1,140,275,0.509,62,100,0.62,130,189,319,39,31,58,49,170,342
1724,2,1998,23,1,5,74,21,1503,193,438,0.441,15,55,0.273,178,383,0.465,81,103,0.786,146,219,365,104,54,82,87,253,482
1724,3,1999,24,1,5,37,23,525,67,130,0.515,0,1,0,67,129,0.519,22,29,0.759,34,94,128,31,21,27,35,108,156
1724,4,2000,25,1,5,63,0,410,46,118,0.39,0,0,-1,46,118,0.39,17,28,0.607,46,83,129,23,6,23,26,88,109
1724,5,2001,26,1,5,45,0,256,10,53,0.189,0,1,0,10,52,0.192,9,18,0.5,19,34,53,5,5,11,10,47,29
1724,6,2002,27,1,5,49,0,429,41,113,0.363,0,0,-1,41,113,0.363,16,21,0.762,48,56,104,8,11,10,27,95,98
1724,7,2003,28,1,5,32,0,287,25,65,0.385,0,1,0,25,64,0.391,10,13,0.769,18,44,62,14,8,9,10,44,60
1729,1,1990,23,1,4,57,0,438,42,114,0.368,5,20,0.25,37,94,0.394,24,39,0.615,25,46,71,21,14,3,23,54,113
1729,2,1991,24,1,4,32,0,157,23,62,0.371,5,18,0.278,18,44,0.409,7,13,0.538,10,14,24,9,5,1,11,28,58
1734,1,1986,22,1,5,82,15,1695,263,519,0.507,0,1,0,263,518,0.508,156,257,0.607,171,296,467,55,37,69,111,296,682
1734,2,1987,23,1,5,82,19,1684,169,352,0.48,0,1,0,169,351,0.481,125,191,0.654,153,340,493,31,52,76,92,262,463
1734,3,1988,24,1,5,49,22,1073,98,203,0.483,0,2,0,98,201,0.488,83,136,0.61,103,230,333,19,36,56,53,161,279
1734,4,1989,25,1,5,74,22,1531,141,269,0.524,0,3,0,141,266,0.53,63,114,0.553,147,306,453,56,54,98,60,238,345
1734,5,1990,26,1,5,54,28,977,78,127,0.614,0,1,0,78,126,0.619,42,79,0.532,58,168,226,23,38,34,47,182,198
1734,6,1991,27,1,5,77,61,1931,140,321,0.436,1,8,0.125,139,313,0.444,32,54,0.593,101,274,375,124,74,76,50,265,313
1734,7,1992,28,1,5,77,14,1489,111,284,0.391,0,12,0,111,272,0.408,19,29,0.655,62,199,261,132,50,67,54,207,241
1734,8,1993,29,1,5,78,65,1975,124,267,0.464,3,8,0.375,121,259,0.467,24,50,0.48,100,327,427,140,75,100,52,264,275
1734,9,1994,30,1,5,82,78,1823,159,369,0.431,0,3,0,159,366,0.434,24,36,0.667,83,282,365,102,63,125,44,236,342
1734,10,1995,31,1,5,62,20,943,77,187,0.412,12,36,0.333,65,151,0.43,13,24,0.542,23,161,184,52,36,46,20,137,179
1734,11,1996,32,1,5,67,35,1288,84,175,0.48,3,9,0.333,81,166,0.488,32,57,0.561,63,209,272,51,27,44,41,226,203
1735,1,1983,22,1,4,17,1,201,23,51,0.451,0,1,0,23,50,0.46,21,25,0.84,18,44,62,9,9,2,8,21,67
1735,2,1984,23,1,4,59,2,678,64,132,0.485,1,7,0.143,63,125,0.504,91,112,0.813,64,102,166,46,15,5,39,71,220
1735,3,1985,24,1,4,42,0,308,50,95,0.526,2,3,0.667,48,92,0.522,43,54,0.796,29,57,86,29,13,1,28,58,145
1736,1,2006,18,1,3,24,0,127,9,30,0.3,2,7,0.286,7,23,0.304,7,10,0.7,5,8,13,9,3,0,6,11,27
1744,1,1980,24,1,5,54,-1,711,67,143,0.469,0,1,0,67,142,0.472,56,70,0.8,49,102,151,75,26,5,51,104,190
1744,2,1981,25,1,4,82,-1,1065,136,258,0.527,0,1,0,136,257,0.529,63,91,0.692,77,155,232,88,35,17,67,132,335
1744,3,1982,26,1,4,56,0,549,55,133,0.414,0,0,-1,55,133,0.414,33,42,0.786,36,72,108,51,19,11,26,62,143
1744,4,1983,27,1,5,54,4,458,44,104,0.423,0,1,0,44,103,0.427,14,16,0.875,41,47,88,37,15,6,22,63,102
1749,1,1981,24,1,2,25,0,100,11,47,0.234,1,4,0.25,10,43,0.233,7,10,0.7,2,10,12,9,2,1,10,20,30
1752,1,2005,21,1,4,75,57,1965,281,570,0.493,0,2,0,281,568,0.495,185,255,0.725,161,240,401,77,32,63,112,280,747
1752,2,2006,22,1,4,80,80,2469,447,881,0.507,1,4,0.25,446,877,0.509,185,265,0.698,182,331,513,88,32,63,133,297,1080
1752,3,2007,23,1,5,26,26,848,170,323,0.526,0,1,0,170,322,0.528,86,121,0.711,51,125,176,46,10,24,52,88,426
1752,4,2008,24,1,5,45,38,812,123,300,0.41,0,2,0,123,298,0.413,52,69,0.754,35,165,200,27,9,17,41,111,298
1752,5,2009,25,1,5,46,29,1141,191,407,0.469,0,0,-1,191,407,0.469,63,79,0.797,85,168,253,29,21,49,45,114,445
1752,6,2010,26,1,5,76,76,1741,281,560,0.502,1,5,0.2,280,555,0.505,76,106,0.717,134,249,383,52,32,45,58,177,639
1752,7,2011,27,1,5,24,20,553,79,147,0.537,0,0,-1,79,147,0.537,60,80,0.75,47,81,128,8,8,8,23,77,218
1752,7,2011,27,1,5,47,47,1018,152,305,0.498,0,0,-1,152,305,0.498,53,66,0.803,77,130,207,19,18,17,33,107,357
1752,7,2011,27,1,5,71,67,1571,231,452,0.511,0,0,-1,231,452,0.511,113,146,0.774,124,211,335,27,26,25,56,184,575
1755,1,1984,22,1,4,15,2,119,10,37,0.27,0,0,-1,10,37,0.27,8,12,0.667,7,16,23,8,1,1,15,18,28
1756,1,1980,28,1,5,18,-1,302,50,114,0.439,0,0,-1,50,114,0.439,26,43,0.605,37,75,112,29,7,22,41,59,126
1756,2,1981,29,1,5,55,-1,842,101,216,0.468,0,0,-1,101,216,0.468,42,54,0.778,98,189,287,67,17,32,50,143,244
1756,3,1982,30,1,5,21,0,237,20,48,0.417,0,0,-1,20,48,0.417,9,17,0.529,20,46,66,18,3,6,18,51,49
1759,1,1980,24,1,1,24,-1,100,12,34,0.353,0,1,0,12,33,0.364,5,7,0.714,3,11,14,16,7,1,5,8,29
1761,1,1994,25,1,3,75,8,1808,313,726,0.431,32,118,0.271,281,608,0.462,156,210,0.743,98,199,297,252,81,33,167,122,814
1761,2,1995,26,1,3,81,55,2584,487,967,0.504,62,198,0.313,425,769,0.553,235,314,0.748,155,285,440,372,102,16,165,163,1271
1761,3,1996,27,1,3,81,20,2103,386,787,0.49,87,216,0.403,299,571,0.524,206,267,0.772,115,208,323,287,64,28,114,150,1065
1761,4,1997,28,1,3,57,15,1610,285,605,0.471,50,151,0.331,235,454,0.518,134,174,0.77,94,167,261,256,60,29,91,97,754
1761,5,1998,29,1,3,74,52,2235,383,841,0.455,63,174,0.362,320,667,0.48,155,219,0.708,121,206,327,314,76,37,154,149,984
1761,6,1999,30,1,3,44,44,1654,315,750,0.42,39,137,0.285,276,613,0.45,159,215,0.74,65,245,310,235,49,11,121,82,828
1761,7,2000,31,1,3,24,23,868,148,388,0.381,18,78,0.231,130,310,0.419,118,155,0.761,37,93,130,124,44,19,75,51,432
1761,7,2000,31,1,3,32,8,916,149,340,0.438,26,90,0.289,123,250,0.492,74,110,0.673,38,105,143,141,33,9,71,61,398
1761,7,2000,31,1,3,56,31,1784,297,728,0.408,44,168,0.262,253,560,0.452,192,265,0.725,75,198,273,265,77,28,146,112,830
1761,8,2001,32,1,3,17,14,618,124,252,0.492,38,79,0.481,86,173,0.497,49,72,0.681,19,78,97,106,13,5,51,36,335
1761,8,2001,32,1,3,48,5,979,151,330,0.458,32,78,0.41,119,252,0.472,52,88,0.591,47,115,162,93,35,6,60,62,386
1761,8,2001,32,1,3,65,19,1597,275,582,0.473,70,157,0.446,205,425,0.482,101,160,0.631,66,193,259,199,48,11,111,98,721
1761,9,2002,33,1,3,59,9,1494,211,504,0.419,53,171,0.31,158,333,0.474,109,153,0.712,43,175,218,210,48,17,113,91,584
1761,10,2003,34,1,4,63,0,1704,249,577,0.432,95,263,0.361,154,314,0.49,137,194,0.706,67,199,266,230,81,29,122,134,730
1761,11,2004,35,1,4,73,0,1522,211,506,0.417,49,168,0.292,162,338,0.479,145,199,0.729,60,211,271,200,59,21,110,110,616
1761,12,2005,36,1,3,53,6,1099,105,256,0.41,42,116,0.362,63,140,0.45,44,61,0.721,31,129,160,160,39,13,64,70,296
1761,13,2006,37,1,4,65,0,1018,116,298,0.389,45,147,0.306,71,151,0.47,40,56,0.714,26,124,150,139,33,17,66,87,317
1763,1,2009,23,1,3,40,5,442,51,131,0.389,15,38,0.395,36,93,0.387,40,50,0.8,33,48,81,20,14,19,16,78,157
1767,1,1998,24,1,1,68,53,2042,310,791,0.392,21,81,0.259,289,710,0.407,149,183,0.814,78,224,302,317,105,11,184,160,790
1767,2,1999,25,1,1,50,12,941,141,348,0.405,10,27,0.37,131,321,0.408,61,79,0.772,43,92,135,167,39,3,75,75,353
1767,3,2000,26,1,1,73,10,1034,140,346,0.405,13,46,0.283,127,300,0.423,76,98,0.776,50,103,153,172,48,7,58,114,369
1767,4,2001,27,1,1,79,7,1648,231,526,0.439,39,104,0.375,192,422,0.455,65,88,0.739,74,172,246,161,87,7,103,139,566
1767,5,2002,28,1,1,81,3,1750,334,754,0.443,79,219,0.361,255,535,0.477,149,184,0.81,82,169,251,164,73,11,93,145,896
1767,6,2003,29,1,1,59,26,1676,340,732,0.464,89,235,0.379,251,497,0.505,126,149,0.846,57,162,219,182,71,3,106,126,895
1767,7,2004,30,1,2,50,0,1185,263,592,0.444,81,219,0.37,182,373,0.488,82,109,0.752,55,119,174,105,49,8,63,106,689
1767,8,2005,31,1,2,25,0,536,109,255,0.427,33,96,0.344,76,159,0.478,50,58,0.862,23,62,85,59,14,2,28,58,301
1767,9,2006,32,1,1,71,15,1775,286,748,0.382,129,332,0.389,157,416,0.377,107,146,0.733,44,179,223,195,61,1,101,155,808
1767,10,2007,33,1,2,56,2,1330,204,518,0.394,54,165,0.327,150,353,0.425,130,168,0.774,42,136,178,141,50,6,78,98,592
1767,11,2008,34,1,1,26,5,498,88,210,0.419,28,82,0.341,60,128,0.469,24,32,0.75,10,61,71,63,13,2,28,37,228
1767,11,2008,34,1,2,46,0,891,116,296,0.392,53,144,0.368,63,152,0.414,40,49,0.816,23,87,110,76,32,3,31,59,325
1767,11,2008,34,1,2,72,5,1389,204,506,0.403,81,226,0.358,123,280,0.439,64,81,0.79,33,148,181,139,45,5,59,96,553
1767,12,2009,35,1,1,71,10,1484,193,485,0.398,60,197,0.305,133,288,0.462,86,101,0.851,42,158,200,143,62,4,66,100,532
1770,1,1993,22,1,3,28,28,938,184,466,0.395,21,73,0.288,163,393,0.415,68,92,0.739,42,80,122,131,40,11,115,80,457
1770,2,1994,23,1,2,82,82,3066,637,1432,0.445,17,60,0.283,620,1372,0.452,285,347,0.821,169,219,388,374,87,25,334,161,1576
1770,3,1995,24,1,2,51,51,1982,484,1026,0.472,35,110,0.318,449,916,0.49,306,380,0.805,120,140,260,191,28,12,160,92,1309
1770,4,1996,25,1,2,82,82,2820,569,1308,0.435,121,333,0.363,448,975,0.459,345,418,0.825,173,237,410,235,47,22,191,165,1604
1770,5,1997,26,1,3,31,31,1155,184,441,0.417,40,108,0.37,144,333,0.432,104,122,0.852,51,133,184,160,29,17,101,81,512
1770,5,1997,26,1,2,46,46,1676,260,588,0.442,46,139,0.331,214,449,0.477,148,188,0.787,81,146,227,156,57,15,107,113,714
1770,5,1997,26,1,2,77,77,2831,444,1029,0.431,86,247,0.348,358,782,0.458,252,310,0.813,132,279,411,316,86,32,208,194,1226
1770,6,1998,27,1,2,31,31,1258,230,572,0.402,22,79,0.278,208,493,0.422,103,128,0.805,61,112,173,158,38,2,118,74,585
1770,6,1998,27,1,2,48,47,1788,246,535,0.46,39,112,0.348,207,423,0.489,126,154,0.818,69,158,227,223,41,6,145,112,657
1770,6,1998,27,1,2,79,78,3046,476,1107,0.43,61,191,0.319,415,916,0.453,229,282,0.812,130,270,400,381,79,8,263,186,1242
1770,7,1999,28,1,2,49,9,1175,152,370,0.411,25,90,0.278,127,280,0.454,85,101,0.842,36,123,159,128,43,6,82,80,414
1770,8,2000,29,1,3,79,76,2767,507,1235,0.411,117,303,0.386,390,932,0.418,186,212,0.877,101,293,394,230,57,10,185,167,1317
1770,9,2001,30,1,3,17,14,550,77,217,0.355,16,38,0.421,61,179,0.341,73,85,0.859,17,62,79,50,19,4,48,42,243
1770,9,2001,30,1,3,39,26,1140,162,415,0.39,10,42,0.238,152,373,0.408,66,84,0.786,36,109,145,113,34,6,82,97,400
1770,9,2001,30,1,3,56,40,1690,239,632,0.378,26,80,0.325,213,552,0.386,139,169,0.822,53,171,224,163,53,10,130,139,643
1770,10,2002,31,1,3,55,19,1825,238,538,0.442,38,81,0.469,200,457,0.438,75,87,0.862,54,236,290,140,42,14,106,145,589
1770,11,2003,32,1,3,63,0,1309,204,462,0.442,32,71,0.451,172,391,0.44,47,55,0.855,84,178,262,118,31,4,80,132,487
1770,12,2004,33,1,3,80,80,3119,382,900,0.424,162,405,0.4,220,495,0.444,107,127,0.843,52,435,487,226,86,23,175,227,1033
1770,13,2005,34,1,3,24,24,990,118,283,0.417,54,147,0.367,64,136,0.471,30,33,0.909,10,105,115,86,23,1,56,67,320
1770,13,2005,34,1,3,40,3,997,130,299,0.435,68,148,0.459,62,151,0.411,24,25,0.96,23,131,154,97,12,4,59,86,352
1770,13,2005,34,1,3,64,27,1987,248,582,0.426,122,295,0.414,126,287,0.439,54,58,0.931,33,236,269,183,35,5,115,153,672
1770,14,2006,35,1,3,27,1,420,38,129,0.295,14,63,0.222,24,66,0.364,9,13,0.692,11,53,64,31,10,6,30,46,99
1770,14,2006,35,1,3,40,1,512,47,160,0.294,18,74,0.243,29,86,0.337,9,13,0.692,11,65,76,35,12,6,35,51,121
1772,1,1988,23,1,1,58,0,760,64,171,0.374,6,25,0.24,58,146,0.397,23,32,0.719,17,42,59,179,20,5,58,81,157
1775,1,2006,24,1,3,36,0,315,29,85,0.341,12,36,0.333,17,49,0.347,26,33,0.788,16,24,40,25,11,2,31,30,96
1775,2,2007,25,1,3,10,2,122,18,35,0.514,4,13,0.308,14,22,0.636,5,9,0.556,2,7,9,9,5,1,6,12,45
1775,2,2007,25,1,3,13,2,138,19,43,0.442,5,17,0.294,14,26,0.538,5,9,0.556,2,8,10,13,5,1,7,15,48
1775,3,2008,26,1,3,14,1,228,26,80,0.325,11,30,0.367,15,50,0.3,16,23,0.696,7,26,33,17,8,0,9,22,79
1776,1,2001,26,1,5,48,35,1410,237,508,0.467,5,23,0.217,232,485,0.478,154,192,0.802,119,242,361,59,34,27,93,138,633
1776,2,2002,27,1,5,17,0,169,22,65,0.338,0,0,-1,22,65,0.338,40,48,0.833,17,26,43,7,5,3,12,25,84
1776,2,2002,27,1,5,22,0,326,38,99,0.384,0,1,0,38,98,0.388,26,32,0.813,31,54,85,7,6,3,18,44,102
1776,2,2002,27,1,5,39,0,495,60,164,0.366,0,1,0,60,163,0.368,66,80,0.825,48,80,128,14,11,6,30,69,186
1776,3,2003,28,1,5,77,0,1041,153,349,0.438,1,1,1,152,348,0.437,114,149,0.765,86,139,225,37,24,30,59,137,421
1776,4,2004,29,1,4,22,13,598,71,171,0.415,0,1,0,71,170,0.418,64,81,0.79,45,81,126,18,12,6,24,45,206
1776,5,2005,30,1,5,81,23,1976,340,731,0.465,0,2,0,340,729,0.466,289,349,0.828,184,222,406,81,32,18,131,171,969
1776,6,2006,31,1,5,37,0,433,66,148,0.446,0,0,-1,66,148,0.446,38,48,0.792,30,59,89,22,5,6,28,70,170
1776,6,2006,31,1,5,27,10,594,108,221,0.489,1,2,0.5,107,219,0.489,28,34,0.824,56,72,128,22,8,2,37,56,245
1776,6,2006,31,1,5,64,10,1027,174,369,0.472,1,2,0.5,173,367,0.471,66,82,0.805,86,131,217,44,13,8,65,126,415
1776,7,2007,32,1,4,56,25,1025,159,388,0.41,0,1,0,159,387,0.411,90,103,0.874,62,130,192,58,21,7,65,89,408
1777,1,1988,22,1,1,82,80,3249,438,1013,0.432,32,126,0.254,406,887,0.458,206,266,0.774,120,276,396,868,205,6,258,244,1114
1777,2,1989,23,1,1,72,72,2477,479,1025,0.467,81,240,0.338,398,785,0.507,180,258,0.698,106,235,341,619,139,7,226,163,1219
1777,3,1990,24,1,1,82,69,2428,327,749,0.437,35,131,0.267,292,618,0.472,120,165,0.727,106,212,318,604,109,4,211,121,809
1777,4,1991,25,1,1,72,21,1595,250,508,0.492,13,51,0.255,237,457,0.519,117,160,0.731,62,135,197,452,60,9,135,81,630
1777,5,1992,26,1,1,81,81,2461,367,747,0.491,11,43,0.256,356,704,0.506,171,222,0.77,95,210,305,694,112,13,211,153,916
1777,6,1993,27,1,1,82,81,3117,459,945,0.486,22,82,0.268,437,863,0.506,241,300,0.803,129,259,388,724,136,12,220,158,1181
1777,7,1994,28,1,1,79,79,2711,331,732,0.452,36,127,0.283,295,605,0.488,167,211,0.791,107,241,348,678,120,6,232,115,865
1777,8,1995,29,1,1,82,67,2402,239,566,0.422,27,87,0.31,212,479,0.443,119,153,0.778,73,233,306,616,105,16,210,148,624
1777,9,1996,30,1,1,81,81,2643,296,626,0.473,64,149,0.43,232,477,0.486,150,191,0.785,66,241,307,635,100,5,201,153,806
1777,10,1997,31,1,1,30,30,1053,97,227,0.427,18,57,0.316,79,170,0.465,59,77,0.766,20,104,124,294,46,3,102,57,271
1777,10,1997,31,1,1,52,52,2001,192,452,0.425,48,121,0.397,144,331,0.435,109,136,0.801,71,200,271,641,51,9,172,104,541
1777,10,1997,31,1,1,82,82,3054,289,679,0.426,66,178,0.371,223,501,0.445,168,213,0.789,91,304,395,935,97,12,274,161,812
1777,11,1998,32,1,1,82,82,2413,249,598,0.416,43,137,0.314,206,461,0.447,137,180,0.761,67,255,322,713,84,2,174,132,678
1777,12,1999,33,1,1,49,49,1382,138,329,0.419,32,103,0.311,106,226,0.469,65,79,0.823,33,151,184,386,42,3,99,58,373
1777,13,2000,34,1,1,81,81,2190,246,570,0.432,89,221,0.403,157,349,0.45,79,98,0.806,63,233,296,650,76,10,174,111,660
1777,14,2001,35,1,1,29,28,786,74,180,0.411,13,42,0.31,61,138,0.442,9,17,0.529,21,99,120,163,21,0,58,56,170
1777,14,2001,35,1,1,54,54,1802,170,403,0.422,57,165,0.345,113,238,0.475,64,76,0.842,42,143,185,498,63,7,117,83,461
1777,14,2001,35,1,1,83,82,2588,244,583,0.419,70,207,0.338,174,376,0.463,73,93,0.785,63,242,305,661,84,7,175,139,631
1777,15,2002,36,1,1,82,82,2367,260,592,0.439,79,195,0.405,181,397,0.456,87,110,0.791,56,253,309,605,74,1,150,162,686
1777,16,2003,37,1,1,82,0,1467,147,369,0.398,27,95,0.284,120,274,0.438,61,80,0.763,34,142,176,375,48,3,152,90,382
1777,17,2004,38,1,1,42,3,577,34,100,0.34,7,41,0.171,27,59,0.458,28,39,0.718,10,60,70,119,17,1,53,41,103
1781,1,1999,23,1,4,27,8,271,46,108,0.426,1,7,0.143,45,101,0.446,21,32,0.656,30,24,54,8,3,11,26,29,114
1786,1,1982,22,1,2,38,0,412,69,146,0.473,0,0,-1,69,146,0.473,32,39,0.821,28,23,51,22,11,3,18,43,170
1786,1,1982,22,1,2,49,0,478,79,172,0.459,0,0,-1,79,172,0.459,38,49,0.776,35,28,63,27,14,3,24,48,196
1786,2,1983,23,1,2,78,3,1309,199,426,0.467,2,13,0.154,197,413,0.477,92,126,0.73,87,92,179,105,64,11,83,132,492
1787,1,2000,24,1,1,49,5,663,103,203,0.507,9,24,0.375,94,179,0.525,30,39,0.769,25,45,70,30,29,3,31,112,245
1787,1,2000,24,1,1,52,5,681,108,212,0.509,9,24,0.375,99,188,0.527,30,41,0.732,25,46,71,32,30,3,33,113,255
1791,1,2001,24,1,3,30,0,197,16,52,0.308,1,3,0.333,15,49,0.306,12,14,0.857,15,20,35,8,2,5,8,27,45
1796,1,2010,23,1,5,39,2,412,49,111,0.441,0,1,0,49,110,0.445,26,38,0.684,49,55,104,24,10,9,27,58,124
1797,1,1980,25,1,3,77,-1,1286,288,565,0.51,0,6,0,288,559,0.515,161,204,0.789,114,156,270,95,40,40,117,155,737
1797,2,1981,26,1,3,66,-1,1108,187,440,0.425,0,1,0,187,439,0.426,179,220,0.814,83,147,230,65,44,31,87,123,553
1798,1,2006,29,1,1,75,15,1557,170,429,0.396,86,236,0.364,84,193,0.435,121,133,0.91,19,134,153,227,40,4,116,108,547
1798,2,2007,30,1,1,26,2,309,37,101,0.366,12,44,0.273,25,57,0.439,27,31,0.871,5,16,21,61,13,1,31,22,113
1798,2,2007,30,1,2,37,1,664,91,221,0.412,32,86,0.372,59,135,0.437,59,64,0.922,10,38,48,111,13,0,59,53,273
1798,2,2007,30,1,2,63,3,973,128,322,0.398,44,130,0.338,84,192,0.438,86,95,0.905,15,54,69,172,26,1,90,75,386
1799,1,2003,22,1,3,51,10,666,75,194,0.387,18,54,0.333,57,140,0.407,29,43,0.674,16,43,59,22,19,16,45,56,197
1799,2,2004,23,1,3,19,2,187,24,66,0.364,16,39,0.41,8,27,0.296,12,19,0.632,5,23,28,6,4,7,18,36,76
1799,2,2004,23,1,3,21,2,195,27,72,0.375,17,42,0.405,10,30,0.333,13,20,0.65,5,24,29,7,4,7,19,36,84
1801,1,2005,30,1,1,15,0,104,15,45,0.333,0,9,0,15,36,0.417,12,13,0.923,3,6,9,9,5,1,7,6,42
1802,1,1993,24,1,1,8,0,136,25,42,0.595,5,9,0.556,20,33,0.606,14,18,0.778,2,9,11,23,4,0,7,18,69
1802,2,1994,25,1,1,76,2,1097,138,342,0.404,56,151,0.371,82,191,0.429,100,120,0.833,16,73,89,218,65,0,74,62,432
1802,3,1995,26,1,1,80,24,1722,190,425,0.447,75,204,0.368,115,221,0.52,134,153,0.876,26,122,148,373,95,2,120,133,589
1803,1,1991,23,1,5,21,0,105,11,36,0.306,0,1,0,11,35,0.314,6,9,0.667,17,20,37,1,1,3,3,16,28
1804,1,2011,27,1,1,62,1,858,106,259,0.409,6,30,0.2,100,229,0.437,37,41,0.902,9,61,70,162,29,2,51,54,255
1806,1,2008,20,1,4,66,49,1647,219,520,0.421,6,21,0.286,213,499,0.427,122,145,0.841,106,238,344,55,36,56,90,153,566
1806,2,2009,21,1,4,61,52,1421,191,500,0.382,48,140,0.343,143,360,0.397,95,123,0.772,67,259,326,60,29,36,70,157,525
1806,3,2010,22,1,4,52,51,1655,227,563,0.403,15,41,0.366,212,522,0.406,154,193,0.798,115,257,372,47,37,52,77,170,623
1806,4,2011,23,1,4,63,11,1112,145,347,0.418,3,13,0.231,142,334,0.425,62,91,0.681,79,169,248,25,27,32,51,115,355
1806,5,2012,24,1,4,30,0,203,31,82,0.378,3,10,0.3,28,72,0.389,14,21,0.667,12,37,49,5,7,8,14,23,79
1807,1,2004,24,1,5,20,4,290,17,59,0.288,1,12,0.083,16,47,0.34,7,16,0.438,15,30,45,12,7,1,14,28,42
1808,1,2007,23,1,4,59,19,753,91,169,0.538,0,0,-1,91,169,0.538,78,118,0.661,50,131,181,17,25,35,47,137,260
1808,2,2008,24,1,4,43,6,549,61,125,0.488,0,0,-1,61,125,0.488,57,83,0.687,32,62,94,13,13,10,42,80,179
1810,1,1998,23,1,1,77,62,2266,226,609,0.371,42,128,0.328,184,481,0.383,80,110,0.727,51,120,171,329,64,6,120,188,574
1810,2,1999,24,1,1,49,2,885,91,225,0.404,5,19,0.263,86,206,0.417,57,82,0.695,16,59,75,107,35,7,65,67,244
1810,3,2000,25,1,1,18,4,214,26,61,0.426,1,5,0.2,25,56,0.446,9,15,0.6,6,6,12,13,10,2,8,17,62
1810,3,2000,25,1,1,38,2,423,36,103,0.35,1,6,0.167,35,97,0.361,19,24,0.792,15,24,39,59,23,2,24,41,92
1810,3,2000,25,1,1,56,6,637,62,164,0.378,2,11,0.182,60,153,0.392,28,39,0.718,21,30,51,72,33,4,32,58,154
1810,4,2001,26,1,1,28,0,232,27,81,0.333,1,2,0.5,26,79,0.329,11,16,0.688,7,14,21,44,6,1,14,21,66
1810,4,2001,26,1,1,25,0,279,26,71,0.366,0,3,0,26,68,0.382,12,17,0.706,3,20,23,34,17,5,20,41,64
1810,4,2001,26,1,1,53,0,511,53,152,0.349,1,5,0.2,52,147,0.354,23,33,0.697,10,34,44,78,23,6,34,62,130
1810,5,2002,27,1,2,34,0,366,37,90,0.411,4,12,0.333,33,78,0.423,16,25,0.64,10,19,29,48,31,1,20,30,94
1810,6,2003,28,1,1,66,2,842,103,231,0.446,13,35,0.371,90,196,0.459,51,74,0.689,13,65,78,86,37,5,41,93,270
1810,7,2004,29,1,1,73,7,1598,167,411,0.406,41,122,0.336,126,289,0.436,75,94,0.798,28,102,130,202,64,8,75,138,450
1810,8,2005,30,1,1,63,36,1747,203,456,0.445,41,108,0.38,162,348,0.466,85,113,0.752,32,147,179,302,59,15,96,144,532
1810,9,2006,31,1,1,75,53,1981,267,603,0.443,51,155,0.329,216,448,0.482,106,141,0.752,31,137,168,324,63,22,115,132,691
1810,10,2007,32,1,1,40,0,562,60,146,0.411,11,29,0.379,49,117,0.419,21,29,0.724,13,35,48,78,16,1,31,68,152
1810,10,2007,32,1,1,27,17,739,82,197,0.416,14,44,0.318,68,153,0.444,25,32,0.781,9,44,53,123,17,2,45,51,203
1810,10,2007,32,1,1,67,17,1301,142,343,0.414,25,73,0.342,117,270,0.433,46,61,0.754,22,79,101,201,33,3,76,119,355
1810,11,2008,33,1,1,27,11,410,40,88,0.455,15,30,0.5,25,58,0.431,9,11,0.818,5,34,39,60,10,1,34,29,104
1810,11,2008,33,1,1,42,41,1121,115,267,0.431,27,63,0.429,88,204,0.431,26,32,0.813,17,81,98,202,42,8,50,86,283
1810,11,2008,33,1,1,69,52,1531,155,355,0.437,42,93,0.452,113,262,0.431,35,43,0.814,22,115,137,262,52,9,84,115,387
1810,12,2009,34,1,1,80,12,1481,154,381,0.404,52,133,0.391,102,248,0.411,61,81,0.753,29,118,147,200,46,5,82,111,421
1810,13,2010,35,1,1,31,0,406,49,111,0.441,13,39,0.333,36,72,0.5,19,20,0.95,8,40,48,63,11,1,26,32,130
1814,1,1989,23,1,1,43,0,291,29,83,0.349,1,9,0.111,28,74,0.378,9,16,0.563,11,13,24,73,21,3,18,34,68
1814,2,1990,24,1,1,53,10,575,55,142,0.387,1,4,0.25,54,138,0.391,29,40,0.725,21,22,43,162,26,1,48,55,140
1814,3,1991,25,1,1,21,4,217,29,68,0.426,0,4,0,29,64,0.453,21,32,0.656,9,12,21,77,14,2,27,22,79
1814,3,1991,25,1,1,47,10,742,101,209,0.483,1,5,0.2,100,204,0.49,38,55,0.691,13,43,56,153,33,2,47,40,241
1814,3,1991,25,1,1,68,14,959,130,277,0.469,1,9,0.111,129,268,0.481,59,87,0.678,22,55,77,230,47,4,74,62,320
1814,4,1992,26,1,1,20,14,463,55,108,0.509,1,5,0.2,54,103,0.524,24,32,0.75,5,30,35,100,21,3,45,43,135
1814,4,1992,26,1,1,49,1,772,103,222,0.464,3,10,0.3,100,212,0.472,42,69,0.609,8,37,45,166,40,6,65,46,251
1814,4,1992,26,1,1,69,15,1235,158,330,0.479,4,15,0.267,154,315,0.489,66,101,0.653,13,67,80,266,61,9,110,89,386
1814,5,1993,27,1,1,75,49,2030,256,510,0.502,0,8,0,256,502,0.51,144,182,0.791,20,126,146,561,85,16,145,141,656
1814,6,1994,28,1,1,82,70,2332,356,724,0.492,0,12,0,356,712,0.5,178,253,0.704,41,135,176,433,113,8,172,160,890
1814,7,1995,29,1,1,82,82,3011,448,863,0.519,3,22,0.136,445,841,0.529,202,295,0.685,49,159,208,670,114,13,207,154,1101
1814,8,1996,30,1,1,82,82,3084,438,887,0.494,6,31,0.194,432,856,0.505,189,262,0.721,37,169,206,789,119,21,195,179,1071
1814,9,1997,31,1,1,76,76,2472,327,685,0.477,6,26,0.231,321,659,0.487,140,203,0.69,32,115,147,513,96,15,146,158,800
1814,10,1998,32,1,1,75,73,2674,321,671,0.478,2,13,0.154,319,658,0.485,122,168,0.726,30,120,150,591,84,18,165,140,766
1814,11,1999,33,1,1,50,50,1672,218,461,0.473,1,12,0.083,217,449,0.483,50,88,0.568,22,96,118,369,51,11,112,101,487
1814,12,2000,34,1,1,82,82,2571,402,850,0.473,1,9,0.111,401,841,0.477,114,155,0.735,33,125,158,491,76,18,140,150,919
1814,13,2001,35,1,1,55,20,1290,134,300,0.447,1,6,0.167,133,294,0.452,41,60,0.683,21,64,85,237,33,4,60,90,310
1814,14,2002,36,1,1,17,0,152,21,49,0.429,0,0,-1,21,49,0.429,12,17,0.706,0,5,5,28,5,1,9,17,54
1814,14,2002,36,1,1,51,13,1200,186,383,0.486,0,5,0,186,378,0.492,109,146,0.747,14,50,64,258,35,8,67,69,481
1814,14,2002,36,1,1,68,13,1352,207,432,0.479,0,5,0,207,427,0.485,121,163,0.742,14,55,69,286,40,9,76,86,535
1814,15,2003,37,1,1,48,0,430,63,150,0.42,0,2,0,63,148,0.426,30,39,0.769,10,21,31,64,15,1,29,26,156
1814,16,2004,38,1,1,46,1,637,80,199,0.402,0,3,0,80,196,0.408,52,78,0.667,3,30,33,111,26,3,51,34,212
1815,1,1987,23,1,3,60,3,520,94,201,0.468,0,1,0,94,200,0.47,40,58,0.69,38,50,88,40,17,15,37,81,228
1815,2,1988,24,1,3,70,2,879,155,298,0.52,1,8,0.125,154,290,0.531,67,91,0.736,77,91,168,49,30,26,54,127,378
1815,3,1989,25,1,3,67,51,1850,270,515,0.524,1,9,0.111,269,506,0.532,101,134,0.754,114,172,286,126,64,35,110,213,642
1815,4,1990,26,1,3,82,82,2832,504,1019,0.495,2,17,0.118,502,1002,0.501,205,270,0.759,113,268,381,252,104,62,167,321,1215
1815,5,1991,27,1,3,73,70,2279,416,873,0.477,2,15,0.133,414,858,0.483,157,216,0.727,108,222,330,142,81,47,122,240,991
1815,6,1992,28,1,3,80,69,2202,290,633,0.458,1,9,0.111,289,624,0.463,104,143,0.727,95,217,312,158,72,49,104,234,685
1815,7,1993,29,1,3,73,19,1287,193,403,0.479,0,3,0,193,400,0.483,92,126,0.73,78,117,195,89,36,18,70,187,478
1816,1,2012,29,1,1,15,0,119,11,35,0.314,4,15,0.267,7,20,0.35,1,3,0.333,1,8,9,22,8,0,7,11,27
1817,1,2011,21,1,1,38,0,277,46,101,0.455,5,12,0.417,41,89,0.461,13,22,0.591,11,25,36,45,5,1,38,31,110
1817,2,2012,22,1,1,8,0,119,19,42,0.452,1,3,0.333,18,39,0.462,6,6,1,1,11,12,11,4,0,5,9,45
1817,2,2012,22,1,1,9,0,124,20,43,0.465,1,3,0.333,19,40,0.475,6,6,1,1,12,13,11,5,0,6,9,47
1818,1,1983,26,1,2,48,0,447,53,135,0.393,0,2,0,53,133,0.398,38,48,0.792,40,29,69,24,22,4,25,62,144
1818,2,1984,27,1,2,25,0,176,20,50,0.4,1,1,1,19,49,0.388,14,22,0.636,6,6,12,14,8,2,12,24,55
1820,1,1993,22,1,2,42,0,356,57,149,0.383,3,14,0.214,54,135,0.4,40,59,0.678,18,30,48,13,8,1,28,23,157
1820,2,1994,23,1,2,17,0,119,17,54,0.315,0,1,0,17,53,0.321,13,21,0.619,9,7,16,4,4,0,9,7,47
1823,1,1980,23,1,5,79,-1,1541,199,396,0.503,0,0,-1,199,396,0.503,74,117,0.632,145,249,394,115,48,121,78,211,472
1823,2,1981,24,1,5,81,-1,1643,235,466,0.504,0,1,0,235,465,0.505,112,189,0.593,173,295,468,144,44,119,121,185,582
1823,3,1982,25,1,5,79,42,1979,312,641,0.487,0,0,-1,312,641,0.487,123,189,0.651,184,387,571,127,60,112,138,241,747
1823,4,1983,26,1,5,32,4,698,91,182,0.5,0,0,-1,91,182,0.5,34,58,0.586,75,130,205,24,16,29,36,84,216
1823,4,1983,26,1,5,51,7,1216,208,399,0.521,0,1,0,208,398,0.523,77,122,0.631,115,204,319,115,51,63,88,137,493
1823,4,1983,26,1,5,83,11,1914,299,581,0.515,0,1,0,299,580,0.516,111,180,0.617,190,334,524,139,67,92,124,221,709
1823,5,1984,27,1,5,80,10,1721,193,412,0.468,0,0,-1,193,412,0.468,69,113,0.611,131,267,398,55,35,65,95,205,455
1823,6,1985,28,1,5,58,0,875,117,235,0.498,0,1,0,117,234,0.5,36,49,0.735,92,129,221,33,15,44,43,112,270
1823,7,1986,29,1,5,75,2,1069,105,223,0.471,0,0,-1,105,223,0.471,51,81,0.63,106,149,255,15,23,62,38,129,261
1823,8,1987,30,1,5,78,7,1051,88,178,0.494,0,2,0,88,176,0.5,70,110,0.636,106,171,277,21,21,42,36,137,246
1823,9,1988,31,1,5,74,26,723,49,105,0.467,0,0,-1,49,105,0.467,22,32,0.688,66,108,174,17,13,24,29,104,120
1824,1,1980,25,1,2,81,-1,2937,574,1361,0.422,12,58,0.207,562,1303,0.431,380,487,0.78,173,241,414,332,144,82,227,267,1540
1824,2,1981,26,1,1,79,-1,2615,532,1220,0.436,11,51,0.216,521,1169,0.446,411,501,0.82,160,203,363,291,136,61,208,244,1486
1824,3,1982,27,1,2,80,77,2937,577,1228,0.47,8,42,0.19,569,1186,0.48,399,495,0.806,142,268,410,369,105,55,233,253,1561
1824,4,1983,28,1,1,77,74,2551,398,861,0.462,5,31,0.161,393,830,0.473,292,369,0.791,92,243,335,388,97,39,204,204,1093
1824,5,1984,29,1,2,80,78,2665,384,878,0.437,4,32,0.125,380,846,0.449,281,330,0.852,87,193,280,338,93,57,172,251,1053
1824,6,1985,30,1,1,80,77,2976,493,1066,0.462,7,26,0.269,486,1040,0.467,261,306,0.853,91,226,317,543,96,39,212,224,1254
1824,7,1986,31,1,1,78,78,2732,482,1060,0.455,6,42,0.143,476,1018,0.468,243,297,0.818,69,199,268,456,110,35,173,206,1213
1824,8,1987,32,1,1,79,78,2933,423,953,0.444,7,62,0.113,416,891,0.467,209,251,0.833,45,216,261,594,87,38,177,201,1062
1824,9,1988,33,1,1,77,74,2670,352,803,0.438,12,46,0.261,340,757,0.449,255,298,0.856,62,178,240,598,93,29,195,204,971
1824,10,1989,34,1,1,72,72,2309,277,638,0.434,7,50,0.14,270,588,0.459,160,195,0.821,31,159,190,472,94,21,175,211,721
1824,11,1990,35,1,1,75,65,2036,206,475,0.434,1,24,0.042,205,451,0.455,118,140,0.843,48,153,201,485,81,14,117,179,531
1825,1,1980,24,1,2,79,-1,2622,590,1212,0.487,5,13,0.385,585,1199,0.488,280,338,0.828,95,105,200,370,120,24,189,216,1465
1825,2,1981,25,1,2,75,-1,2693,573,1136,0.504,6,20,0.3,567,1116,0.508,279,356,0.784,60,119,179,407,126,11,197,188,1431
1825,3,1982,26,1,2,68,57,2314,455,1011,0.45,7,30,0.233,448,981,0.457,294,385,0.764,63,128,191,358,102,16,186,188,1211
1825,4,1983,27,1,2,61,57,1813,389,858,0.453,14,41,0.341,375,817,0.459,186,237,0.785,26,98,124,318,61,6,156,138,978
1825,5,1984,28,1,2,67,43,1893,353,798,0.442,16,43,0.372,337,755,0.446,164,213,0.77,31,115,146,374,58,7,173,155,886
1825,6,1985,29,1,2,73,66,2367,453,946,0.479,22,72,0.306,431,874,0.493,265,332,0.798,38,154,192,566,43,7,244,184,1193
1825,7,1986,30,1,2,32,4,615,129,293,0.44,24,65,0.369,105,228,0.461,33,45,0.733,13,33,46,114,8,1,60,56,315
1825,7,1986,30,1,2,39,5,862,155,328,0.473,5,20,0.25,150,308,0.487,79,110,0.718,17,58,75,219,10,1,90,72,394
1825,7,1986,30,1,2,71,9,1477,284,621,0.457,29,85,0.341,255,536,0.476,112,155,0.723,30,91,121,333,18,2,150,128,709
1825,8,1987,31,1,2,24,0,508,85,186,0.457,5,15,0.333,80,171,0.468,42,55,0.764,11,35,46,115,12,1,41,36,217
1826,1,1990,23,1,1,48,2,272,20,84,0.238,1,6,0.167,19,78,0.244,13,17,0.765,8,20,28,64,17,2,26,49,54
1827,1,1994,26,1,5,45,3,280,44,106,0.415,0,0,-1,44,106,0.415,29,46,0.63,48,70,118,7,10,22,24,45,117
1827,2,1995,27,1,5,64,30,907,85,192,0.443,0,1,0,85,191,0.445,29,46,0.63,101,188,289,16,17,67,54,163,199
1827,3,1996,28,1,5,81,60,1519,180,352,0.511,1,3,0.333,179,349,0.513,85,127,0.669,129,304,433,48,40,129,98,245,446
1827,4,1997,29,1,5,82,82,2599,243,467,0.52,0,2,0,243,465,0.523,96,156,0.615,231,682,913,71,65,227,118,288,582
1827,5,1998,30,1,5,81,81,2261,253,471,0.537,0,0,-1,253,471,0.537,143,238,0.601,242,443,685,59,79,158,117,321,649
1827,6,1999,31,1,5,50,7,1027,96,189,0.508,0,0,-1,96,189,0.508,64,105,0.61,120,200,320,19,29,57,47,151,256
1827,7,2000,32,1,5,80,74,2129,144,279,0.516,0,1,0,144,278,0.518,95,157,0.605,233,415,648,44,81,127,80,298,383
1827,8,2001,33,1,5,82,19,1981,108,198,0.545,0,0,-1,108,198,0.545,50,93,0.538,205,408,613,40,44,97,47,257,266
1827,9,2002,34,1,5,81,9,1660,89,193,0.461,0,1,0,89,192,0.464,30,66,0.455,142,324,466,27,37,82,52,219,208
1827,10,2003,35,1,5,69,17,1170,61,135,0.452,0,0,-1,61,135,0.452,30,44,0.682,117,177,294,24,34,63,34,178,152
1827,11,2004,36,1,5,66,47,965,55,103,0.534,0,1,0,55,102,0.539,17,28,0.607,61,171,232,24,27,43,30,156,127
1827,12,2005,37,1,5,46,23,410,28,54,0.519,1,1,1,27,53,0.509,16,25,0.64,43,70,113,6,7,13,18,86,73
1829,1,1980,23,1,4,75,-1,1938,309,649,0.476,2,9,0.222,307,640,0.48,148,189,0.783,190,394,584,157,84,67,148,260,768
1829,2,1981,24,1,4,43,-1,930,182,394,0.462,0,5,0,182,389,0.468,93,122,0.762,99,179,278,86,47,23,85,120,457
1829,3,1982,25,1,4,59,4,720,120,291,0.412,0,2,0,120,289,0.415,60,80,0.75,72,145,217,40,36,25,68,147,300
1829,4,1983,26,1,3,82,64,2297,409,858,0.477,7,38,0.184,402,820,0.49,126,172,0.733,176,369,545,220,77,53,242,279,951
1829,5,1984,27,1,3,81,20,2073,411,884,0.465,11,47,0.234,400,837,0.478,223,270,0.826,139,321,460,195,82,49,186,256,1056
1829,6,1985,28,1,3,55,3,756,107,263,0.407,1,10,0.1,106,253,0.419,49,56,0.875,48,116,164,38,31,16,49,99,264
1832,1,2012,22,1,4,36,0,298,54,121,0.446,0,0,-1,54,121,0.446,6,9,0.667,20,38,58,6,5,14,14,25,114
1833,1,1980,32,1,3,81,-1,2533,377,772,0.488,0,0,-1,377,772,0.488,161,201,0.801,163,263,426,424,76,35,247,213,915
1833,2,1981,33,1,3,80,-1,2324,373,866,0.431,0,1,0,373,865,0.431,173,214,0.808,135,227,362,312,57,25,230,202,919
1833,3,1982,34,1,3,14,1,187,22,45,0.489,0,0,-1,22,45,0.489,15,20,0.75,3,15,18,29,4,3,17,20,59
1835,1,1986,23,1,4,64,0,815,113,214,0.528,0,0,-1,113,214,0.528,37,85,0.435,90,153,243,19,13,22,59,147,263
1836,1,2003,24,1,5,16,0,156,15,37,0.405,0,0,-1,15,37,0.405,2,6,0.333,4,28,32,0,1,12,6,20,32
1839,1,1992,22,1,4,82,77,3047,616,1258,0.49,5,22,0.227,611,1236,0.494,339,409,0.829,323,576,899,292,81,51,160,225,1576
1839,2,1993,23,1,4,82,82,3323,728,1385,0.526,18,71,0.254,710,1314,0.54,336,438,0.767,281,583,864,353,53,27,227,187,1810
1839,3,1994,24,1,4,51,51,1757,346,672,0.515,5,21,0.238,341,651,0.524,137,197,0.695,143,305,448,184,29,14,116,131,834
1839,4,1995,25,1,4,81,81,3234,585,1219,0.48,81,210,0.386,504,1009,0.5,274,354,0.774,190,395,585,369,78,28,207,174,1525
1839,5,1996,26,1,4,81,81,3274,583,1225,0.476,67,183,0.366,516,1042,0.495,427,564,0.757,249,434,683,355,55,43,182,173,1660
1839,6,1997,27,1,3,76,76,2613,376,735,0.512,34,105,0.324,342,630,0.543,190,274,0.693,165,228,393,174,64,36,136,249,976
1839,7,1998,28,1,3,70,70,2412,429,884,0.485,15,63,0.238,414,821,0.504,214,283,0.756,175,226,401,150,40,13,127,193,1087
1839,8,1999,29,1,4,49,48,1639,210,458,0.459,33,92,0.359,177,366,0.484,134,164,0.817,91,193,284,119,34,10,89,147,587
1839,9,2000,30,1,4,70,68,2281,282,652,0.433,58,174,0.333,224,478,0.469,128,167,0.766,87,293,380,175,42,7,94,205,750
1839,10,2001,31,1,4,65,65,2105,246,598,0.411,51,163,0.313,195,435,0.448,102,128,0.797,90,273,363,127,39,29,97,209,645
1840,1,2004,23,1,3,41,20,734,72,203,0.355,7,33,0.212,65,170,0.382,22,37,0.595,59,124,183,27,37,32,37,90,173
1840,2,2006,25,1,3,27,7,489,56,139,0.403,13,36,0.361,43,103,0.417,17,23,0.739,40,75,115,12,10,12,24,54,142
1840,2,2006,25,1,3,36,7,524,61,149,0.409,13,36,0.361,48,113,0.425,18,27,0.667,40,82,122,14,12,12,28,61,153
1840,3,2007,26,1,4,54,0,720,93,190,0.489,10,30,0.333,83,160,0.519,30,37,0.811,52,111,163,18,33,18,27,101,226
1842,1,1980,27,1,4,82,-1,2647,588,1271,0.463,5,32,0.156,583,1239,0.471,385,482,0.799,258,423,681,344,153,112,286,291,1566
1842,2,1981,28,1,4,82,-1,2118,379,846,0.448,3,18,0.167,376,828,0.454,262,332,0.789,183,362,545,286,94,71,230,256,1023
1842,3,1982,29,1,4,76,71,1934,372,757,0.491,1,7,0.143,371,750,0.495,233,291,0.801,133,321,454,215,72,45,191,240,978
1842,4,1983,30,1,4,6,0,153,30,66,0.455,0,2,0,30,64,0.469,7,9,0.778,9,16,25,11,1,2,12,22,67
1842,4,1983,30,1,4,30,9,899,162,359,0.451,1,17,0.059,161,342,0.471,141,170,0.829,88,157,245,100,25,23,105,131,466
1842,4,1983,30,1,4,42,7,1001,199,496,0.401,2,17,0.118,197,479,0.411,164,201,0.816,66,158,224,144,56,21,121,135,564
1842,4,1983,30,1,4,78,16,2053,391,921,0.425,3,36,0.083,388,885,0.438,312,380,0.821,163,331,494,255,82,46,238,288,1097
1842,5,1984,31,1,4,78,25,2122,359,852,0.421,5,29,0.172,354,823,0.43,339,432,0.785,198,320,518,219,101,30,216,290,1062
1842,6,1985,32,1,4,66,9,1565,304,714,0.426,7,30,0.233,297,684,0.434,260,316,0.823,149,247,396,149,70,35,142,221,875
1842,7,1986,33,1,4,79,4,1574,214,507,0.422,5,24,0.208,209,483,0.433,183,233,0.785,98,234,332,217,67,25,165,248,616
1843,1,1980,30,1,3,79,-1,1535,262,527,0.497,1,11,0.091,261,516,0.506,82,93,0.882,50,113,163,161,59,24,96,165,607
1843,2,1981,31,1,3,40,-1,372,87,158,0.551,1,6,0.167,86,152,0.566,27,31,0.871,8,47,55,30,20,2,25,45,202
1843,3,1982,32,1,3,26,0,150,27,54,0.5,1,3,0.333,26,51,0.51,6,7,0.857,7,15,22,10,13,3,13,28,61
1845,1,1981,23,1,4,79,-1,1716,340,682,0.499,0,1,0,340,681,0.499,128,193,0.663,132,226,358,78,45,48,130,283,808
1845,2,1982,24,1,4,21,17,504,94,194,0.485,0,0,-1,94,194,0.485,32,40,0.8,43,94,137,20,7,16,26,67,220
1845,2,1982,24,1,4,23,22,617,94,175,0.537,0,0,-1,94,175,0.537,35,44,0.795,43,82,125,22,6,17,24,73,223
1845,2,1982,24,1,4,31,9,783,163,293,0.556,0,1,0,163,292,0.558,51,72,0.708,54,135,189,31,20,27,50,117,377
1845,2,1982,24,1,4,75,48,1904,351,662,0.53,0,1,0,351,661,0.531,118,156,0.756,140,311,451,73,33,60,100,257,820
1845,3,1983,25,1,3,29,8,549,69,154,0.448,0,0,-1,69,154,0.448,22,30,0.733,32,58,90,23,8,17,35,82,160
1845,3,1983,25,1,3,50,0,992,178,355,0.501,1,4,0.25,177,351,0.504,73,100,0.73,75,126,201,48,18,26,69,150,430
1845,3,1983,25,1,3,79,8,1541,247,509,0.485,1,4,0.25,246,505,0.487,95,130,0.731,107,184,291,71,26,43,104,232,590
1845,4,1984,26,1,4,72,4,818,127,256,0.496,0,1,0,127,255,0.498,92,126,0.73,53,85,138,40,24,18,59,141,346
1848,1,1987,24,1,4,29,0,234,27,64,0.422,0,3,0,27,61,0.443,20,38,0.526,15,28,43,5,9,2,18,55,74
1849,1,1982,24,1,5,78,50,1741,395,644,0.613,0,0,-1,395,644,0.613,212,330,0.642,152,307,459,91,39,89,197,372,1002
1849,2,1983,25,1,5,79,21,1544,371,595,0.624,0,0,-1,371,595,0.624,186,324,0.574,140,258,398,95,40,83,180,323,928
1849,3,1984,26,1,5,31,9,594,113,198,0.571,0,0,-1,113,198,0.571,64,110,0.582,68,98,166,18,15,21,59,119,290
1849,3,1984,26,1,5,50,12,893,189,342,0.553,0,0,-1,189,342,0.553,101,177,0.571,94,158,252,63,22,48,105,188,479
1849,3,1984,26,1,5,81,21,1487,302,540,0.559,0,0,-1,302,540,0.559,165,287,0.575,162,256,418,81,37,69,164,307,769
1849,4,1985,27,1,5,74,54,1659,281,516,0.545,0,3,0,281,513,0.548,181,252,0.718,146,291,437,64,37,62,151,265,743
1849,5,1986,28,1,5,71,55,1828,362,573,0.632,0,0,-1,362,573,0.632,259,373,0.694,143,319,462,95,44,66,191,291,983
1849,6,1987,29,1,5,79,74,2345,494,889,0.556,0,0,-1,494,889,0.556,342,490,0.698,194,372,566,155,49,76,276,340,1330
1849,7,1988,30,1,5,43,33,1050,258,488,0.529,0,1,0,258,487,0.53,146,249,0.586,84,158,242,57,17,32,122,151,662
1849,8,1989,31,1,5,72,11,1477,296,565,0.524,0,0,-1,296,565,0.524,129,245,0.527,135,223,358,105,20,44,140,254,721
1849,9,1990,32,1,5,21,0,242,48,90,0.533,0,0,-1,48,90,0.533,21,35,0.6,19,31,50,16,3,5,25,52,117
1849,9,1990,32,1,5,25,0,259,48,92,0.522,0,0,-1,48,92,0.522,21,35,0.6,19,34,53,17,3,5,31,56,117
1849,10,1991,33,1,5,24,8,228,34,63,0.54,0,0,-1,34,63,0.54,22,37,0.595,18,39,57,17,4,4,25,50,90
1851,1,1980,23,1,2,38,-1,325,45,115,0.391,0,1,0,45,114,0.395,31,39,0.795,19,36,55,54,19,4,42,40,121
1851,2,1981,24,1,1,81,-1,2311,419,785,0.534,1,5,0.2,418,780,0.536,214,270,0.793,193,173,366,341,78,20,216,198,1053
1851,3,1982,25,1,2,7,0,104,9,22,0.409,0,1,0,9,21,0.429,9,12,0.75,7,8,15,11,6,2,5,8,27
1851,3,1982,25,1,2,67,15,1191,208,422,0.493,3,11,0.273,205,411,0.499,98,130,0.754,75,69,144,160,50,23,91,93,517
1851,3,1982,25,1,2,74,15,1295,217,444,0.489,3,12,0.25,214,432,0.495,107,142,0.754,82,77,159,171,56,25,96,101,544
1851,4,1983,26,1,2,82,51,2511,520,1013,0.513,11,40,0.275,509,973,0.523,245,315,0.778,167,186,353,301,93,49,152,263,1296
1851,5,1984,27,1,2,82,0,1909,426,901,0.473,4,19,0.211,422,882,0.478,207,275,0.753,130,107,237,271,44,19,135,196,1063
1851,6,1985,28,1,2,82,16,2093,428,942,0.454,5,27,0.185,423,915,0.462,190,247,0.769,134,118,252,325,71,20,135,205,1051
1851,7,1986,29,1,2,79,12,1978,465,996,0.467,2,13,0.154,463,983,0.471,165,214,0.771,119,107,226,269,80,23,88,180,1097
1851,8,1987,30,1,2,78,8,2166,533,1154,0.462,4,14,0.286,529,1140,0.464,158,201,0.786,123,134,257,300,92,16,133,159,1228
1851,9,1988,31,1,2,82,1,1935,425,959,0.443,5,24,0.208,420,935,0.449,147,217,0.677,90,141,231,267,58,18,152,164,1002
1851,10,1989,32,1,2,82,21,2073,462,996,0.464,13,44,0.295,449,952,0.472,193,263,0.734,109,146,255,242,74,17,105,155,1130
1851,11,1990,33,1,2,82,12,1972,334,775,0.431,5,34,0.147,329,741,0.444,131,196,0.668,108,148,256,255,71,13,123,143,804
1851,12,1991,34,1,2,82,28,2390,406,936,0.434,11,34,0.324,395,902,0.438,135,209,0.646,110,170,280,271,75,15,118,166,958
1851,13,1992,35,1,2,60,23,1350,202,499,0.405,19,60,0.317,183,439,0.417,55,85,0.647,67,115,182,145,41,14,74,93,478
1854,1,1989,22,1,4,37,0,307,50,102,0.49,0,1,0,50,101,0.495,29,43,0.674,20,27,47,20,17,6,18,38,129
1855,1,1980,28,1,4,81,-1,2125,398,748,0.532,0,3,0,398,745,0.534,257,329,0.781,152,298,450,146,102,118,146,223,1053
1855,2,1981,29,1,4,81,-1,2046,407,755,0.539,0,3,0,407,752,0.541,282,347,0.813,142,293,435,226,95,74,149,226,1096
1855,3,1982,30,1,4,76,73,2181,416,737,0.564,0,3,0,416,734,0.567,263,333,0.79,109,284,393,189,99,112,145,211,1095
1855,4,1983,31,1,4,74,0,1749,250,460,0.543,0,1,0,250,459,0.545,165,208,0.793,102,242,344,142,85,91,109,199,665
1855,5,1984,32,1,4,75,0,1761,226,432,0.523,0,1,0,226,431,0.524,167,213,0.784,92,231,323,187,107,103,101,199,619
1855,6,1985,33,1,4,80,8,1633,207,385,0.538,0,4,0,207,381,0.543,186,216,0.861,105,192,297,155,84,50,118,183,600
1855,7,1986,34,1,4,70,42,1519,189,338,0.559,0,1,0,189,337,0.561,114,145,0.786,49,120,169,126,48,50,90,159,492
1856,1,2002,23,1,4,23,2,126,8,20,0.4,0,0,-1,8,20,0.4,10,20,0.5,13,23,36,3,3,9,11,35,26
1857,1,1983,22,1,4,16,0,137,9,20,0.45,0,0,-1,9,20,0.45,6,15,0.4,11,19,30,10,2,6,11,24,24
1857,1,1983,22,1,4,23,0,191,11,30,0.367,0,0,-1,11,30,0.367,9,20,0.45,15,31,46,11,3,7,15,33,31
1858,1,1995,23,1,2,11,0,139,15,44,0.341,2,12,0.167,13,32,0.406,13,16,0.813,6,5,11,16,6,0,9,19,45
1860,1,2007,23,1,3,44,5,336,43,93,0.462,1,9,0.111,42,84,0.5,23,41,0.561,22,35,57,16,11,1,18,59,110
1860,2,2008,24,1,3,9,2,137,14,36,0.389,3,13,0.231,11,23,0.478,9,10,0.9,10,17,27,11,5,2,5,17,40
1860,2,2008,24,1,3,6,0,143,17,32,0.531,6,15,0.4,11,17,0.647,8,13,0.615,8,16,24,5,2,0,7,18,48
1860,2,2008,24,1,5,25,0,222,26,64,0.406,9,23,0.391,17,41,0.415,23,28,0.821,11,27,38,11,5,1,14,46,84
1860,2,2008,24,1,5,47,2,531,60,140,0.429,18,53,0.34,42,87,0.483,40,51,0.784,29,63,92,28,15,3,28,85,178
1861,1,1999,23,1,2,29,5,476,39,123,0.317,19,61,0.311,20,62,0.323,11,22,0.5,9,33,42,41,18,5,29,30,108
1861,2,2000,24,1,1,56,0,662,66,201,0.328,39,118,0.331,27,83,0.325,17,23,0.739,17,45,62,94,30,5,28,46,188
1862,1,1985,27,1,5,28,4,638,65,123,0.528,0,0,-1,65,123,0.528,36,52,0.692,69,109,178,25,22,74,21,101,166
1862,1,1985,27,1,5,31,4,667,67,127,0.528,0,0,-1,67,127,0.528,40,58,0.69,71,113,184,26,22,79,25,107,174
1862,2,1986,28,1,5,81,58,1609,129,254,0.508,0,1,0,129,253,0.51,54,86,0.628,122,199,321,76,57,133,71,235,312
1862,3,1987,29,1,4,79,64,1609,118,249,0.474,0,1,0,118,248,0.476,48,76,0.632,144,212,356,80,67,165,77,252,284
1862,4,1988,30,1,4,69,49,1313,72,177,0.407,0,1,0,72,176,0.409,53,75,0.707,106,219,325,59,53,113,57,226,197
1862,5,1989,31,1,5,53,45,1154,60,125,0.48,0,1,0,60,124,0.484,16,25,0.64,77,180,257,42,39,76,39,187,136
1862,6,1990,32,1,5,81,81,2240,94,185,0.508,0,0,-1,94,185,0.508,68,105,0.648,145,359,504,139,50,197,76,296,256
1862,7,1991,33,1,5,62,54,1499,67,124,0.54,0,0,-1,67,124,0.54,29,50,0.58,119,240,359,48,51,124,46,199,163
1862,8,1992,34,1,5,75,32,1365,33,90,0.367,0,0,-1,33,90,0.367,20,40,0.5,105,212,317,62,43,92,39,214,86
1862,9,1993,35,1,5,67,21,1206,33,63,0.524,0,1,0,33,62,0.532,22,38,0.579,87,190,277,42,38,77,38,144,88
1862,10,1994,36,1,5,42,0,877,36,78,0.462,0,1,0,36,77,0.468,19,34,0.559,89,146,235,29,14,43,12,136,91
1862,11,1996,38,1,4,46,0,297,6,19,0.316,0,0,-1,6,19,0.316,4,13,0.308,28,46,74,12,5,24,3,44,16
1862,12,1998,40,1,4,24,0,127,7,10,0.7,0,0,-1,7,10,0.7,1,2,0.5,12,12,24,5,1,6,4,22,15
1864,1,2011,22,1,1,18,0,135,14,45,0.311,0,4,0,14,41,0.341,14,17,0.824,6,19,25,19,5,3,10,7,42
1864,2,2012,23,1,1,33,1,268,29,73,0.397,1,8,0.125,28,65,0.431,29,37,0.784,9,35,44,42,10,5,28,28,88
1864,3,2013,24,1,1,29,3,338,40,109,0.367,1,9,0.111,39,100,0.39,35,53,0.66,18,27,45,83,14,2,38,29,116
1865,1,1980,29,1,5,80,-1,2771,232,532,0.436,0,2,0,232,530,0.438,124,178,0.697,219,731,950,164,43,162,218,298,588
1865,2,1981,30,1,5,81,-1,2639,218,485,0.449,0,0,-1,218,485,0.449,148,193,0.767,200,613,813,122,53,134,168,271,584
1865,3,1982,31,1,5,81,47,2446,231,465,0.497,0,3,0,231,462,0.5,179,219,0.817,164,544,708,100,38,146,155,301,641
1865,4,1983,32,1,5,82,82,2440,307,677,0.453,0,2,0,307,675,0.455,162,206,0.786,222,446,668,138,46,131,171,278,776
1865,5,1984,33,1,5,81,73,2506,318,633,0.502,1,3,0.333,317,630,0.503,164,196,0.837,168,414,582,156,46,80,158,335,801
1865,6,1985,34,1,5,42,32,885,53,115,0.461,0,2,0,53,113,0.469,36,47,0.766,49,162,211,34,12,31,40,125,142
1865,7,1986,35,1,5,80,19,1437,126,254,0.496,0,7,0,126,247,0.51,124,150,0.827,105,250,355,74,38,61,102,244,376
1865,8,1987,36,1,4,78,37,1578,111,224,0.496,0,2,0,111,222,0.5,97,124,0.782,114,341,455,64,23,77,87,227,319
1865,9,1988,37,1,5,79,77,1778,128,263,0.487,0,4,0,128,259,0.494,78,106,0.736,105,303,408,81,29,99,82,251,334
1865,10,1989,38,1,4,72,40,1279,77,183,0.421,0,1,0,77,182,0.423,48,61,0.787,88,212,300,59,24,85,83,166,202
1865,11,1990,39,1,4,72,2,885,67,144,0.465,1,5,0.2,66,139,0.475,38,54,0.704,76,154,230,20,20,27,48,146,173
1867,1,1980,27,1,4,21,-1,278,50,119,0.42,0,0,-1,50,119,0.42,27,36,0.75,31,41,72,11,4,5,20,48,127
1867,1,1980,27,1,4,53,-1,1170,207,387,0.535,0,0,-1,207,387,0.535,119,165,0.721,83,213,296,90,24,37,102,159,533
1867,1,1980,27,1,4,74,-1,1448,257,506,0.508,0,0,-1,257,506,0.508,146,201,0.726,114,254,368,101,28,42,122,207,660
1867,2,1981,28,1,4,81,-1,1574,245,507,0.483,0,0,-1,245,507,0.483,125,161,0.776,127,274,401,99,40,36,126,200,615
1867,3,1982,29,1,4,78,18,2040,303,572,0.53,1,1,1,302,571,0.529,172,238,0.723,156,351,507,114,49,36,155,217,779
1867,4,1983,30,1,4,32,0,491,62,132,0.47,0,1,0,62,131,0.473,32,48,0.667,28,86,114,22,13,9,35,82,156
1867,4,1983,30,1,4,49,2,673,86,193,0.446,0,0,-1,86,193,0.446,47,75,0.627,56,139,195,40,18,14,66,90,219
1867,4,1983,30,1,4,81,2,1164,148,325,0.455,0,1,0,148,324,0.457,79,123,0.642,84,225,309,62,31,23,101,172,375
1868,1,1999,22,1,1,11,0,131,14,44,0.318,10,29,0.345,4,15,0.267,11,13,0.846,2,11,13,13,7,0,5,7,49
1868,1,1999,22,1,1,13,0,213,29,75,0.387,15,33,0.455,14,42,0.333,3,4,0.75,4,27,31,29,6,0,12,16,76
1868,1,1999,22,1,1,24,0,344,43,119,0.361,25,62,0.403,18,57,0.316,14,17,0.824,6,38,44,42,13,0,17,23,125
1868,2,2000,23,1,1,13,1,196,25,54,0.463,11,23,0.478,14,31,0.452,7,9,0.778,0,16,16,39,6,0,15,13,68
1868,2,2000,23,1,1,42,0,416,55,154,0.357,30,91,0.33,25,63,0.397,25,39,0.641,12,27,39,57,12,1,25,21,165
1868,2,2000,23,1,1,55,1,612,80,208,0.385,41,114,0.36,39,94,0.415,32,48,0.667,12,43,55,96,18,1,40,34,233
1868,3,2001,24,1,1,71,10,1415,170,416,0.409,84,231,0.364,86,185,0.465,37,52,0.712,16,108,124,224,36,1,76,58,461
1868,4,2002,25,1,1,67,0,1083,114,284,0.401,69,186,0.371,45,98,0.459,43,59,0.729,13,90,103,140,23,1,61,83,340
1868,5,2003,26,1,1,49,1,709,80,210,0.381,44,121,0.364,36,89,0.404,20,27,0.741,11,59,70,80,18,4,23,42,224
1868,6,2004,27,1,1,82,26,2016,210,524,0.401,98,273,0.359,112,251,0.446,55,72,0.764,15,155,170,478,30,4,103,92,573
1868,7,2005,28,1,1,82,66,2576,331,726,0.456,225,521,0.432,106,205,0.517,68,86,0.791,14,217,231,350,44,5,98,121,955
1868,8,2006,29,1,1,82,7,2089,190,491,0.387,140,371,0.377,50,120,0.417,32,50,0.64,14,119,133,169,37,1,55,112,552
1868,9,2007,30,1,1,60,0,1173,137,355,0.386,89,231,0.385,48,124,0.387,30,44,0.682,9,57,66,94,16,2,36,53,393
1868,10,2008,31,1,2,67,3,1336,151,363,0.416,115,276,0.417,36,87,0.414,20,28,0.714,5,67,72,126,19,1,36,66,437
1868,11,2009,32,1,1,18,0,108,11,34,0.324,11,28,0.393,0,6,0,0,0,-1,0,6,6,7,3,0,6,4,33
1870,1,1995,23,1,2,64,58,1981,342,744,0.46,91,246,0.37,251,498,0.504,122,169,0.722,79,170,249,128,131,41,75,175,897
1870,2,1996,24,1,2,70,66,2184,337,685,0.492,83,227,0.366,254,458,0.555,136,184,0.739,45,188,233,246,129,45,99,162,893
1870,3,1997,25,1,2,80,80,2998,473,1081,0.438,152,389,0.391,321,692,0.464,276,337,0.819,90,236,326,270,189,49,169,226,1374
1870,4,1998,26,1,2,80,80,2910,486,1005,0.484,143,368,0.389,343,637,0.538,234,306,0.765,85,217,302,246,160,55,146,164,1349
1870,5,1999,27,1,2,20,20,724,96,227,0.423,20,64,0.313,76,163,0.466,59,80,0.738,20,56,76,61,35,24,21,42,271
1870,5,1999,27,1,3,30,30,1157,164,368,0.446,28,78,0.359,136,290,0.469,153,191,0.801,30,88,118,125,90,34,72,86,509
1870,5,1999,27,1,3,50,50,1881,260,595,0.437,48,142,0.338,212,453,0.468,212,271,0.782,50,144,194,186,125,58,93,128,780
1870,6,2000,28,1,2,72,72,2807,478,1119,0.427,128,341,0.375,350,778,0.45,362,419,0.864,81,262,343,305,192,49,160,176,1446
1870,7,2001,29,1,2,63,58,2282,388,871,0.445,90,238,0.378,298,633,0.471,228,270,0.844,75,217,292,171,110,58,135,183,1094
1870,8,2002,30,1,2,81,81,3156,517,1198,0.432,149,382,0.39,368,816,0.451,297,355,0.837,61,317,378,262,117,77,148,258,1480
1870,9,2003,31,1,2,47,47,1789,291,688,0.423,98,241,0.407,193,447,0.432,189,230,0.822,35,191,226,173,64,31,85,137,869
1870,10,2004,32,1,2,81,81,2998,473,1156,0.409,177,479,0.37,296,677,0.437,278,333,0.835,38,270,308,258,92,34,129,226,1401
1870,11,2005,33,1,3,80,80,2839,351,820,0.428,142,382,0.372,209,438,0.477,174,216,0.806,38,367,405,212,86,38,99,251,1018
1870,12,2006,34,1,2,75,75,2437,292,722,0.404,133,374,0.356,159,348,0.457,168,215,0.781,35,244,279,177,131,27,93,201,885
1870,13,2007,35,1,2,29,14,561,57,151,0.377,22,74,0.297,35,77,0.455,25,34,0.735,14,47,61,33,22,2,23,54,161
1870,13,2007,35,1,2,35,27,1033,121,271,0.446,56,148,0.378,65,123,0.528,34,41,0.829,17,112,129,76,46,8,24,70,332
1870,13,2007,35,1,2,64,41,1594,178,422,0.422,78,222,0.351,100,200,0.5,59,75,0.787,31,159,190,109,68,10,47,124,493
1870,14,2008,36,1,2,47,33,922,66,180,0.367,34,116,0.293,32,64,0.5,10,14,0.714,18,114,132,69,26,8,29,72,176
1871,1,1981,24,1,4,60,-1,950,189,357,0.529,0,4,0,189,353,0.535,146,218,0.67,92,171,263,43,36,81,101,185,524
1871,2,1982,25,1,4,48,19,802,142,259,0.548,1,2,0.5,141,257,0.549,90,129,0.698,70,137,207,40,28,92,66,149,375
1871,3,1983,26,1,4,28,3,622,92,185,0.497,0,3,0,92,182,0.505,84,114,0.737,56,121,177,20,14,31,43,107,268
1871,3,1983,26,1,4,49,25,1036,145,294,0.493,2,6,0.333,143,288,0.497,117,172,0.68,80,191,271,69,28,77,103,160,409
1871,3,1983,26,1,4,77,28,1658,237,479,0.495,2,9,0.222,235,470,0.5,201,286,0.703,136,312,448,89,42,108,146,267,677
1871,4,1984,27,1,4,81,33,1770,322,644,0.5,6,19,0.316,316,625,0.506,176,242,0.727,143,306,449,85,64,107,125,298,826
1871,5,1985,28,1,4,18,1,322,44,91,0.484,0,1,0,44,90,0.489,41,51,0.804,16,46,62,18,9,18,28,52,129
1871,5,1985,28,1,4,26,4,447,86,184,0.467,0,3,0,86,181,0.475,41,60,0.683,34,75,109,11,11,11,33,71,213
1871,5,1985,28,1,4,44,5,769,130,275,0.473,0,4,0,130,271,0.48,82,111,0.739,50,121,171,29,20,29,61,123,342
1871,6,1986,29,1,4,53,6,1011,187,370,0.505,7,23,0.304,180,347,0.519,132,178,0.742,71,136,207,45,30,38,64,142,513
1872,1,2003,23,1,2,19,1,115,9,24,0.375,2,7,0.286,7,17,0.412,3,4,0.75,4,5,9,5,6,1,6,13,23
1872,2,2004,24,1,2,81,2,1508,123,311,0.395,27,89,0.303,96,222,0.432,124,149,0.832,25,101,126,173,65,18,73,132,397
1872,3,2005,25,1,2,77,14,2268,275,647,0.425,87,229,0.38,188,418,0.45,176,207,0.85,34,208,242,196,61,31,114,171,813
1872,4,2006,26,1,2,68,2,1837,233,559,0.417,63,187,0.337,170,372,0.457,122,160,0.763,18,152,170,154,55,20,107,142,651
1872,5,2007,27,1,2,24,3,449,43,112,0.384,7,27,0.259,36,85,0.424,22,26,0.846,7,26,33,53,18,4,17,41,115
1872,5,2007,27,1,2,39,9,870,96,249,0.386,32,101,0.317,64,148,0.432,73,88,0.83,16,66,82,55,30,12,50,80,297
1872,5,2007,27,1,2,63,12,1319,139,361,0.385,39,128,0.305,100,233,0.429,95,114,0.833,23,92,115,108,48,16,67,121,412
1872,6,2008,28,1,2,70,26,1757,182,432,0.421,74,192,0.385,108,240,0.45,94,126,0.746,30,140,170,166,48,18,78,140,532
1872,7,2009,29,1,3,52,21,1495,129,317,0.407,54,147,0.367,75,170,0.441,66,81,0.815,23,103,126,188,53,11,66,112,378
1878,1,2005,29,1,3,10,0,116,9,31,0.29,0,4,0,9,27,0.333,5,10,0.5,6,7,13,6,5,2,3,16,23
1880,1,1980,26,1,4,82,-1,1545,188,392,0.48,1,3,0.333,187,389,0.481,61,108,0.565,147,234,381,67,50,67,112,186,438
1880,2,1981,27,1,4,68,-1,1003,117,252,0.464,0,1,0,117,251,0.466,64,101,0.634,96,138,234,41,18,23,57,112,298
1880,3,1982,28,1,4,60,6,746,113,213,0.531,0,3,0,113,210,0.538,42,77,0.545,80,122,202,25,20,29,50,100,268
1880,4,1983,29,1,4,60,4,878,142,311,0.457,0,2,0,142,309,0.46,56,102,0.549,114,149,263,39,22,22,83,104,340
1880,5,1984,30,1,4,57,5,473,70,130,0.538,0,0,-1,70,130,0.538,30,49,0.612,33,82,115,28,14,14,30,63,170
1880,6,1985,31,1,4,47,0,418,48,87,0.552,0,0,-1,48,87,0.552,33,51,0.647,48,80,128,15,9,14,35,58,129
1881,1,2000,20,1,3,33,0,138,22,58,0.379,2,4,0.5,20,54,0.37,11,18,0.611,16,22,38,5,6,5,14,10,57
1881,2,2001,21,1,3,65,0,866,122,275,0.444,20,60,0.333,102,215,0.474,40,53,0.755,63,126,189,32,30,15,39,68,304
1881,3,2002,22,1,4,81,36,2142,287,640,0.448,52,168,0.31,235,472,0.498,45,68,0.662,125,365,490,116,75,46,79,184,671
1881,4,2003,23,1,3,80,12,2204,308,710,0.434,111,314,0.354,197,396,0.497,57,83,0.687,106,299,405,112,67,22,107,176,784
1881,5,2004,24,1,2,42,2,373,33,96,0.344,13,44,0.295,20,52,0.385,14,23,0.609,24,44,68,14,12,9,19,48,93
1881,6,2005,25,1,3,76,23,1830,210,486,0.432,102,261,0.391,108,225,0.48,55,75,0.733,107,291,398,65,44,24,49,165,577
1881,7,2006,26,1,4,76,42,2089,298,736,0.405,115,335,0.343,183,401,0.456,88,121,0.727,105,271,376,63,68,22,74,200,799
1881,8,2007,27,1,3,18,0,138,14,51,0.275,10,32,0.313,4,19,0.211,2,2,1,6,17,23,1,5,1,7,19,40
1882,1,1985,24,1,5,67,6,888,106,180,0.589,0,1,0,106,179,0.592,33,83,0.398,65,173,238,56,30,57,61,139,245
1883,1,1994,23,1,4,81,47,1773,195,407,0.479,0,1,0,195,406,0.48,78,107,0.729,299,306,605,99,61,31,94,246,468
1883,2,1995,24,1,4,80,80,2385,372,839,0.443,1,12,0.083,371,827,0.449,80,124,0.645,329,515,844,163,35,27,124,267,825
1883,3,1996,25,1,4,68,68,2322,327,733,0.446,14,39,0.359,313,694,0.451,102,133,0.767,260,477,737,132,54,27,109,262,770
1883,4,1997,26,1,4,79,61,2421,258,537,0.48,1,13,0.077,257,524,0.49,99,121,0.818,270,410,680,84,58,39,116,269,616
1883,5,1998,27,1,4,14,4,352,52,127,0.409,2,3,0.667,50,124,0.403,14,19,0.737,50,52,102,18,10,3,16,39,120
1883,6,1999,28,1,4,18,2,206,20,51,0.392,0,1,0,20,50,0.4,14,17,0.824,28,24,52,15,5,0,7,31,54
1883,7,2000,29,1,4,40,1,330,44,104,0.423,2,3,0.667,42,101,0.416,14,19,0.737,41,62,103,19,3,6,13,50,104
1883,8,2001,30,1,4,45,1,638,60,153,0.392,1,6,0.167,59,147,0.401,41,55,0.745,83,137,220,31,19,8,21,95,162
1883,9,2002,31,1,4,79,40,1920,222,508,0.437,4,11,0.364,218,497,0.439,106,130,0.815,233,345,578,127,50,19,88,209,554
1883,10,2003,32,1,4,26,0,222,24,62,0.387,0,0,-1,24,62,0.387,5,11,0.455,29,30,59,8,5,1,15,31,53
1887,1,1989,22,1,3,42,34,577,81,179,0.453,0,1,0,81,178,0.455,50,67,0.746,24,71,95,33,16,13,39,50,212
1887,1,1989,22,1,3,51,34,682,93,209,0.445,0,1,0,93,208,0.447,58,80,0.725,32,81,113,42,21,15,47,58,244
1893,1,1980,25,1,1,82,-1,2657,437,1017,0.43,12,48,0.25,425,969,0.439,201,258,0.779,62,208,270,557,223,27,258,238,1087
1893,2,1981,26,1,1,14,-1,239,30,73,0.411,3,10,0.3,27,63,0.429,24,32,0.75,5,13,18,46,24,1,23,29,87
1893,2,1981,26,1,1,60,-1,987,120,279,0.43,3,12,0.25,117,267,0.438,63,95,0.663,25,55,80,195,74,7,120,136,306
1893,2,1981,26,1,1,74,-1,1226,150,352,0.426,6,22,0.273,144,330,0.436,87,127,0.685,30,68,98,241,98,8,143,165,393
1893,3,1982,27,1,1,58,0,608,89,208,0.428,1,9,0.111,88,199,0.442,43,54,0.796,4,39,43,131,62,1,66,98,222
1893,4,1983,28,1,1,35,0,333,40,132,0.303,3,16,0.188,37,116,0.319,11,17,0.647,8,18,26,80,31,1,54,52,94
1893,5,1984,29,1,1,13,0,183,13,41,0.317,0,3,0,13,38,0.342,7,10,0.7,3,10,13,39,21,0,18,32,33
1893,5,1984,29,1,1,16,0,210,17,49,0.347,0,3,0,17,46,0.37,8,12,0.667,3,14,17,44,25,0,26,37,42
1894,1,1993,24,1,4,4,0,106,18,41,0.439,0,0,-1,18,41,0.439,8,17,0.471,5,14,19,3,3,5,12,14,44
1895,1,1981,24,1,3,30,-1,207,29,75,0.387,0,0,-1,29,75,0.387,10,17,0.588,23,19,42,11,11,5,17,35,68
1903,1,1980,23,1,3,65,0,674,139,276,0.504,11,27,0.407,128,249,0.514,62,76,0.816,32,34,66,47,29,5,49,91,351
1903,2,1981,24,1,3,62,-1,666,92,216,0.426,9,28,0.321,83,188,0.441,45,51,0.882,29,64,93,59,16,2,30,84,238
1903,3,1982,25,1,3,30,0,251,31,81,0.383,1,10,0.1,30,71,0.423,16,26,0.615,14,20,34,14,6,5,9,33,79
1903,4,1983,26,1,3,34,0,309,39,88,0.443,2,8,0.25,37,80,0.463,25,30,0.833,18,25,43,17,15,2,17,39,105
1906,1,2000,24,1,5,56,6,528,89,161,0.553,0,0,-1,89,161,0.553,28,54,0.519,48,98,146,13,11,37,26,94,206
1906,2,2001,25,1,5,63,3,597,109,185,0.589,0,0,-1,109,185,0.589,42,66,0.636,69,99,168,10,7,19,27,96,260
1906,3,2002,26,1,5,62,61,1502,247,465,0.531,0,0,-1,247,465,0.531,110,164,0.671,157,221,378,78,24,89,66,181,604
1906,4,2003,27,1,5,42,35,812,123,238,0.517,0,0,-1,123,238,0.517,53,79,0.671,66,130,196,20,19,32,35,107,299
1908,1,2006,26,1,2,19,0,135,14,41,0.341,3,12,0.25,11,29,0.379,13,15,0.867,3,7,10,5,7,0,8,10,44
1910,1,2012,25,1,5,23,0,135,19,35,0.543,0,0,-1,19,35,0.543,8,14,0.571,14,20,34,5,4,4,3,9,46
1911,1,1993,23,1,4,62,4,674,157,361,0.435,3,6,0.5,154,355,0.434,90,111,0.811,33,89,122,39,11,4,42,82,407
1911,2,1994,24,1,3,75,69,2487,517,1030,0.502,3,21,0.143,514,1009,0.509,328,398,0.824,140,327,467,160,47,22,152,169,1365
1911,3,1995,25,1,4,39,20,1052,158,361,0.438,10,40,0.25,148,321,0.461,104,136,0.765,46,119,165,51,15,3,44,97,430
1911,4,1996,26,1,3,56,5,1107,233,547,0.426,14,49,0.286,219,498,0.44,145,198,0.732,62,143,205,89,21,5,68,105,625
1911,5,1997,27,1,3,37,2,733,163,365,0.447,12,38,0.316,151,327,0.462,64,97,0.66,41,99,140,37,12,10,47,71,402
1911,6,1999,29,1,4,17,10,365,63,159,0.396,9,33,0.273,54,126,0.429,50,80,0.625,18,47,65,16,5,5,25,34,185
1911,7,2000,30,1,4,16,0,143,18,49,0.367,2,6,0.333,16,43,0.372,4,6,0.667,6,17,23,8,2,1,8,24,42
1912,1,1980,22,1,2,27,-1,155,21,50,0.42,0,1,0,21,49,0.429,9,18,0.5,7,15,22,20,4,0,9,16,51
1912,1,1980,22,1,2,23,-1,526,77,149,0.517,0,4,0,77,145,0.531,29,33,0.879,25,24,49,33,20,3,26,34,183
1912,1,1980,22,1,2,50,-1,681,98,199,0.492,0,5,0,98,194,0.505,38,51,0.745,32,39,71,53,24,3,35,50,234
1912,2,1981,23,1,2,62,-1,1666,278,600,0.463,0,9,0,278,591,0.47,79,123,0.642,92,137,229,162,55,7,70,114,635
1912,2,1981,23,1,2,65,-1,1682,279,606,0.46,0,9,0,279,597,0.467,80,125,0.64,92,138,230,163,56,7,70,117,638
1912,3,1982,24,1,2,13,3,150,19,59,0.322,0,2,0,19,57,0.333,6,8,0.75,8,10,18,14,5,1,4,6,44
1913,1,1982,23,1,3,79,32,1516,210,484,0.434,0,3,0,210,481,0.437,134,173,0.775,113,150,263,47,40,20,112,225,554
1913,2,1983,24,1,3,73,20,1171,170,360,0.472,0,4,0,170,356,0.478,101,131,0.771,85,105,190,71,41,10,89,189,441
1915,1,1981,23,1,1,82,-1,1469,272,532,0.511,12,51,0.235,260,481,0.541,107,119,0.899,44,88,132,160,76,5,95,120,663
1915,2,1982,24,1,1,82,72,2845,486,945,0.514,39,100,0.39,447,845,0.529,152,169,0.899,78,183,261,384,143,9,125,185,1163
1915,3,1983,25,1,1,82,9,1836,328,634,0.517,23,76,0.303,305,558,0.547,129,148,0.872,41,124,165,278,64,8,90,130,808
1915,4,1984,26,1,1,82,45,2402,357,713,0.501,23,70,0.329,334,643,0.519,95,114,0.833,49,137,186,353,123,6,116,181,832
1915,5,1985,27,1,1,65,52,2018,282,582,0.485,23,85,0.271,259,497,0.521,127,140,0.907,33,146,179,380,85,3,111,128,714
1915,6,1986,28,1,1,82,79,2426,286,592,0.483,58,141,0.411,228,451,0.506,73,90,0.811,41,137,178,446,81,11,117,201,703
1915,7,1987,29,1,1,76,0,1250,164,341,0.481,14,46,0.304,150,295,0.508,34,41,0.829,25,88,113,197,59,7,58,136,376
1918,1,2001,25,1,4,70,3,641,55,113,0.487,1,1,1,54,112,0.482,26,37,0.703,74,78,152,24,8,8,27,111,137
1918,2,2002,26,1,4,59,5,650,66,146,0.452,0,2,0,66,144,0.458,35,54,0.648,89,73,162,44,16,13,22,104,167
1918,3,2003,27,1,4,54,22,781,69,163,0.423,0,0,-1,69,163,0.423,36,61,0.59,86,73,159,38,15,19,27,116,174
1918,4,2004,28,1,5,72,12,1246,101,204,0.495,0,6,0,101,198,0.51,57,118,0.483,134,138,272,28,33,18,47,175,259
1918,5,2005,29,1,5,41,14,601,34,66,0.515,0,0,-1,34,66,0.515,20,40,0.5,63,65,128,18,7,14,24,103,88
1918,6,2006,30,1,5,62,7,676,27,66,0.409,0,7,0,27,59,0.458,20,47,0.426,50,91,141,11,23,17,26,114,74
1918,7,2007,31,1,5,56,0,473,23,43,0.535,0,0,-1,23,43,0.535,15,29,0.517,35,52,87,10,10,10,21,100,61
1918,8,2008,32,1,4,20,6,151,3,19,0.158,0,0,-1,3,19,0.158,3,12,0.25,18,20,38,4,3,2,9,25,9
1918,9,2009,33,1,5,19,1,116,3,14,0.214,0,0,-1,3,14,0.214,0,4,0,10,8,18,4,1,1,3,18,6
1920,1,2000,20,1,3,77,5,1370,224,469,0.478,2,11,0.182,222,458,0.485,196,261,0.751,123,180,303,61,24,26,138,169,646
1920,2,2001,21,1,3,69,9,1359,225,487,0.462,17,56,0.304,208,431,0.483,223,288,0.774,88,203,291,82,35,9,106,140,690
1920,3,2002,22,1,2,63,52,1615,235,530,0.443,46,139,0.331,189,391,0.483,201,251,0.801,54,177,231,112,41,19,116,155,717
1920,4,2003,23,1,2,64,57,2006,343,773,0.444,62,177,0.35,281,596,0.471,325,405,0.802,77,245,322,123,55,16,147,194,1073
1920,5,2004,24,1,3,73,72,2628,453,1013,0.447,76,231,0.329,377,782,0.482,526,620,0.848,96,334,430,224,65,16,207,217,1508
1920,6,2005,25,1,2,66,60,2436,425,986,0.431,51,168,0.304,374,818,0.457,563,657,0.857,70,324,394,225,70,8,195,191,1464
1920,7,2006,26,1,3,32,13,943,167,375,0.445,24,71,0.338,143,304,0.47,212,256,0.828,28,141,169,66,19,4,78,95,570
1920,8,2007,27,1,3,75,31,2291,367,808,0.454,13,65,0.2,354,743,0.476,519,633,0.82,90,352,442,208,65,14,201,244,1266
1920,9,2008,28,1,3,70,65,2502,458,1000,0.458,78,203,0.384,380,797,0.477,553,681,0.812,78,316,394,189,71,7,195,210,1547
1920,10,2009,29,1,4,51,19,1588,292,634,0.461,24,95,0.253,268,539,0.497,342,415,0.824,49,233,282,92,44,8,120,192,950
1920,11,2010,30,1,4,70,49,2081,457,886,0.516,13,50,0.26,444,836,0.531,460,551,0.835,92,281,373,172,51,4,168,231,1387
1920,12,2011,31,1,3,67,18,1401,253,559,0.453,28,78,0.359,225,481,0.468,271,325,0.834,44,197,241,84,21,5,127,175,805
1920,13,2012,32,1,3,32,28,881,139,373,0.373,24,66,0.364,115,307,0.375,178,208,0.856,21,104,125,39,23,1,59,83,480
1920,14,2013,33,1,3,18,0,257,27,76,0.355,5,21,0.238,22,55,0.4,36,48,0.75,5,20,25,19,6,2,17,42,95
1922,1,2001,22,1,5,74,0,1095,122,271,0.45,0,2,0,122,269,0.454,95,145,0.655,103,192,295,27,18,78,61,139,339
1922,2,2002,23,1,5,82,8,1549,228,414,0.551,0,1,0,228,413,0.552,243,333,0.73,153,308,461,31,27,86,118,201,699
1922,3,2003,24,1,5,82,82,2443,305,635,0.48,0,3,0,305,632,0.483,231,322,0.717,260,464,724,88,49,111,158,276,841
1922,4,2004,25,1,5,82,82,2777,383,809,0.473,0,1,0,383,808,0.474,353,470,0.751,268,579,847,86,43,101,201,278,1119
1922,5,2005,26,1,5,23,22,703,98,227,0.432,0,0,-1,98,227,0.432,74,123,0.602,79,126,205,29,8,23,59,74,270
1922,6,2006,27,1,5,82,82,2465,287,615,0.467,0,0,-1,287,615,0.467,178,333,0.535,220,558,778,56,29,80,166,276,752
1922,7,2007,28,1,5,81,23,1703,199,395,0.504,0,0,-1,199,395,0.504,131,242,0.541,151,341,492,30,21,66,129,226,529
1922,8,2008,29,1,5,24,2,259,15,49,0.306,0,0,-1,15,49,0.306,14,31,0.452,18,63,81,7,0,10,23,42,44
1922,8,2008,29,1,5,31,2,286,18,55,0.327,0,0,-1,18,55,0.327,20,44,0.455,19,70,89,7,1,10,30,50,56
1922,9,2009,30,1,5,55,12,709,65,131,0.496,0,0,-1,65,131,0.496,29,60,0.483,82,140,222,22,11,25,32,121,159
1922,10,2010,31,1,5,36,0,359,28,56,0.5,0,0,-1,28,56,0.5,21,59,0.356,41,80,121,1,9,11,17,59,77
1922,11,2011,32,1,5,18,0,158,13,22,0.591,0,0,-1,13,22,0.591,9,18,0.5,17,44,61,3,4,2,5,26,35
1922,12,2012,33,1,5,34,1,374,17,45,0.378,0,0,-1,17,45,0.378,7,27,0.259,25,88,113,6,4,10,22,66,41
1929,1,1984,22,1,2,81,2,1976,408,918,0.444,24,74,0.324,384,844,0.455,142,172,0.826,57,98,155,151,23,13,110,162,982
1929,2,1985,23,1,2,76,61,2613,605,1213,0.499,15,72,0.208,590,1141,0.517,211,250,0.844,60,146,206,184,52,9,107,176,1436
1929,3,1986,24,1,2,80,80,2992,735,1522,0.483,3,17,0.176,732,1505,0.486,322,371,0.868,66,222,288,191,70,12,168,180,1795
1929,4,1987,25,1,2,80,79,2763,689,1509,0.457,4,26,0.154,685,1483,0.462,376,425,0.885,50,168,218,298,75,13,182,154,1758
1929,5,1988,26,1,2,80,80,2655,648,1360,0.476,10,24,0.417,638,1336,0.478,335,380,0.882,44,162,206,237,51,13,172,198,1641
1929,6,1989,27,1,2,76,75,2418,677,1410,0.48,1,19,0.053,676,1391,0.486,296,340,0.871,55,124,179,219,39,14,165,155,1651
1929,7,1990,28,1,2,75,74,2567,781,1592,0.491,1,6,0.167,780,1586,0.492,257,293,0.877,54,152,206,243,48,6,125,116,1820
1929,8,1991,29,1,2,69,69,2466,525,1034,0.508,1,6,0.167,524,1028,0.51,231,252,0.917,36,170,206,143,50,6,108,128,1282
1929,9,1992,30,1,2,81,81,2922,691,1353,0.511,1,12,0.083,690,1341,0.515,256,285,0.898,49,184,233,180,56,5,140,126,1639
1929,10,1993,31,1,2,79,59,2558,595,1205,0.494,3,9,0.333,592,1196,0.495,236,277,0.852,31,142,173,128,42,4,125,117,1429
1929,11,1994,32,1,2,27,23,903,187,389,0.481,4,6,0.667,183,383,0.478,76,94,0.809,23,61,84,59,14,0,28,46,454
1929,11,1994,32,1,2,50,50,1657,338,692,0.488,3,6,0.5,335,686,0.488,129,153,0.843,28,87,115,66,26,5,57,77,808
1929,11,1994,32,1,2,77,73,2560,525,1081,0.486,7,12,0.583,518,1069,0.485,205,247,0.83,51,148,199,125,40,5,85,123,1262
1929,12,1995,33,1,2,19,19,660,144,284,0.507,11,28,0.393,133,256,0.52,51,59,0.864,11,44,55,29,15,0,29,35,350
1929,13,1996,34,1,2,7,0,103,13,33,0.394,0,0,-1,13,33,0.394,5,6,0.833,0,8,8,7,3,0,3,6,31
1929,13,1996,34,1,2,25,3,407,63,160,0.394,5,16,0.313,58,144,0.403,24,26,0.923,8,24,32,19,13,0,19,19,155
1929,13,1996,34,1,2,32,3,510,76,193,0.394,5,16,0.313,71,177,0.401,29,32,0.906,8,32,40,26,16,0,22,25,186
1930,1,1989,23,1,2,54,5,1354,181,432,0.419,27,82,0.329,154,350,0.44,78,127,0.614,62,147,209,130,63,14,48,139,467
1930,2,1990,24,1,2,73,23,2244,296,698,0.424,19,80,0.238,277,618,0.448,198,260,0.762,144,286,430,188,100,32,82,177,809
1930,3,1991,25,1,3,77,7,2281,397,821,0.484,30,86,0.349,367,735,0.499,227,298,0.762,168,250,418,216,106,40,114,162,1051
1930,4,1992,26,1,3,82,15,2853,551,1153,0.478,87,228,0.382,464,925,0.502,229,303,0.756,148,335,483,274,131,43,102,158,1418
1930,5,1993,27,1,2,82,82,3199,509,1096,0.464,167,438,0.381,342,658,0.52,203,261,0.778,120,263,383,311,138,33,133,180,1388
1930,6,1994,28,1,2,80,76,3207,476,1138,0.418,192,503,0.382,284,635,0.447,176,238,0.739,120,229,349,275,129,43,137,153,1320
1930,7,1995,29,1,3,82,46,3091,438,1031,0.425,199,548,0.363,239,483,0.495,206,282,0.73,104,271,375,340,96,38,105,155,1281
1930,8,1996,30,1,3,82,15,2367,303,748,0.405,146,414,0.353,157,334,0.47,120,169,0.71,70,235,305,214,81,34,93,131,872
1930,9,1997,31,1,3,36,26,1264,141,347,0.406,68,201,0.338,73,146,0.5,40,59,0.678,45,117,162,116,54,14,50,75,390
1930,10,1998,32,1,2,72,22,1928,184,439,0.419,111,295,0.376,73,144,0.507,40,51,0.784,48,220,268,157,68,15,65,139,519
1930,11,1999,33,1,2,48,48,1624,118,298,0.396,68,203,0.335,50,95,0.526,33,46,0.717,21,187,208,150,38,7,55,100,337
1930,12,2000,34,1,2,69,69,2308,170,422,0.403,110,304,0.362,60,118,0.508,56,69,0.812,27,306,333,206,89,17,62,156,506
1930,13,2001,35,1,2,53,19,1306,87,259,0.336,57,181,0.315,30,78,0.385,36,44,0.818,20,146,166,88,53,15,35,98,267
1930,14,2002,36,1,2,65,1,1180,99,289,0.343,79,235,0.336,20,54,0.37,23,39,0.59,28,148,176,90,48,15,35,104,300
1931,1,1986,22,1,4,81,76,2475,504,1016,0.496,0,2,0,504,1014,0.497,195,405,0.481,174,544,718,236,105,44,279,295,1203
1931,2,1987,23,1,4,82,82,2857,728,1422,0.512,0,7,0,728,1415,0.514,323,540,0.598,278,577,855,158,104,60,237,323,1779
1931,3,1988,24,1,4,82,82,3198,858,1650,0.52,0,5,0,858,1645,0.522,552,789,0.7,277,709,986,199,117,50,325,296,2268
1931,4,1989,25,1,4,80,80,3126,809,1559,0.519,5,16,0.313,804,1543,0.521,703,918,0.766,259,594,853,219,144,70,285,286,2326
1931,5,1990,26,1,4,82,82,3122,914,1627,0.562,16,43,0.372,898,1584,0.567,696,913,0.762,232,679,911,226,121,50,304,259,2540
1931,6,1991,27,1,4,82,82,3302,847,1608,0.527,4,14,0.286,843,1594,0.529,684,888,0.77,236,731,967,270,89,79,244,268,2382
1931,7,1992,28,1,4,81,81,3054,798,1516,0.526,3,17,0.176,795,1499,0.53,673,865,0.778,225,684,909,241,108,51,248,226,2272
1931,8,1993,29,1,4,82,82,3099,797,1443,0.552,4,20,0.2,793,1423,0.557,619,836,0.74,227,692,919,308,124,85,240,261,2217
1931,9,1994,30,1,4,82,82,3329,772,1552,0.497,8,32,0.25,764,1520,0.503,511,736,0.694,235,705,940,328,125,126,234,268,2063
1931,10,1995,31,1,4,82,82,3126,830,1548,0.536,11,41,0.268,819,1507,0.543,516,695,0.742,156,715,871,285,129,85,236,269,2187
1931,11,1996,32,1,4,82,82,3113,789,1520,0.519,16,40,0.4,773,1480,0.522,512,708,0.723,175,629,804,345,138,56,199,245,2106
1931,12,1997,33,1,4,82,82,2998,864,1571,0.55,0,13,0,864,1558,0.555,521,690,0.755,193,616,809,368,113,48,233,217,2249
1931,13,1998,34,1,4,81,81,3030,780,1472,0.53,2,6,0.333,778,1466,0.531,628,825,0.761,189,645,834,316,96,70,247,237,2190
1931,14,1999,35,1,4,49,49,1832,393,797,0.493,0,1,0,393,796,0.494,378,480,0.788,107,356,463,201,62,28,162,134,1164
1931,15,2000,36,1,4,82,82,2947,752,1476,0.509,2,8,0.25,750,1468,0.511,589,739,0.797,169,610,779,304,79,71,231,229,2095
1931,16,2001,37,1,4,81,81,2895,670,1345,0.498,2,5,0.4,668,1340,0.499,536,676,0.793,114,555,669,361,93,62,244,216,1878
1931,17,2002,38,1,4,80,80,3040,635,1399,0.454,9,25,0.36,626,1374,0.456,509,639,0.797,142,544,686,341,152,59,263,229,1788
1931,18,2003,39,1,4,81,81,2936,595,1289,0.462,3,14,0.214,592,1275,0.464,474,621,0.763,113,515,628,379,136,31,210,204,1667
1931,19,2004,40,1,4,42,42,1373,193,400,0.483,0,1,0,193,399,0.484,168,225,0.747,61,306,367,163,50,20,103,116,554
1932,1,1980,23,1,4,10,-1,162,8,25,0.32,0,0,-1,8,25,0.32,10,14,0.714,9,19,28,14,2,5,9,16,26
1932,1,1980,23,1,4,28,-1,277,23,42,0.548,0,0,-1,23,42,0.548,7,9,0.778,27,31,58,12,5,1,14,35,53
1932,1,1980,23,1,4,39,-1,445,31,67,0.463,0,0,-1,31,67,0.463,18,27,0.667,36,50,86,26,8,6,23,51,80
1933,1,1980,24,1,5,82,-1,3140,778,1549,0.502,0,6,0,778,1543,0.504,563,783,0.719,573,617,1190,147,80,107,300,210,2119
1933,2,1981,25,1,5,80,-1,3245,806,1545,0.522,1,3,0.333,805,1542,0.522,609,804,0.757,474,706,1180,141,83,150,308,223,2222
1933,3,1982,26,1,5,81,81,3398,945,1822,0.519,0,6,0,945,1816,0.52,630,827,0.762,558,630,1188,142,76,125,294,208,2520
1933,4,1983,27,1,5,78,78,2922,654,1305,0.501,0,1,0,654,1304,0.502,600,788,0.761,445,749,1194,101,89,157,264,206,1908
1933,5,1984,28,1,5,71,71,2613,532,1101,0.483,0,4,0,532,1097,0.485,545,727,0.75,352,598,950,96,71,110,250,188,1609
1933,6,1985,29,1,5,79,79,2957,602,1284,0.469,0,2,0,602,1282,0.47,737,904,0.815,385,646,1031,130,67,123,286,216,1941
1933,7,1986,30,1,5,74,74,2706,571,1246,0.458,0,1,0,571,1245,0.459,617,784,0.787,339,533,872,90,67,71,261,194,1759
1933,8,1987,31,1,5,73,70,2488,595,1311,0.454,0,11,0,595,1300,0.458,570,692,0.824,340,484,824,120,59,92,202,139,1760
1933,9,1988,32,1,5,79,78,2692,531,1090,0.487,2,7,0.286,529,1083,0.488,543,689,0.788,372,512,884,112,59,72,249,160,1607
1933,10,1989,33,1,5,81,80,2878,538,1096,0.491,0,12,0,538,1084,0.496,561,711,0.789,386,570,956,112,79,100,245,154,1637
1933,11,1990,34,1,5,81,81,2735,517,1077,0.48,1,9,0.111,516,1068,0.483,493,631,0.781,364,448,812,130,47,84,232,158,1528
1933,12,1991,35,1,5,82,15,1912,280,598,0.468,0,7,0,280,591,0.474,309,372,0.831,271,396,667,68,30,74,137,134,869
1933,13,1992,36,1,5,82,77,2511,440,929,0.474,3,8,0.375,437,921,0.474,396,504,0.786,320,424,744,93,74,64,150,136,1279
1933,14,1993,37,1,5,11,0,104,13,42,0.31,0,0,-1,13,42,0.31,24,31,0.774,22,24,46,7,1,8,10,6,50
1933,15,1994,38,1,5,55,0,618,102,232,0.44,0,1,0,102,231,0.442,90,117,0.769,106,120,226,34,11,17,59,52,294
1933,16,1995,39,1,5,17,0,149,13,35,0.371,1,2,0.5,12,33,0.364,22,32,0.688,20,26,46,6,2,3,11,15,49
1939,1,1996,25,1,4,29,0,311,49,113,0.434,0,1,0,49,112,0.438,9,14,0.643,16,39,55,7,3,6,17,37,107
1939,2,1997,26,1,4,16,1,128,18,48,0.375,2,3,0.667,16,45,0.356,6,8,0.75,8,15,23,2,3,1,5,18,44
1939,2,1997,26,1,4,26,2,201,32,82,0.39,2,4,0.5,30,78,0.385,9,14,0.643,16,23,39,3,4,2,7,29,75
1940,1,1984,23,1,3,57,0,469,50,126,0.397,3,13,0.231,47,113,0.416,18,23,0.783,23,36,59,47,25,2,23,63,121
1940,2,1985,24,1,3,34,0,190,27,63,0.429,0,1,0,27,62,0.435,16,23,0.696,12,11,23,27,16,3,18,17,70
1940,3,1986,25,1,3,57,0,673,97,214,0.453,8,42,0.19,89,172,0.517,53,82,0.646,26,56,82,55,32,5,41,68,255
1940,4,1987,26,1,3,23,3,284,31,94,0.33,3,9,0.333,28,85,0.329,18,31,0.581,10,29,39,45,18,4,23,32,83
1940,5,1988,27,1,3,35,1,477,48,118,0.407,2,12,0.167,46,106,0.434,25,37,0.676,17,34,51,55,13,7,24,53,123
1941,1,1989,22,1,4,26,18,950,177,358,0.494,1,5,0.2,176,353,0.499,79,103,0.767,70,101,171,81,44,25,93,89,434
1941,2,1990,23,1,4,71,42,2269,440,826,0.533,0,5,0,440,821,0.536,274,370,0.741,142,280,422,187,91,39,188,261,1154
1941,3,1991,24,1,4,73,47,2197,470,905,0.519,0,3,0,470,902,0.521,219,306,0.716,169,257,426,196,117,62,188,281,1159
1941,4,1992,25,1,4,82,82,2904,650,1199,0.542,0,5,0,650,1194,0.544,279,385,0.725,229,335,564,285,135,122,210,293,1579
1941,5,1993,26,1,4,79,77,2761,702,1379,0.509,8,30,0.267,694,1349,0.514,388,484,0.802,198,322,520,207,108,101,230,323,1800
1941,6,1994,27,1,4,26,25,925,177,372,0.476,1,3,0.333,176,369,0.477,54,83,0.651,49,120,169,85,46,25,86,93,409
1941,6,1994,27,1,4,42,41,1595,409,829,0.493,2,14,0.143,407,815,0.499,174,258,0.674,82,214,296,176,53,57,147,167,994
1941,6,1994,27,1,4,68,66,2520,586,1201,0.488,3,17,0.176,583,1184,0.492,228,341,0.669,131,334,465,261,99,82,233,260,1403
1941,7,1995,28,1,4,46,19,1510,340,622,0.547,6,21,0.286,334,601,0.556,136,202,0.673,97,179,276,154,41,57,121,176,822
1941,8,1996,29,1,4,33,4,816,178,388,0.459,3,14,0.214,175,374,0.468,82,109,0.752,30,113,143,65,38,24,77,121,441
1941,9,1997,30,1,4,77,17,2134,426,795,0.536,7,36,0.194,419,759,0.552,181,251,0.721,137,332,469,173,81,74,161,268,1040
1941,10,1998,31,1,4,70,11,1794,390,756,0.516,0,7,0,390,749,0.521,167,226,0.739,110,282,392,139,71,46,100,201,947
1941,11,1999,32,1,4,50,5,1184,187,386,0.484,1,9,0.111,186,377,0.493,78,112,0.696,62,157,219,113,36,38,69,129,453
1941,12,2000,33,1,4,72,0,1217,149,339,0.44,1,4,0.25,148,335,0.442,34,52,0.654,50,158,208,73,62,29,55,183,333
1941,13,2001,34,1,4,82,0,1305,247,500,0.494,7,28,0.25,240,472,0.508,102,140,0.729,66,148,214,92,47,29,96,219,603
1941,14,2002,35,1,4,41,10,552,71,149,0.477,1,7,0.143,70,142,0.493,22,33,0.667,25,83,108,30,21,21,25,80,165
1943,1,1980,32,1,2,26,4,442,123,249,0.494,3,4,0.75,120,245,0.49,50,55,0.909,10,28,38,29,9,2,37,49,299
1943,1,1980,32,1,2,17,-1,522,121,294,0.412,7,11,0.636,114,283,0.403,41,50,0.82,7,33,40,54,15,4,45,30,290
1943,1,1980,32,1,2,43,4,964,244,543,0.449,10,15,0.667,234,528,0.443,91,105,0.867,17,61,78,83,24,6,82,79,589
1946,1,2007,21,1,4,30,0,170,19,52,0.365,6,16,0.375,13,36,0.361,7,11,0.636,11,20,31,6,3,1,15,22,51
1950,1,1997,19,1,1,67,64,2324,355,871,0.408,102,288,0.354,253,583,0.434,245,337,0.727,54,130,184,522,67,19,210,159,1057
1950,2,1998,20,1,1,82,81,3112,513,1237,0.415,95,304,0.313,418,933,0.448,329,450,0.731,58,172,230,704,104,7,256,222,1450
1950,3,1999,21,1,1,18,18,661,124,304,0.408,8,39,0.205,116,265,0.438,63,87,0.724,17,45,62,167,29,5,55,44,319
1950,3,1999,21,1,1,31,31,1234,254,579,0.439,58,158,0.367,196,421,0.466,159,191,0.832,20,60,80,270,30,3,109,81,725
1950,3,1999,21,1,1,49,49,1895,378,883,0.428,66,197,0.335,312,686,0.455,222,278,0.799,37,105,142,437,59,8,164,125,1044
1950,4,2000,22,1,1,74,74,2881,569,1317,0.432,66,233,0.283,503,1084,0.464,436,536,0.813,61,179,240,622,112,15,270,195,1640
1950,5,2001,23,1,1,67,67,2557,563,1277,0.441,110,335,0.328,453,942,0.481,362,458,0.79,53,152,205,506,79,5,197,150,1598
1950,6,2002,24,1,1,82,80,3187,625,1413,0.442,71,248,0.286,554,1165,0.476,353,452,0.781,75,191,266,666,77,13,284,186,1674
1950,7,2003,25,1,1,81,81,3240,671,1530,0.439,89,296,0.301,582,1234,0.472,375,467,0.803,53,210,263,654,108,20,263,200,1806
1950,8,2004,26,1,1,34,34,1415,262,606,0.432,37,118,0.314,225,488,0.461,147,185,0.795,19,98,117,281,64,5,97,74,708
1950,8,2004,26,1,1,47,47,1839,336,780,0.431,50,156,0.321,286,624,0.458,209,251,0.833,39,107,146,438,65,4,152,98,931
1950,8,2004,26,1,1,81,81,3254,598,1386,0.431,87,274,0.318,511,1112,0.46,356,436,0.817,58,205,263,719,129,9,249,172,1639
1950,9,2005,27,1,1,82,82,3281,604,1308,0.462,115,325,0.354,489,983,0.497,458,549,0.834,50,198,248,668,122,6,233,186,1781
1950,10,2006,28,1,1,60,60,2193,349,774,0.451,33,104,0.317,316,670,0.472,246,326,0.755,25,150,175,382,63,4,157,143,977
1950,11,2007,29,1,1,74,74,2748,395,952,0.415,123,345,0.357,272,607,0.448,297,386,0.769,36,177,213,403,71,10,179,185,1210
1950,12,2008,30,1,1,24,19,805,111,265,0.419,28,74,0.378,83,191,0.435,83,116,0.716,17,42,59,113,21,2,48,57,333
1950,13,2009,31,1,1,23,4,414,38,111,0.342,6,25,0.24,32,86,0.372,6,13,0.462,2,26,28,75,10,3,37,34,88
1952,1,1995,21,1,3,40,8,1036,158,423,0.374,32,106,0.302,126,317,0.397,83,122,0.68,64,132,196,57,25,50,58,63,431
1952,1,1995,21,1,3,32,23,1050,187,453,0.413,37,137,0.27,150,316,0.475,64,100,0.64,73,136,209,48,20,38,57,94,475
1952,1,1995,21,1,3,72,31,2086,345,876,0.394,69,243,0.284,276,633,0.436,147,222,0.662,137,268,405,105,45,88,115,157,906
1952,2,1996,22,1,3,62,6,934,125,314,0.398,28,94,0.298,97,220,0.441,64,83,0.771,65,148,213,49,22,31,48,83,342
1952,3,1997,23,1,3,61,20,1022,174,421,0.413,35,111,0.315,139,310,0.448,61,98,0.622,92,184,276,54,25,46,55,96,444
1952,4,1998,24,1,3,73,73,2611,451,1090,0.414,63,201,0.313,388,889,0.436,158,216,0.731,210,418,628,159,95,73,147,226,1123
1952,5,1999,25,1,3,48,20,1250,208,494,0.421,26,72,0.361,182,422,0.431,88,121,0.727,115,227,342,66,47,37,80,123,530
1952,6,2000,26,1,4,64,51,2071,331,840,0.394,49,138,0.355,282,702,0.402,199,255,0.78,189,448,637,167,68,68,123,180,910
1952,7,2001,27,1,3,81,49,2326,427,849,0.503,41,128,0.32,386,721,0.535,205,273,0.751,172,394,566,133,85,78,128,196,1100
1952,8,2002,28,1,3,58,42,1750,343,661,0.519,13,42,0.31,330,619,0.533,160,226,0.708,158,285,443,101,50,67,124,150,859
1952,9,2003,29,1,4,78,53,2378,421,918,0.459,33,87,0.379,388,831,0.467,167,221,0.756,234,465,699,137,95,85,135,234,1042
1952,10,2004,30,1,4,16,8,408,57,136,0.419,11,27,0.407,46,109,0.422,14,20,0.7,28,71,99,28,13,20,22,47,139
1952,10,2004,30,1,4,66,66,2580,413,884,0.467,120,298,0.403,293,586,0.5,120,162,0.741,182,527,709,94,80,104,95,200,1066
1952,10,2004,30,1,4,82,74,2988,470,1020,0.461,131,325,0.403,339,695,0.488,134,182,0.736,210,598,808,122,93,124,117,247,1205
1952,11,2005,31,1,4,65,2,1645,262,592,0.443,151,363,0.416,111,229,0.485,72,91,0.791,95,333,428,81,57,46,42,136,747
1952,12,2006,32,1,4,81,0,2077,265,671,0.395,128,395,0.324,137,276,0.496,92,123,0.748,105,387,492,60,59,41,90,160,750
1952,13,2007,33,1,4,81,0,1360,209,493,0.424,95,271,0.351,114,222,0.514,53,80,0.663,86,237,323,46,39,43,67,130,566
1952,14,2008,34,1,4,11,1,156,13,44,0.295,8,23,0.348,5,21,0.238,7,9,0.778,9,21,30,5,2,9,6,16,41
1952,14,2008,34,1,4,15,0,184,19,54,0.352,7,30,0.233,12,24,0.5,12,13,0.923,15,31,46,5,4,7,9,15,57
1952,14,2008,34,1,4,26,1,340,32,98,0.327,15,53,0.283,17,45,0.378,19,22,0.864,24,52,76,10,6,16,15,31,98
1952,15,2009,35,1,4,25,0,189,33,73,0.452,25,55,0.455,8,18,0.444,3,6,0.5,6,34,40,15,4,5,6,24,94
1954,1,1986,23,1,3,66,0,691,143,298,0.48,0,8,0,143,290,0.493,46,54,0.852,42,60,102,52,21,7,58,108,332
1954,2,1988,25,1,3,10,0,101,16,51,0.314,0,1,0,16,50,0.32,8,13,0.615,9,18,27,6,5,0,9,16,40
1955,1,1994,24,1,5,53,1,535,40,88,0.455,0,0,-1,40,88,0.455,31,51,0.608,36,81,117,17,8,33,29,106,111
1957,1,2006,23,1,3,23,9,241,24,60,0.4,1,3,0.333,23,57,0.404,22,29,0.759,8,23,31,10,8,7,15,17,71
1957,2,2007,24,1,2,40,2,361,32,89,0.36,4,18,0.222,28,71,0.394,31,45,0.689,8,21,29,13,12,5,19,22,99
1963,1,1987,22,1,3,43,0,286,51,135,0.378,3,15,0.2,48,120,0.4,42,66,0.636,12,29,41,35,13,6,33,48,147
1963,2,1988,23,1,3,26,0,136,23,61,0.377,1,4,0.25,22,57,0.386,10,21,0.476,13,11,24,14,6,3,10,21,57
1964,1,1987,24,1,5,24,0,146,9,31,0.29,0,1,0,9,30,0.3,4,11,0.364,8,20,28,9,7,1,20,24,22
1967,1,1990,23,1,2,69,23,1351,170,414,0.411,2,15,0.133,168,399,0.421,91,129,0.705,78,81,159,44,41,16,47,97,433
1967,2,1991,24,1,1,74,26,1334,214,507,0.422,27,88,0.307,187,419,0.446,68,100,0.68,53,78,131,65,37,31,49,104,523
1968,1,1994,21,1,3,79,73,2896,561,1382,0.406,85,299,0.284,476,1083,0.44,306,438,0.699,107,246,353,266,89,14,245,205,1513
1968,2,1995,22,1,3,80,80,2980,683,1566,0.436,113,344,0.328,570,1222,0.466,447,605,0.739,116,215,331,298,82,8,235,190,1926
1968,3,1996,23,1,3,18,18,669,145,383,0.379,35,102,0.343,110,281,0.391,97,133,0.729,37,60,97,50,14,3,55,39,422
1968,4,1997,24,1,3,37,21,975,140,376,0.372,42,131,0.321,98,245,0.4,72,111,0.649,28,87,115,93,35,5,57,69,394
1968,4,1997,24,1,3,32,30,1189,146,367,0.398,48,146,0.329,98,221,0.443,88,117,0.752,41,138,179,111,43,7,57,117,428
1968,4,1997,24,1,3,69,51,2164,286,743,0.385,90,277,0.325,196,466,0.421,160,228,0.702,69,225,294,204,78,12,114,186,822
1968,5,1998,25,1,3,48,48,1729,251,577,0.435,37,122,0.303,214,455,0.47,184,231,0.797,72,164,236,132,43,14,108,137,723
1968,6,1999,26,1,3,24,23,855,134,297,0.451,13,30,0.433,121,267,0.453,75,104,0.721,24,122,146,75,20,3,60,58,356
1968,7,2000,27,1,3,76,76,2828,515,1158,0.445,112,278,0.403,403,880,0.458,186,239,0.778,64,317,381,298,79,14,180,215,1328
1968,8,2001,28,1,3,76,76,2989,573,1388,0.413,103,289,0.356,470,1099,0.428,279,364,0.766,92,484,576,411,85,13,211,185,1528
1968,9,2002,29,1,3,40,40,1601,303,744,0.407,41,112,0.366,262,632,0.415,211,241,0.876,31,211,242,171,45,6,110,80,858
1968,10,2003,30,1,3,82,81,3321,670,1586,0.422,119,306,0.389,551,1280,0.43,313,369,0.848,66,432,498,462,83,17,230,196,1772
1968,11,2004,31,1,3,19,18,730,156,398,0.392,19,67,0.284,137,331,0.414,65,80,0.813,19,98,117,47,14,5,37,42,396
1969,1,2001,23,1,3,78,14,1522,189,439,0.431,18,67,0.269,171,372,0.46,67,91,0.736,72,177,249,63,39,20,53,146,463
1969,2,2002,24,1,3,75,20,2420,357,769,0.464,16,59,0.271,341,710,0.48,201,237,0.848,92,259,351,104,67,27,104,170,931
1969,3,2003,25,1,3,28,25,952,166,350,0.474,5,17,0.294,161,333,0.483,78,102,0.765,66,122,188,68,20,11,41,74,415
1969,3,2003,25,1,3,52,15,1811,291,667,0.436,16,55,0.291,275,612,0.449,134,181,0.74,88,247,335,95,47,21,74,136,732
1969,3,2003,25,1,3,80,40,2763,457,1017,0.449,21,72,0.292,436,945,0.461,212,283,0.749,154,369,523,163,67,32,115,210,1147
1969,4,2004,26,1,3,82,31,2534,409,867,0.472,9,39,0.231,400,828,0.483,356,463,0.769,93,266,359,152,60,24,148,191,1183
1969,5,2005,27,1,3,80,71,2893,478,1079,0.443,1,8,0.125,477,1071,0.445,420,524,0.802,85,227,312,217,58,27,164,198,1377
1969,6,2006,28,1,3,70,55,2102,275,690,0.399,1,6,0.167,274,684,0.401,206,302,0.682,64,234,298,66,42,17,113,136,757
1969,7,2007,29,1,3,75,75,2575,407,900,0.452,0,0,-1,407,900,0.452,214,323,0.663,124,221,345,115,52,22,192,174,1028
1969,8,2008,30,1,3,59,56,1702,230,477,0.482,0,0,-1,230,477,0.482,114,173,0.659,75,181,256,121,40,30,83,106,574
1969,9,2009,31,1,2,39,19,1064,124,285,0.435,0,3,0,124,282,0.44,46,85,0.541,41,116,157,46,15,30,56,96,294
1974,1,1993,23,1,4,43,3,520,93,169,0.55,0,1,0,93,168,0.554,45,70,0.643,66,98,164,12,11,18,38,75,231
1974,2,1994,24,1,4,55,2,626,89,167,0.533,0,2,0,89,165,0.539,70,98,0.714,75,124,199,10,16,33,40,113,248
1975,1,1980,24,1,3,80,80,2744,457,750,0.609,0,0,-1,457,750,0.609,436,554,0.787,284,420,704,199,76,61,230,266,1350
1975,2,1981,25,1,3,81,81,2730,441,750,0.588,0,1,0,441,749,0.589,352,450,0.782,222,303,525,219,79,68,180,256,1234
1975,3,1982,26,1,3,78,73,2590,397,724,0.548,0,3,0,397,721,0.551,357,478,0.747,218,281,499,183,79,49,174,263,1151
1975,4,1983,27,1,3,79,71,2252,331,663,0.499,0,1,0,331,662,0.5,280,345,0.812,185,237,422,186,65,39,165,202,942
1975,5,1984,28,1,3,80,78,2502,317,596,0.532,1,6,0.167,316,590,0.536,320,425,0.753,201,260,461,205,63,24,203,224,955
1975,6,1985,29,1,3,57,51,1495,201,377,0.533,0,2,0,201,375,0.536,231,278,0.831,98,144,242,102,36,15,98,140,633
1975,7,1986,30,1,3,76,72,2458,314,661,0.475,0,3,0,314,658,0.477,447,562,0.795,241,383,624,215,61,29,206,252,1075
1975,8,1987,31,1,3,46,0,836,103,188,0.548,0,1,0,103,187,0.551,126,163,0.773,72,112,184,75,13,5,48,76,332
1975,8,1987,31,1,3,35,31,1132,150,289,0.519,0,0,-1,150,289,0.519,177,228,0.776,103,148,251,122,26,9,88,102,477
1975,8,1987,31,1,3,81,31,1968,253,477,0.53,0,1,0,253,476,0.532,303,391,0.775,175,260,435,197,39,14,136,178,809
1975,9,1988,32,1,3,71,0,848,80,171,0.468,0,2,0,80,169,0.473,110,143,0.769,74,105,179,60,22,12,54,75,270
1976,1,1989,23,1,2,79,36,2065,357,827,0.432,32,129,0.248,325,698,0.466,181,243,0.745,49,153,202,301,86,8,178,136,927
1976,2,1990,24,1,2,30,10,869,142,321,0.442,13,53,0.245,129,268,0.481,77,116,0.664,15,72,87,150,42,5,72,69,374
1976,2,1990,24,1,2,49,2,1118,133,306,0.435,15,52,0.288,118,254,0.465,59,95,0.621,35,106,141,146,42,5,71,79,340
1976,2,1990,24,1,2,79,12,1987,275,627,0.439,28,105,0.267,247,522,0.473,136,211,0.645,50,178,228,296,84,10,143,148,714
1976,3,1991,25,1,2,82,79,2870,504,1247,0.404,172,510,0.337,332,737,0.45,217,296,0.733,41,197,238,303,127,15,171,179,1397
1976,4,1992,26,1,2,80,80,2700,502,1216,0.413,162,473,0.342,340,743,0.458,206,267,0.772,37,206,243,326,104,28,178,200,1372
1976,5,1993,27,1,2,71,68,2251,349,858,0.407,120,361,0.332,229,497,0.461,164,228,0.719,29,192,221,297,86,8,140,124,982
1976,6,1994,28,1,2,75,73,2571,380,976,0.389,120,403,0.298,260,573,0.454,143,191,0.749,42,187,229,380,125,20,185,143,1023
1976,7,1995,29,1,2,64,54,2038,306,777,0.394,143,441,0.324,163,336,0.485,99,144,0.688,18,146,164,274,75,13,137,157,854
1976,8,1996,30,1,1,75,57,2467,410,1052,0.39,146,460,0.317,264,592,0.446,251,332,0.756,39,190,229,330,96,12,215,182,1217
1976,9,1997,31,1,2,72,31,2068,340,906,0.375,115,372,0.309,225,534,0.421,134,180,0.744,27,132,159,153,87,19,121,168,929
1976,10,1998,32,1,2,11,0,169,26,78,0.333,6,26,0.231,20,52,0.385,23,26,0.885,5,8,13,12,2,1,12,20,81
1976,10,1998,32,1,2,31,0,467,77,180,0.428,31,86,0.36,46,94,0.489,25,34,0.735,9,35,44,40,14,3,28,51,210
1976,10,1998,32,1,2,42,0,636,103,258,0.399,37,112,0.33,66,146,0.452,48,60,0.8,14,43,57,52,16,4,40,71,291
1976,11,1999,33,1,2,46,1,1007,164,421,0.39,80,231,0.346,84,190,0.442,84,114,0.737,13,72,85,76,30,3,67,111,492
1976,12,2000,34,1,2,47,0,989,169,490,0.345,67,223,0.3,102,267,0.382,108,148,0.73,15,64,79,75,38,9,53,83,513
1976,13,2001,35,1,1,19,0,285,31,98,0.316,13,47,0.277,18,51,0.353,6,10,0.6,1,28,29,20,9,3,17,31,81
1976,13,2001,35,1,1,24,6,375,42,125,0.336,21,64,0.328,21,61,0.344,15,22,0.682,3,34,37,29,12,0,18,33,120
1976,13,2001,35,1,1,43,6,660,73,223,0.327,34,111,0.306,39,112,0.348,21,32,0.656,4,62,66,49,21,3,35,64,201
1978,1,1980,25,1,3,54,-1,1298,264,587,0.45,0,4,0,264,583,0.453,144,172,0.837,78,140,218,104,45,5,77,126,672
1978,2,1981,26,1,3,63,-1,815,165,338,0.488,0,0,-1,165,338,0.488,113,149,0.758,62,93,155,63,35,7,71,83,443
1978,3,1982,27,1,3,65,7,1187,212,417,0.508,0,4,0,212,413,0.513,159,193,0.824,85,133,218,133,50,6,92,151,583
1978,4,1983,28,1,3,9,1,155,21,50,0.42,0,0,-1,21,50,0.42,17,21,0.81,10,16,26,12,5,2,13,24,59
1982,1,1992,23,1,2,21,0,215,28,94,0.298,14,39,0.359,14,55,0.255,20,30,0.667,3,12,15,32,14,1,28,32,90
1982,1,1992,23,1,2,24,0,255,30,99,0.303,15,41,0.366,15,58,0.259,24,36,0.667,3,13,16,35,16,2,31,41,99
1983,1,1993,22,1,1,82,4,1503,171,375,0.456,43,110,0.391,128,265,0.483,39,68,0.574,26,92,118,273,59,7,85,148,424
1983,2,1994,23,1,1,82,6,1472,167,402,0.415,41,119,0.345,126,283,0.445,58,84,0.69,26,75,101,215,46,4,97,114,433
1983,3,1995,24,1,1,82,50,1744,172,408,0.422,72,177,0.407,100,231,0.433,58,83,0.699,21,61,82,276,51,4,106,123,474
1983,4,1996,25,1,1,82,20,1705,153,364,0.42,75,189,0.397,78,175,0.446,41,68,0.603,21,69,90,302,64,10,89,144,422
1983,5,1997,26,1,1,80,38,1952,149,370,0.403,83,221,0.376,66,149,0.443,29,46,0.63,29,105,134,329,60,8,90,159,410
1983,6,1998,27,1,1,79,32,1835,131,349,0.375,63,180,0.35,68,169,0.402,38,51,0.745,19,95,114,349,65,10,113,164,363
1983,7,1999,28,1,1,9,0,126,7,19,0.368,2,10,0.2,5,9,0.556,4,5,0.8,0,3,3,23,7,0,11,13,20
1985,1,1991,22,1,1,64,55,2145,294,724,0.406,72,197,0.365,222,527,0.421,255,331,0.77,54,124,178,253,81,11,159,169,915
1985,2,1993,24,1,1,49,9,787,129,309,0.417,29,84,0.345,100,225,0.444,54,82,0.659,20,33,53,72,21,3,51,59,341
1988,1,1980,28,1,4,58,-1,2097,492,1025,0.48,3,24,0.125,489,1001,0.489,235,322,0.73,100,367,467,200,73,65,238,178,1222
1988,2,1981,29,1,4,10,-1,153,38,75,0.507,0,1,0,38,74,0.514,17,21,0.81,8,18,26,10,9,6,14,22,93
1988,2,1981,29,1,4,6,-1,168,30,82,0.366,0,0,-1,30,82,0.366,12,20,0.6,9,32,41,20,8,7,18,16,72
1988,2,1981,29,1,4,16,-1,321,68,157,0.433,0,1,0,68,156,0.436,29,41,0.707,17,50,67,30,17,13,32,38,165
1988,3,1982,30,1,5,41,0,746,151,330,0.458,0,5,0,151,325,0.465,90,126,0.714,45,114,159,32,22,36,51,109,392
1988,4,1983,31,1,5,47,1,1019,292,562,0.52,0,1,0,292,561,0.52,119,163,0.73,76,171,247,39,40,40,68,153,703
1988,5,1984,32,1,5,70,0,1456,352,748,0.471,0,5,0,352,743,0.474,212,264,0.803,82,207,289,74,42,50,127,182,916
1988,6,1985,33,1,5,66,0,1254,284,546,0.52,0,1,0,284,545,0.521,122,162,0.753,79,216,295,67,18,53,95,170,690
1988,7,1986,34,1,5,29,0,609,116,251,0.462,0,0,-1,116,251,0.462,62,81,0.765,25,78,103,35,10,18,49,64,294
1990,1,2006,21,1,2,79,12,1362,241,535,0.45,67,180,0.372,174,355,0.49,78,106,0.736,29,114,143,63,44,22,86,176,627
1990,2,2007,22,1,2,37,0,554,62,177,0.35,20,75,0.267,42,102,0.412,40,58,0.69,14,33,47,38,26,7,40,71,184
1990,3,2008,23,1,2,75,24,2020,428,944,0.453,142,349,0.407,286,595,0.481,116,155,0.748,50,156,206,162,66,18,172,234,1114
1990,4,2009,24,1,2,24,1,465,87,196,0.444,25,70,0.357,62,126,0.492,47,60,0.783,10,37,47,36,20,8,19,40,246
1990,4,2009,24,1,2,34,2,636,105,292,0.36,38,119,0.319,67,173,0.387,60,81,0.741,11,52,63,32,27,6,45,63,308
1990,4,2009,24,1,2,58,3,1101,192,488,0.393,63,189,0.333,129,299,0.431,107,141,0.759,21,89,110,68,47,14,64,103,554
1994,1,1997,22,1,4,35,0,192,26,68,0.382,4,14,0.286,22,54,0.407,8,14,0.571,8,15,23,13,7,9,17,38,64
1994,2,1998,23,1,3,82,64,2340,295,730,0.404,54,175,0.309,241,555,0.434,144,194,0.742,141,223,364,177,110,44,141,274,788
1994,3,1999,24,1,4,32,4,659,64,177,0.362,13,50,0.26,51,127,0.402,40,57,0.702,36,79,115,40,24,13,40,88,181
1994,4,2000,25,1,4,61,5,879,78,230,0.339,34,110,0.309,44,120,0.367,39,54,0.722,33,77,110,70,24,23,67,83,229
1994,5,2001,26,1,4,60,3,478,45,126,0.357,19,56,0.339,26,70,0.371,22,28,0.786,24,57,81,39,14,7,20,82,131
1994,6,2002,27,1,4,56,0,718,80,180,0.444,39,99,0.394,41,81,0.506,13,19,0.684,32,96,128,41,18,7,22,83,212
1994,7,2003,28,1,3,82,8,1949,173,418,0.414,91,248,0.367,82,170,0.482,61,98,0.622,64,224,288,106,78,28,67,188,498
1994,8,2004,29,1,4,77,23,1900,203,523,0.388,137,366,0.374,66,157,0.42,62,82,0.756,28,211,239,124,72,22,91,179,605
1994,9,2005,30,1,4,28,0,353,33,85,0.388,25,65,0.385,8,20,0.4,7,14,0.5,8,53,61,11,10,6,19,59,98
1994,9,2005,30,1,4,44,0,553,62,150,0.413,30,90,0.333,32,60,0.533,8,15,0.533,21,56,77,26,15,9,17,85,162
1994,9,2005,30,1,4,72,0,906,95,235,0.404,55,155,0.355,40,80,0.5,15,29,0.517,29,109,138,37,25,15,36,144,260
1994,10,2006,31,1,3,36,1,353,33,99,0.333,10,45,0.222,23,54,0.426,12,21,0.571,15,53,68,23,8,5,19,52,88
1995,1,1986,22,1,3,45,4,461,69,180,0.383,1,9,0.111,68,171,0.398,18,35,0.514,14,16,30,67,38,4,40,61,157
2002,1,1985,22,1,5,78,27,1584,269,483,0.557,0,1,0,269,482,0.558,188,263,0.715,146,252,398,78,18,33,114,207,726
2002,2,1986,23,1,5,77,42,1705,253,444,0.57,1,2,0.5,252,442,0.57,174,244,0.713,140,263,403,83,19,28,110,219,681
2002,3,1987,24,1,5,81,79,2817,391,718,0.545,0,4,0,391,714,0.548,251,349,0.719,180,431,611,114,36,64,153,270,1033
2002,4,1988,25,1,5,23,17,601,71,138,0.514,0,0,-1,71,138,0.514,37,53,0.698,49,95,144,26,14,8,35,75,179
2002,4,1988,25,1,5,47,38,1513,277,510,0.543,0,2,0,277,508,0.545,108,162,0.667,97,226,323,92,18,15,76,159,662
2002,4,1988,25,1,5,70,55,2114,348,648,0.537,0,2,0,348,646,0.539,145,215,0.674,146,321,467,118,32,23,111,234,841
2002,5,1989,26,1,5,81,0,1257,169,351,0.481,0,4,0,169,347,0.487,87,129,0.674,87,174,261,54,18,24,68,193,425
2002,6,1990,27,1,5,18,0,116,10,29,0.345,0,0,-1,10,29,0.345,10,19,0.526,8,19,27,3,3,1,10,24,30
2002,7,1991,28,1,5,56,7,689,93,187,0.497,0,3,0,93,184,0.505,66,90,0.733,56,109,165,32,11,14,45,91,252
2002,8,1992,29,1,5,22,0,108,14,33,0.424,0,0,-1,14,33,0.424,14,21,0.667,14,20,34,9,2,0,8,18,42
2005,1,1984,22,1,3,79,36,2081,335,672,0.499,1,4,0.25,334,668,0.5,182,249,0.731,173,277,450,176,53,54,120,205,853
2005,2,1985,23,1,3,82,82,3001,476,890,0.535,0,6,0,476,884,0.538,231,313,0.738,201,338,539,355,90,75,178,215,1183
2005,3,1986,24,1,3,82,82,2610,338,629,0.537,0,3,0,338,626,0.54,171,222,0.77,159,361,520,292,50,58,130,197,847
2005,4,1987,25,1,3,81,81,3136,432,783,0.552,0,9,0,432,774,0.558,306,393,0.779,190,388,578,434,88,53,208,172,1170
2005,5,1988,26,1,3,81,80,2689,359,746,0.481,0,4,0,359,742,0.484,288,367,0.785,232,399,631,264,57,51,144,166,1006
2005,6,1989,27,1,3,68,65,2435,340,729,0.466,5,22,0.227,335,707,0.474,169,234,0.722,143,371,514,293,57,36,168,121,854
2005,7,1990,28,1,3,82,82,3238,537,1043,0.515,11,42,0.262,526,1001,0.525,273,348,0.784,192,477,669,377,60,70,174,176,1358
2005,8,1991,29,1,4,74,68,2561,336,679,0.495,13,39,0.333,323,640,0.505,159,198,0.803,153,407,560,259,70,51,129,203,844
2005,9,1992,30,1,3,75,48,2106,271,622,0.436,25,85,0.294,246,537,0.458,110,153,0.719,149,319,468,219,48,30,115,180,677
2005,10,1993,31,1,3,64,5,1019,92,204,0.451,2,5,0.4,90,199,0.452,36,52,0.692,53,105,158,81,12,15,53,99,222
2007,1,1986,23,1,3,21,0,266,28,58,0.483,0,1,0,28,57,0.491,5,8,0.625,15,23,38,9,7,1,10,30,61
2007,2,1987,24,1,4,63,34,1284,164,360,0.456,1,8,0.125,163,352,0.463,24,38,0.632,63,120,183,84,27,8,43,200,353
2007,3,1988,25,1,4,81,41,2039,258,552,0.467,9,35,0.257,249,517,0.482,87,111,0.784,133,202,335,138,39,8,93,246,612
2007,4,1989,26,1,4,11,0,103,13,19,0.684,0,0,-1,13,19,0.684,9,15,0.6,4,8,12,5,4,0,3,11,35
2011,1,1982,22,1,4,30,1,335,34,84,0.405,0,0,-1,34,84,0.405,27,41,0.659,41,59,100,20,6,8,21,52,95
2011,2,1983,23,1,4,14,0,130,13,29,0.448,0,0,-1,13,29,0.448,14,18,0.778,15,15,30,4,2,4,8,26,40
2011,2,1983,23,1,4,42,0,375,45,97,0.464,0,2,0,45,95,0.474,33,43,0.767,39,50,89,20,6,7,32,58,123
2011,2,1983,23,1,4,56,0,505,58,126,0.46,0,2,0,58,124,0.468,47,61,0.77,54,65,119,24,8,11,40,84,163
2011,3,1984,24,1,4,57,0,611,85,197,0.431,0,3,0,85,194,0.438,38,56,0.679,63,92,155,37,14,2,49,77,208
2011,4,1985,25,1,4,34,0,132,20,42,0.476,0,1,0,20,41,0.488,7,10,0.7,7,15,22,9,3,5,8,22,47
2011,5,1986,26,1,4,22,0,204,24,42,0.571,0,1,0,24,41,0.585,17,25,0.68,12,37,49,6,1,3,10,25,65
2012,1,1980,26,1,1,31,-1,516,66,171,0.386,2,7,0.286,64,164,0.39,37,53,0.698,20,29,49,65,21,5,43,45,171
2012,1,1980,26,1,1,36,-1,1012,162,356,0.455,3,14,0.214,159,342,0.465,95,119,0.798,12,38,50,162,25,14,88,78,422
2012,1,1980,26,1,1,67,-1,1528,228,527,0.433,5,21,0.238,223,506,0.441,132,172,0.767,32,67,99,227,46,19,131,123,593
2012,2,1981,27,1,1,54,-1,680,78,202,0.386,1,8,0.125,77,194,0.397,48,59,0.814,10,38,48,84,20,9,79,62,205
2012,3,1982,28,1,1,20,17,349,52,125,0.416,1,5,0.2,51,120,0.425,29,36,0.806,6,11,17,39,8,3,22,44,134
2017,1,1982,22,1,3,39,0,352,80,172,0.465,0,4,0,80,168,0.476,31,53,0.585,34,15,49,16,18,3,34,59,191
2017,2,1983,23,1,3,39,7,381,69,163,0.423,1,7,0.143,68,156,0.436,17,23,0.739,33,20,53,26,11,5,27,50,156
2017,3,1984,24,1,3,77,45,1425,347,584,0.594,2,12,0.167,345,572,0.603,61,113,0.54,117,76,193,81,49,6,111,176,757
2017,4,1985,25,1,3,76,3,1170,329,612,0.538,22,61,0.361,307,551,0.557,94,160,0.588,97,68,165,71,39,7,81,147,774
2017,5,1986,26,1,3,71,19,1213,252,544,0.463,41,114,0.36,211,430,0.491,42,64,0.656,51,89,140,83,53,7,70,131,587
2017,6,1987,27,1,3,76,6,1420,311,677,0.459,86,229,0.376,225,448,0.502,80,137,0.584,71,88,159,149,61,2,104,156,788
2017,7,1988,28,1,2,11,0,117,22,52,0.423,5,19,0.263,17,33,0.515,2,6,0.333,4,12,16,13,5,0,7,6,51
2017,7,1988,28,1,3,37,0,886,201,478,0.421,48,141,0.34,153,337,0.454,74,96,0.771,51,61,112,58,47,6,58,75,524
2017,7,1988,28,1,3,48,0,1003,223,530,0.421,53,160,0.331,170,370,0.459,76,102,0.745,55,73,128,71,52,6,65,81,575
2017,8,1989,29,1,2,80,49,2027,434,917,0.473,93,255,0.365,341,662,0.515,77,144,0.535,73,116,189,116,80,12,124,184,1038
2017,9,1990,30,1,3,14,7,280,42,87,0.483,8,23,0.348,34,64,0.531,10,21,0.476,11,25,36,16,8,1,14,28,102
2019,1,1980,29,1,4,28,-1,784,132,302,0.437,1,8,0.125,131,294,0.446,104,181,0.575,88,149,237,112,32,6,93,116,369
2019,1,1980,29,1,4,45,-1,1424,268,584,0.459,1,7,0.143,267,577,0.463,166,307,0.541,134,328,462,221,69,17,188,187,703
2019,1,1980,29,1,4,73,-1,2208,400,886,0.451,2,15,0.133,398,871,0.457,270,488,0.553,222,477,699,333,101,23,281,303,1072
2019,2,1981,30,1,4,69,-1,1845,348,768,0.453,0,7,0,348,761,0.457,207,385,0.538,164,364,528,210,99,28,221,242,903
2019,3,1982,31,1,4,76,4,1341,141,378,0.373,0,3,0,141,375,0.376,72,159,0.453,93,305,398,204,96,28,131,198,354
2020,1,1998,18,1,3,64,17,1179,179,398,0.45,14,41,0.341,165,357,0.462,79,111,0.712,105,164,269,98,49,61,66,86,451
2020,2,1999,19,1,3,49,2,1106,168,385,0.436,8,35,0.229,160,350,0.457,114,157,0.726,120,158,278,113,52,66,80,94,458
2020,3,2000,20,1,3,79,34,2462,459,1018,0.451,18,65,0.277,441,953,0.463,277,392,0.707,188,313,501,263,90,151,160,201,1213
2020,4,2001,21,1,2,77,77,3087,788,1724,0.457,59,166,0.355,729,1558,0.468,430,587,0.733,192,388,580,352,116,118,198,160,2065
2020,5,2002,22,1,2,76,76,2912,715,1586,0.451,103,283,0.364,612,1303,0.47,415,555,0.748,150,447,597,400,119,73,189,139,1948
2020,6,2003,23,1,2,75,74,2954,829,1813,0.457,173,448,0.386,656,1365,0.481,576,726,0.793,121,367,488,411,124,59,195,156,2407
2020,7,2004,24,1,2,67,67,2675,653,1566,0.417,174,513,0.339,479,1053,0.455,398,500,0.796,95,307,402,370,93,42,179,129,1878
2020,8,2005,25,1,3,78,78,3182,715,1660,0.431,142,435,0.326,573,1225,0.468,431,557,0.774,71,413,484,448,135,52,201,167,2003
2020,9,2006,26,1,3,47,47,1745,410,1011,0.406,73,234,0.312,337,777,0.434,254,340,0.747,46,261,307,225,59,41,120,88,1147
2020,10,2007,27,1,2,71,71,2539,638,1480,0.431,126,381,0.331,512,1099,0.466,345,488,0.707,56,322,378,458,92,36,213,136,1747
2020,11,2008,28,1,2,66,62,2440,548,1307,0.419,86,295,0.292,462,1012,0.457,245,358,0.684,42,297,339,387,68,30,160,91,1427
2020,12,2009,29,1,2,35,35,1181,188,485,0.388,44,117,0.376,144,368,0.391,125,156,0.801,20,134,154,175,42,15,69,38,545
2020,13,2010,30,1,2,24,24,627,84,216,0.389,15,62,0.242,69,154,0.448,43,57,0.754,22,67,89,93,15,12,43,38,226
2020,13,2010,30,1,2,30,24,673,91,235,0.387,16,64,0.25,75,171,0.439,47,63,0.746,22,72,94,99,15,14,44,40,245
2020,14,2011,31,1,2,72,39,1686,227,514,0.442,30,88,0.341,197,426,0.462,90,129,0.698,49,202,251,252,66,34,102,101,574
2020,15,2012,32,1,3,52,0,837,101,231,0.437,15,33,0.455,86,198,0.434,56,83,0.675,23,131,154,110,16,15,53,35,273
2025,1,1981,23,1,4,82,1,1645,355,666,0.533,0,2,0,355,664,0.535,108,159,0.679,155,204,359,55,27,151,110,260,818
2025,2,1982,24,1,4,82,33,2332,465,875,0.531,0,0,-1,465,875,0.531,187,248,0.754,191,365,556,91,30,185,137,264,1117
2025,3,1983,25,1,4,82,13,2345,483,893,0.541,0,1,0,483,892,0.541,193,269,0.717,215,338,553,104,34,192,159,241,1159
2025,4,1984,26,1,4,82,10,2577,587,1055,0.556,1,3,0.333,586,1052,0.557,336,439,0.765,208,402,610,104,23,126,150,243,1511
2025,5,1985,27,1,4,79,31,2653,605,1062,0.57,0,6,0,605,1056,0.573,355,467,0.76,229,483,712,141,28,120,157,234,1565
2025,6,1986,28,1,4,68,62,2397,561,978,0.574,0,0,-1,561,978,0.574,326,420,0.776,171,380,551,181,29,134,149,192,1448
2025,7,1987,29,1,4,77,77,3060,790,1307,0.604,0,4,0,790,1303,0.606,428,512,0.836,247,516,763,198,38,172,197,240,2008
2025,8,1988,30,1,4,64,63,2390,550,911,0.604,0,0,-1,550,911,0.604,346,434,0.797,159,377,536,171,27,92,141,179,1446
2025,9,1989,31,1,4,78,74,2876,661,1211,0.546,0,4,0,661,1207,0.548,436,533,0.818,223,414,637,172,26,97,196,223,1758
2025,10,1990,32,1,4,82,25,2722,648,1181,0.549,23,69,0.333,625,1112,0.562,393,440,0.893,201,476,677,172,30,157,183,250,1712
2025,11,1991,33,1,4,68,10,2067,504,912,0.553,15,37,0.405,489,875,0.559,228,275,0.829,145,335,480,126,25,146,140,194,1251
2025,12,1992,34,1,4,56,1,1398,323,634,0.509,0,13,0,323,621,0.52,134,163,0.822,119,211,330,82,11,59,82,112,780
2025,13,1993,35,1,4,71,0,1656,298,649,0.459,2,18,0.111,296,631,0.469,164,195,0.841,95,263,358,73,16,59,92,126,762
2027,1,1995,22,1,5,55,0,534,34,71,0.479,0,0,-1,34,71,0.479,28,41,0.683,40,65,105,10,10,60,19,95,96
2027,2,1996,23,1,5,80,6,1195,62,145,0.428,0,0,-1,62,145,0.428,58,105,0.552,66,164,230,11,21,166,36,171,182
2027,3,1997,24,1,5,82,79,1477,130,276,0.471,1,7,0.143,129,269,0.48,53,107,0.495,132,198,330,23,39,164,62,247,314
2027,4,1998,25,1,5,78,72,1211,101,223,0.453,0,3,0,101,220,0.459,45,81,0.556,96,163,259,19,24,137,54,240,247
2027,5,1999,26,1,5,22,1,269,22,51,0.431,0,0,-1,22,51,0.431,4,6,0.667,31,23,54,2,9,32,13,59,48
2027,6,2000,27,1,5,66,53,1048,64,154,0.416,0,0,-1,64,154,0.416,29,56,0.518,106,124,230,36,26,117,38,205,157
2027,7,2001,28,1,5,18,3,193,10,28,0.357,0,0,-1,10,28,0.357,8,12,0.667,8,27,35,4,7,15,9,35,28
2034,1,1988,21,1,3,82,4,1706,255,519,0.491,11,30,0.367,244,489,0.499,173,224,0.772,115,213,328,107,70,63,108,237,694
2034,2,1989,22,1,3,82,82,2804,487,970,0.502,30,89,0.337,457,881,0.519,301,375,0.803,167,297,464,219,105,70,188,264,1305
2034,3,1990,23,1,3,80,80,2748,468,949,0.493,3,23,0.13,465,926,0.502,315,403,0.782,170,319,489,187,87,81,192,247,1254
2034,4,1991,24,1,3,73,55,2503,438,847,0.517,4,19,0.211,434,828,0.524,235,278,0.845,172,251,423,169,91,56,158,220,1115
2034,5,1992,25,1,3,52,44,1757,285,604,0.472,19,50,0.38,266,554,0.48,188,222,0.847,95,173,268,120,61,47,114,142,777
2034,6,1993,26,1,3,77,68,2439,387,780,0.496,40,112,0.357,347,668,0.519,220,297,0.741,121,206,327,197,105,58,152,208,1034
2034,7,1994,27,1,3,76,76,2613,355,710,0.5,9,31,0.29,346,679,0.51,192,254,0.756,129,273,402,327,111,49,228,248,911
2034,8,1995,28,1,3,81,81,2805,411,833,0.493,32,89,0.36,379,744,0.509,221,297,0.744,125,269,394,276,125,49,168,260,1075
2034,9,1996,29,1,3,75,75,2440,346,712,0.486,17,68,0.25,329,644,0.511,170,221,0.769,123,238,361,262,83,44,143,246,879
2034,10,1997,30,1,3,50,49,1449,148,379,0.391,15,58,0.259,133,321,0.414,89,123,0.724,80,161,241,135,47,30,83,141,400
2034,11,1998,31,1,3,57,4,1316,150,327,0.459,4,17,0.235,146,310,0.471,55,77,0.714,74,137,211,88,57,30,79,156,359
2034,12,1999,32,1,3,13,0,244,23,52,0.442,0,1,0,23,51,0.451,14,17,0.824,18,23,41,13,12,4,12,24,60
2034,13,2000,33,1,3,32,0,634,43,108,0.398,10,23,0.435,33,85,0.388,43,56,0.768,29,106,135,35,29,13,19,81,139
2034,14,2001,34,1,3,66,20,987,60,136,0.441,4,20,0.2,56,116,0.483,21,27,0.778,49,127,176,74,48,13,47,136,145
2034,15,2002,35,1,3,41,1,784,52,122,0.426,5,12,0.417,47,110,0.427,10,14,0.714,48,79,127,45,41,4,22,90,119
2035,1,1995,22,1,2,45,20,827,116,261,0.444,11,28,0.393,105,233,0.451,50,73,0.685,35,94,129,89,36,16,39,97,293
2035,2,1996,23,1,2,81,73,2259,337,722,0.467,38,117,0.325,299,605,0.494,152,199,0.764,86,218,304,205,92,21,135,205,864
2035,3,1997,24,1,2,41,8,775,53,156,0.34,23,55,0.418,30,101,0.297,41,49,0.837,13,80,93,84,34,15,48,61,170
2035,3,1997,24,1,2,42,3,850,97,209,0.464,18,48,0.375,79,161,0.491,51,61,0.836,27,101,128,77,43,7,42,69,263
2035,3,1997,24,1,2,83,11,1625,150,365,0.411,41,103,0.398,109,262,0.416,92,110,0.836,40,181,221,161,77,22,90,130,433
2035,4,1998,25,1,3,24,1,472,43,104,0.413,3,17,0.176,40,87,0.46,20,23,0.87,24,44,68,38,23,1,24,47,109
2035,4,1998,25,1,3,57,31,1341,96,277,0.347,9,46,0.196,87,231,0.377,22,32,0.688,34,129,163,137,78,12,52,117,223
2035,4,1998,25,1,3,81,32,1813,139,381,0.365,12,63,0.19,127,318,0.399,42,55,0.764,58,173,231,175,101,13,76,164,332
2035,5,1999,26,1,2,50,4,959,95,237,0.401,6,31,0.194,89,206,0.432,44,62,0.71,27,113,140,100,63,3,57,90,240
2035,6,2000,27,1,2,82,14,1952,244,593,0.411,44,121,0.364,200,472,0.424,121,146,0.829,47,199,246,240,108,18,113,194,653
2035,7,2001,28,1,2,76,33,2394,338,714,0.473,53,170,0.312,285,544,0.524,149,194,0.768,33,278,311,377,106,8,203,178,878
2035,8,2002,29,1,2,48,16,1471,220,490,0.449,51,128,0.398,169,362,0.467,96,122,0.787,26,166,192,179,56,14,93,74,587
2035,9,2003,30,1,3,80,40,2374,286,666,0.429,37,112,0.33,249,554,0.449,112,134,0.836,61,289,350,278,131,9,109,177,721
2035,10,2004,31,1,3,75,41,2112,265,577,0.459,75,172,0.436,190,405,0.469,84,111,0.757,45,208,253,195,85,23,103,142,689
2035,11,2005,32,1,2,68,3,1118,61,142,0.43,20,62,0.323,41,80,0.513,10,16,0.625,20,152,172,103,48,17,31,116,152
2035,12,2006,33,1,1,14,0,121,3,12,0.25,0,2,0,3,10,0.3,1,2,0.5,3,17,20,11,5,0,2,7,7
2035,13,2007,34,1,3,10,0,131,11,17,0.647,0,0,-1,11,17,0.647,0,0,-1,1,17,18,13,4,0,8,14,22
2037,1,2004,24,1,1,33,0,391,27,82,0.329,1,10,0.1,26,72,0.361,33,43,0.767,5,29,34,59,16,1,29,39,88
2037,2,2005,25,1,1,53,47,1382,143,408,0.35,18,72,0.25,125,336,0.372,112,146,0.767,20,93,113,236,63,12,99,138,416
2037,3,2006,26,1,1,66,32,1232,120,340,0.353,24,82,0.293,96,258,0.372,106,133,0.797,11,67,78,151,42,9,76,131,370
2037,4,2007,27,1,1,22,7,339,32,83,0.386,7,22,0.318,25,61,0.41,22,25,0.88,1,21,22,45,7,2,23,30,93
2037,4,2007,27,1,1,26,2,379,41,105,0.39,9,23,0.391,32,82,0.39,47,53,0.887,3,18,21,45,17,3,23,21,138
2037,4,2007,27,1,1,48,9,718,73,188,0.388,16,45,0.356,57,143,0.399,69,78,0.885,4,39,43,90,24,5,46,51,231
2041,1,1999,23,1,3,34,0,348,62,163,0.38,1,10,0.1,61,153,0.399,37,45,0.822,12,38,50,14,2,1,23,24,162
2041,2,2000,24,1,3,44,20,860,131,332,0.395,2,13,0.154,129,319,0.404,54,70,0.771,41,97,138,52,16,5,59,84,318
2041,3,2001,25,1,3,34,25,907,144,330,0.436,2,21,0.095,142,309,0.46,45,51,0.882,37,81,118,58,23,8,57,88,335
2041,3,2001,25,1,3,35,25,922,145,332,0.437,2,22,0.091,143,310,0.461,45,51,0.882,38,82,120,58,23,8,58,90,337
2043,1,1987,22,1,1,71,50,1972,143,301,0.475,0,7,0,143,294,0.486,87,141,0.617,101,230,331,583,125,45,155,238,373
2043,2,1988,23,1,1,82,82,2453,235,496,0.474,9,24,0.375,226,472,0.479,145,205,0.707,117,221,338,702,169,47,189,238,624
2043,3,1989,24,1,1,75,74,2341,199,485,0.41,15,70,0.214,184,415,0.443,119,189,0.63,143,245,388,696,156,42,211,236,532
2043,4,1990,25,1,2,82,69,2338,207,438,0.473,11,31,0.355,196,407,0.482,98,153,0.641,127,276,403,598,140,37,187,289,523
2043,5,1991,26,1,2,78,0,1434,132,305,0.433,17,48,0.354,115,257,0.447,57,93,0.613,71,180,251,371,104,20,122,211,338
2043,6,1992,27,1,1,72,30,1652,177,405,0.437,27,98,0.276,150,307,0.489,54,84,0.643,92,160,252,359,129,29,112,218,435
2043,7,1993,28,1,1,73,25,1977,213,459,0.464,25,65,0.385,188,394,0.477,95,134,0.709,84,222,306,384,173,33,139,240,546
2043,8,1994,29,1,1,73,8,1887,177,396,0.447,52,133,0.391,125,263,0.475,31,55,0.564,50,233,283,387,216,22,126,201,437
2043,9,1995,30,1,1,80,18,2070,166,397,0.418,53,155,0.342,113,242,0.467,34,58,0.586,65,237,302,421,165,53,126,275,419
2043,10,1996,31,1,1,55,14,1261,100,238,0.42,46,121,0.38,54,117,0.462,29,41,0.707,41,169,210,197,95,18,75,143,275
2043,11,1997,32,1,1,37,2,798,61,149,0.409,28,84,0.333,33,65,0.508,19,29,0.655,15,103,118,140,58,6,32,78,169
2043,12,1998,33,1,2,18,1,279,23,67,0.343,15,34,0.441,8,33,0.242,1,1,1,13,27,40,55,14,4,12,41,62
2044,1,1980,27,1,5,53,-1,1071,191,382,0.5,0,1,0,191,381,0.501,81,107,0.757,70,150,220,62,36,14,64,126,463
2044,2,1981,28,1,5,79,-1,1564,253,519,0.487,1,6,0.167,252,513,0.491,80,108,0.741,96,199,295,72,23,25,81,165,587
2044,3,1982,29,1,5,73,23,1792,291,572,0.509,1,3,0.333,290,569,0.51,140,170,0.824,102,234,336,129,25,24,124,202,723
2044,4,1983,30,1,5,61,4,1364,198,424,0.467,0,1,0,198,423,0.468,108,133,0.812,57,160,217,76,17,24,80,143,504
2044,5,1984,31,1,5,62,5,1294,222,447,0.497,1,6,0.167,221,441,0.501,127,156,0.814,64,135,199,73,14,17,70,162,572
2044,6,1985,32,1,5,69,21,1547,252,534,0.472,0,5,0,252,529,0.476,112,135,0.83,64,146,210,52,8,17,44,163,616
2044,7,1986,33,1,5,56,1,863,131,285,0.46,0,3,0,131,282,0.465,64,79,0.81,44,69,113,35,9,10,34,85,326
2047,1,1986,24,1,4,30,6,627,70,144,0.486,0,0,-1,70,144,0.486,31,47,0.66,62,141,203,41,38,12,35,88,171
2047,2,1987,25,1,4,59,16,972,88,179,0.492,0,0,-1,88,179,0.492,52,80,0.65,74,153,227,46,36,16,64,136,228
2047,3,1988,26,1,4,19,0,265,23,74,0.311,0,0,-1,23,74,0.311,21,31,0.677,24,40,64,23,16,2,17,50,67
2052,1,2001,22,1,1,22,0,287,62,120,0.517,2,6,0.333,60,114,0.526,24,34,0.706,20,11,31,22,13,1,24,32,150
2052,1,2001,22,1,1,33,0,308,47,96,0.49,0,6,0,47,90,0.522,18,24,0.75,20,28,48,16,12,3,23,48,112
2052,1,2001,22,1,1,55,0,595,109,216,0.505,2,12,0.167,107,204,0.525,42,58,0.724,40,39,79,38,25,4,47,80,262
2058,1,1994,22,1,2,38,0,285,28,88,0.318,5,24,0.208,23,64,0.359,12,27,0.444,17,18,35,16,15,13,18,34,73
2059,1,2002,22,1,5,71,6,729,145,304,0.477,0,4,0,145,300,0.483,41,62,0.661,85,73,158,43,29,11,42,119,331
2059,2,2003,23,1,4,58,10,620,112,258,0.434,0,2,0,112,256,0.438,31,43,0.721,66,75,141,18,11,8,37,118,255
2059,3,2004,24,1,4,68,38,1442,237,537,0.441,0,3,0,237,534,0.444,89,116,0.767,148,195,343,57,38,18,59,191,563
2059,4,2005,25,1,4,43,4,423,71,156,0.455,0,1,0,71,155,0.458,23,28,0.821,31,48,79,13,9,2,13,64,165
2061,1,1990,26,1,4,26,0,148,19,44,0.432,0,0,-1,19,44,0.432,17,23,0.739,7,23,30,7,4,3,9,12,55
2068,1,1980,30,1,2,36,-1,387,90,166,0.542,0,6,0,90,160,0.563,39,49,0.796,3,20,23,38,10,0,36,54,219
2072,1,1998,21,1,2,80,62,2662,515,1145,0.45,3,28,0.107,512,1117,0.458,188,224,0.839,109,171,280,176,125,17,132,213,1221
2072,2,1999,22,1,2,41,40,1551,305,707,0.431,5,30,0.167,300,677,0.443,83,105,0.79,37,118,155,104,67,12,89,81,698
2072,3,2000,23,1,2,31,31,969,188,468,0.402,0,9,0,188,459,0.41,94,119,0.79,35,63,98,54,42,8,64,76,470
2072,3,2000,23,1,2,37,37,1408,272,612,0.444,15,39,0.385,257,573,0.449,119,151,0.788,29,123,152,104,33,15,87,75,678
2072,3,2000,23,1,2,68,68,2377,460,1080,0.426,15,48,0.313,445,1032,0.431,213,270,0.789,64,186,250,158,75,23,151,151,1148
2072,4,2001,24,1,2,61,61,2535,500,1121,0.446,14,46,0.304,486,1075,0.452,188,228,0.825,72,164,236,201,78,27,129,148,1202
2072,5,2002,25,1,2,13,1,213,25,67,0.373,1,5,0.2,24,62,0.387,11,11,1,6,17,23,10,2,3,9,22,62
2072,5,2002,25,1,2,40,40,1503,286,717,0.399,17,57,0.298,269,660,0.408,84,108,0.778,44,111,155,118,30,10,79,86,673
2072,5,2002,25,1,2,53,41,1716,311,784,0.397,18,62,0.29,293,722,0.406,95,119,0.798,50,128,178,128,32,13,88,108,735
2072,6,2003,26,1,2,72,3,1671,244,597,0.409,3,16,0.188,241,581,0.415,65,81,0.802,32,122,154,112,49,14,54,123,556
2072,7,2004,27,1,2,39,0,516,90,211,0.427,2,7,0.286,88,204,0.431,13,17,0.765,10,39,49,22,14,5,26,37,195
2072,8,2005,28,1,3,18,3,390,65,158,0.411,0,3,0,65,155,0.419,7,10,0.7,9,31,40,20,16,2,14,20,137
2073,1,1980,26,1,4,65,-1,1565,252,477,0.528,0,1,0,252,476,0.529,78,121,0.645,122,228,350,66,37,120,112,239,582
2073,2,1981,27,1,5,74,-1,1514,206,415,0.496,0,0,-1,206,415,0.496,148,213,0.695,126,267,393,77,27,80,125,219,560
2073,3,1982,28,1,5,18,10,380,47,91,0.516,0,0,-1,47,91,0.516,31,40,0.775,25,63,88,17,13,21,25,68,125
2073,4,1983,29,1,5,78,74,1706,258,453,0.57,0,0,-1,258,453,0.57,102,163,0.626,150,274,424,64,47,86,118,285,618
2073,5,1984,30,1,5,73,31,1501,193,363,0.532,0,0,-1,193,363,0.532,94,123,0.764,111,242,353,51,35,61,83,247,480
2073,6,1985,31,1,5,76,4,1061,121,243,0.498,1,2,0.5,120,241,0.498,96,124,0.774,94,169,263,27,17,28,50,181,339
2076,1,1984,23,1,4,39,0,332,49,90,0.544,0,0,-1,49,90,0.544,21,39,0.538,40,73,113,19,21,11,21,46,119
2076,2,1985,24,1,4,18,0,171,17,35,0.486,0,0,-1,17,35,0.486,12,17,0.706,18,26,44,13,8,7,8,26,46
2076,2,1985,24,1,4,39,0,394,74,122,0.607,0,3,0,74,119,0.622,17,26,0.654,44,55,99,17,12,14,28,49,165
2076,2,1985,24,1,4,57,0,565,91,157,0.58,0,3,0,91,154,0.591,29,43,0.674,62,81,143,30,20,21,36,75,211
2081,1,2006,22,1,1,19,0,118,6,18,0.333,0,0,-1,6,18,0.333,4,4,1,0,14,14,24,4,1,11,13,16
2082,1,1998,20,1,3,33,0,163,39,64,0.609,3,6,0.5,36,58,0.621,11,17,0.647,10,15,25,12,10,0,21,17,92
2085,1,2004,18,1,5,34,0,159,17,65,0.262,0,1,0,17,64,0.266,14,24,0.583,11,32,43,7,7,15,13,33,48
2085,2,2005,19,1,5,37,2,254,25,76,0.329,0,0,-1,25,76,0.329,17,24,0.708,3,40,43,7,2,17,16,31,67
2085,3,2006,20,1,5,25,0,140,17,33,0.515,0,2,0,17,31,0.548,3,8,0.375,10,18,28,9,3,15,15,25,37
2085,3,2006,20,1,5,30,1,627,102,201,0.507,0,0,-1,102,201,0.507,25,42,0.595,34,89,123,32,11,62,36,67,229
2085,3,2006,20,1,5,55,1,767,119,234,0.509,0,2,0,119,232,0.513,28,50,0.56,44,107,151,41,14,77,51,92,266
2085,4,2007,21,1,4,80,16,1913,249,548,0.454,0,1,0,249,547,0.455,141,230,0.613,145,292,437,90,44,140,124,219,639
2085,5,2008,22,1,5,70,64,1663,219,500,0.438,0,1,0,219,499,0.439,67,121,0.554,127,297,424,58,32,114,101,185,505
2085,6,2009,23,1,5,61,15,1034,137,266,0.515,0,0,-1,137,266,0.515,59,105,0.562,83,181,264,34,22,51,48,134,333
2085,7,2010,24,1,5,24,18,614,92,187,0.492,0,1,0,92,186,0.495,15,28,0.536,42,91,133,43,18,33,33,75,199
2085,7,2010,24,1,5,32,18,685,100,204,0.49,0,1,0,100,203,0.493,15,28,0.536,47,104,151,47,22,34,35,82,215
2085,8,2011,25,1,5,69,69,1686,271,578,0.469,0,0,-1,271,578,0.469,64,115,0.557,133,227,360,104,54,140,151,229,606
2085,9,2012,26,1,5,29,23,472,59,130,0.454,0,0,-1,59,130,0.454,16,37,0.432,35,62,97,17,9,25,32,59,134
2089,1,1999,22,1,5,38,0,469,78,138,0.565,1,2,0.5,77,136,0.566,81,102,0.794,35,82,117,22,9,18,32,65,238
2089,2,2000,23,1,5,55,4,961,135,293,0.461,0,2,0,135,291,0.464,153,195,0.785,113,180,293,45,23,35,48,111,423
2089,3,2001,24,1,5,57,45,1434,168,386,0.435,1,5,0.2,167,381,0.438,168,226,0.743,144,275,419,107,33,38,73,176,505
2089,4,2002,25,1,5,28,28,872,158,281,0.562,1,3,0.333,157,278,0.565,107,130,0.823,76,144,220,51,24,12,41,88,424
2089,4,2002,25,1,5,48,47,1391,208,452,0.46,2,4,0.5,206,448,0.46,190,253,0.751,176,225,401,101,52,29,74,156,608
2089,4,2002,25,1,5,76,75,2263,366,733,0.499,3,7,0.429,363,726,0.5,297,383,0.775,252,369,621,152,76,41,115,244,1032
2089,5,2003,26,1,5,73,72,2270,329,667,0.493,5,16,0.313,324,651,0.498,292,357,0.818,185,418,603,193,65,43,118,203,955
2089,6,2004,27,1,4,72,53,2621,373,731,0.51,12,38,0.316,361,693,0.521,256,329,0.778,191,552,743,312,68,86,144,247,1014
2089,7,2005,28,1,5,56,56,2089,319,609,0.524,5,19,0.263,314,590,0.532,233,287,0.812,139,382,521,220,69,68,82,181,876
2089,8,2006,29,1,5,79,79,2923,434,877,0.495,34,88,0.386,400,789,0.507,280,338,0.828,122,493,615,374,61,62,180,234,1182
2089,9,2007,30,1,5,63,56,1783,224,494,0.453,5,33,0.152,219,461,0.475,115,149,0.772,79,322,401,224,38,39,108,155,568
2089,10,2008,31,1,5,72,72,2513,337,728,0.463,28,90,0.311,309,638,0.484,262,309,0.848,167,514,681,264,69,74,164,247,964
2089,11,2009,32,1,5,27,0,746,108,226,0.478,3,13,0.231,105,213,0.493,99,116,0.853,67,134,201,86,22,12,47,88,318
2089,11,2009,32,1,5,43,43,1354,184,388,0.474,20,43,0.465,164,345,0.475,125,156,0.801,83,261,344,148,30,24,83,135,513
2089,11,2009,32,1,5,70,43,2100,292,614,0.476,23,56,0.411,269,558,0.482,224,272,0.824,150,395,545,234,52,36,130,223,831
2089,12,2010,33,1,5,82,37,1950,250,581,0.43,37,132,0.28,213,449,0.474,182,220,0.827,83,316,399,154,44,29,107,189,719
2089,13,2011,34,1,5,60,5,1015,132,296,0.446,40,107,0.374,92,189,0.487,78,94,0.83,44,178,222,145,28,21,54,98,382
2089,14,2012,35,1,5,15,1,146,9,27,0.333,7,15,0.467,2,12,0.167,10,12,0.833,4,15,19,24,4,2,12,10,35
2092,1,1988,22,1,2,82,1,1840,306,627,0.488,61,172,0.355,245,455,0.538,149,186,0.801,95,95,190,132,53,19,101,157,822
2092,2,1989,23,1,2,74,70,2536,398,831,0.479,98,244,0.402,300,587,0.511,287,340,0.844,73,219,292,227,93,29,143,170,1181
2092,3,1990,24,1,2,82,82,3192,661,1287,0.514,150,362,0.414,511,925,0.552,544,627,0.868,95,200,295,311,110,18,222,175,2016
2092,4,1991,25,1,2,82,82,2972,596,1164,0.512,112,322,0.348,484,842,0.575,551,600,0.918,81,200,281,331,109,13,163,165,1855
2092,5,1992,26,1,2,82,82,3120,562,1121,0.501,129,341,0.378,433,780,0.555,442,515,0.858,82,236,318,314,105,26,157,210,1695
2092,6,1993,27,1,2,82,82,2954,571,1193,0.479,167,419,0.399,404,774,0.522,427,485,0.88,67,191,258,262,120,26,145,182,1736
2092,7,1994,28,1,2,79,79,2638,524,1042,0.503,123,292,0.421,401,750,0.535,403,444,0.908,30,182,212,248,119,24,175,193,1574
2092,8,1995,29,1,2,81,81,2665,505,1092,0.462,195,470,0.415,310,622,0.498,383,427,0.897,30,180,210,242,98,16,151,157,1588
2092,9,1996,30,1,2,76,76,2621,504,1066,0.473,168,410,0.41,336,656,0.512,430,498,0.863,38,176,214,253,77,13,189,175,1606
2092,10,1997,31,1,2,81,81,2966,552,1244,0.444,229,536,0.427,323,708,0.456,418,475,0.88,53,233,286,273,75,25,166,172,1751
2092,11,1998,32,1,2,81,81,2795,516,1081,0.477,164,382,0.429,352,699,0.504,382,440,0.868,46,186,232,171,78,11,128,148,1578
2092,12,1999,33,1,2,50,50,1787,294,671,0.438,106,275,0.385,188,396,0.475,226,247,0.915,25,110,135,112,37,9,76,101,920
2092,13,2000,34,1,2,81,81,2987,466,1041,0.448,165,404,0.408,301,637,0.473,373,406,0.919,50,189,239,187,85,25,129,126,1470
2092,14,2001,35,1,2,81,81,3181,517,1176,0.44,170,464,0.366,347,712,0.487,323,348,0.928,38,247,285,260,81,15,133,162,1527
2092,15,2002,36,1,2,79,79,2889,414,913,0.453,180,443,0.406,234,470,0.498,296,325,0.911,23,196,219,253,88,10,120,143,1304
2092,16,2003,37,1,2,70,70,2117,281,637,0.441,113,318,0.355,168,319,0.527,207,230,0.9,21,151,172,170,62,4,66,89,882
2092,17,2004,38,1,2,80,80,2254,260,594,0.438,134,334,0.401,126,260,0.485,146,165,0.885,18,170,188,249,65,11,68,96,800
2092,18,2005,39,1,2,66,66,2105,314,719,0.437,96,298,0.322,218,421,0.518,250,268,0.933,18,138,156,146,50,5,77,109,974
2096,1,1994,24,1,3,79,18,2022,284,677,0.419,38,122,0.311,246,555,0.443,137,176,0.778,134,267,401,128,54,50,89,232,743
2096,2,1995,25,1,3,80,79,2814,359,855,0.42,94,240,0.392,265,615,0.431,174,213,0.817,99,267,366,154,59,35,120,242,986
2096,3,1996,26,1,3,80,80,3060,454,971,0.468,79,210,0.376,375,761,0.493,218,263,0.829,112,331,443,188,73,52,121,241,1205
2096,4,1997,27,1,3,80,79,3167,405,894,0.453,86,220,0.391,319,674,0.473,176,209,0.842,118,379,497,198,86,41,120,222,1072
2096,5,1998,28,1,3,80,29,2183,292,675,0.433,40,137,0.292,252,538,0.468,152,189,0.804,120,288,408,133,45,30,107,218,776
2096,6,1999,29,1,3,47,24,1395,186,453,0.411,32,115,0.278,154,338,0.456,79,96,0.823,49,188,237,103,39,14,58,125,483
2096,7,2000,30,1,3,20,11,649,123,292,0.421,8,30,0.267,115,262,0.439,68,84,0.81,46,77,123,47,18,4,25,60,322
2096,8,2001,31,1,3,15,8,493,71,191,0.372,7,25,0.28,64,166,0.386,31,36,0.861,24,69,93,18,9,5,20,43,180
2096,9,2002,32,1,3,66,0,1237,178,427,0.417,48,127,0.378,130,300,0.433,85,107,0.794,51,139,190,72,31,13,56,120,489
2096,10,2003,33,1,4,21,0,262,39,106,0.368,7,25,0.28,32,81,0.395,16,18,0.889,19,31,50,22,7,3,10,29,101
2098,1,1991,23,1,4,17,0,279,56,120,0.467,0,2,0,56,118,0.475,16,22,0.727,31,57,88,16,16,9,18,44,128
2098,1,1991,23,1,4,38,2,540,78,168,0.464,0,2,0,78,166,0.47,31,44,0.705,51,90,141,17,19,20,25,56,187
2098,1,1991,23,1,4,55,2,819,134,288,0.465,0,4,0,134,284,0.472,47,66,0.712,82,147,229,33,35,29,43,100,315
2098,2,1992,24,1,4,82,24,1714,310,670,0.463,8,23,0.348,302,647,0.467,114,152,0.75,187,266,453,84,48,41,82,200,742
2098,3,1993,25,1,4,81,46,2183,494,1072,0.461,10,36,0.278,484,1036,0.467,201,254,0.791,176,296,472,111,44,50,142,282,1199
2098,4,1994,26,1,4,80,74,2773,588,1151,0.511,24,73,0.329,564,1078,0.523,181,227,0.797,193,479,672,177,64,62,153,309,1381
2098,5,1995,27,1,4,72,69,2514,417,933,0.447,109,285,0.382,308,648,0.475,175,219,0.799,124,434,558,160,68,33,144,253,1118
2098,6,1996,28,1,4,82,5,1656,283,675,0.419,82,207,0.396,201,468,0.429,121,157,0.771,108,244,352,98,42,20,98,197,769
2098,7,1997,29,1,4,79,5,1997,312,702,0.444,175,415,0.422,137,287,0.477,58,70,0.829,68,309,377,99,35,27,85,161,857
2098,8,1998,30,1,4,50,0,782,81,206,0.393,25,81,0.309,56,125,0.448,25,33,0.758,34,118,152,39,19,9,45,129,212
2098,9,2000,32,1,4,82,78,1842,214,488,0.439,95,242,0.393,119,246,0.484,25,34,0.735,50,340,390,85,38,24,46,242,548
2098,10,2001,33,1,4,14,0,113,11,34,0.324,3,17,0.176,8,17,0.471,0,0,-1,4,17,21,5,3,1,10,20,25
2099,1,1993,21,1,2,73,0,1383,292,615,0.475,3,9,0.333,289,606,0.477,163,214,0.762,74,73,147,73,34,8,92,130,750
2099,2,1994,22,1,2,63,31,1358,254,532,0.477,4,6,0.667,250,526,0.475,149,180,0.828,75,81,156,95,31,13,95,132,661
2099,3,1995,23,1,1,45,16,871,123,305,0.403,14,49,0.286,109,256,0.426,69,95,0.726,38,79,117,69,15,6,77,85,329
2099,4,1996,24,1,2,19,0,136,23,52,0.442,2,10,0.2,21,42,0.5,13,13,1,4,8,12,8,0,0,14,23,61
2100,1,1986,25,1,1,76,2,1131,167,347,0.481,10,37,0.27,157,310,0.506,73,93,0.785,43,88,131,269,65,1,108,165,417
2100,2,1987,26,1,1,11,0,122,13,42,0.31,0,5,0,13,37,0.351,1,4,0.25,1,9,10,13,6,1,12,8,27
2100,2,1987,26,1,1,63,52,1478,205,440,0.466,11,34,0.324,194,406,0.478,61,86,0.709,28,102,130,335,66,6,145,166,482
2100,2,1987,26,1,1,74,52,1600,218,482,0.452,11,39,0.282,207,443,0.467,62,90,0.689,29,111,140,348,72,7,157,174,509
2100,3,1988,27,1,1,11,0,202,25,48,0.521,1,5,0.2,24,43,0.558,14,23,0.609,8,13,21,38,15,0,16,26,65
2100,3,1988,27,1,1,61,6,868,83,173,0.48,3,11,0.273,80,162,0.494,27,32,0.844,22,53,75,190,44,3,77,107,196
2100,3,1988,27,1,1,72,6,1070,108,221,0.489,4,16,0.25,104,205,0.507,41,55,0.745,30,66,96,228,59,3,93,133,261
2102,1,1995,23,1,2,63,8,945,155,301,0.515,2,12,0.167,153,289,0.529,65,78,0.833,49,88,137,66,32,16,44,89,377
2102,2,1996,24,1,2,78,47,1761,320,640,0.5,7,27,0.259,313,613,0.511,99,130,0.762,93,164,257,146,36,11,78,161,746
2102,3,1997,25,1,3,23,15,547,94,196,0.48,1,8,0.125,93,188,0.495,31,36,0.861,30,50,80,34,15,2,22,45,220
2102,4,1998,26,1,2,69,16,1126,140,321,0.436,6,31,0.194,134,290,0.462,59,86,0.686,55,95,150,88,53,11,43,100,345
2102,5,1999,27,1,2,44,7,765,85,204,0.417,8,28,0.286,77,176,0.438,36,48,0.75,31,86,117,50,20,6,38,69,214
2109,1,1989,22,1,3,22,0,320,41,88,0.466,0,0,-1,41,88,0.466,36,60,0.6,17,30,47,20,15,2,29,49,118
2109,1,1989,22,1,3,24,0,353,43,97,0.443,0,0,-1,43,97,0.443,37,64,0.578,18,32,50,21,16,2,33,51,123
2110,1,1980,24,1,3,82,-1,2802,775,1482,0.523,0,6,0,775,1476,0.525,270,343,0.787,206,385,591,93,70,77,172,259,1820
2110,2,1981,25,1,3,82,-1,3194,853,1791,0.476,4,9,0.444,849,1782,0.476,302,385,0.784,215,287,502,139,63,52,175,199,2012
2110,3,1982,26,1,3,27,26,973,229,504,0.454,0,6,0,229,498,0.46,72,100,0.72,71,70,141,39,27,15,55,77,530
2110,3,1982,26,1,3,57,57,2090,524,973,0.539,0,1,0,524,972,0.539,148,202,0.733,173,276,449,43,33,28,98,200,1196
2110,3,1982,26,1,3,84,83,3063,753,1477,0.51,0,7,0,753,1470,0.512,220,302,0.728,244,346,590,82,60,43,153,277,1726
2110,4,1983,27,1,3,80,79,2803,686,1342,0.511,0,3,0,686,1339,0.512,219,289,0.758,188,349,537,98,57,52,126,248,1591
2110,5,1984,28,1,3,79,79,2853,779,1597,0.488,6,14,0.429,773,1583,0.488,275,353,0.779,188,382,570,93,62,73,141,251,1839
2110,6,1985,29,1,3,82,82,2853,775,1558,0.497,5,23,0.217,770,1535,0.502,269,346,0.777,145,272,417,151,61,27,144,219,1824
2110,7,1986,30,1,3,82,82,2970,802,1697,0.473,0,12,0,802,1685,0.476,317,392,0.809,134,275,409,188,56,25,184,175,1921
2110,8,1987,31,1,3,40,18,922,208,478,0.435,1,2,0.5,207,476,0.435,92,112,0.821,38,65,103,38,19,9,51,68,509
2110,9,1988,32,1,3,68,20,1501,378,784,0.482,3,12,0.25,375,772,0.486,160,194,0.825,54,144,198,68,31,13,52,101,919
2112,1,1999,23,1,1,49,37,1456,172,405,0.425,53,148,0.358,119,257,0.463,90,110,0.818,22,89,111,121,44,23,79,98,487
2112,2,2000,24,1,2,81,8,2496,437,1016,0.43,104,292,0.356,333,724,0.46,299,353,0.847,59,229,288,208,87,32,186,171,1277
2112,3,2001,25,1,2,79,49,3002,527,1214,0.434,90,252,0.357,437,962,0.454,394,474,0.831,83,314,397,195,84,26,165,169,1538
2112,4,2002,26,1,2,74,74,3116,595,1358,0.438,149,377,0.395,446,981,0.455,267,314,0.85,63,237,300,187,109,37,180,189,1606
2112,5,2003,27,1,2,73,73,3044,463,1067,0.434,112,318,0.352,351,749,0.469,242,282,0.858,70,233,303,208,95,36,166,185,1280
2112,6,2004,28,1,2,80,80,3229,460,1081,0.426,164,420,0.39,296,661,0.448,176,217,0.811,40,322,362,258,107,33,180,179,1260
2112,7,2005,29,1,2,23,21,726,128,296,0.432,58,125,0.464,70,171,0.409,55,69,0.797,11,52,63,42,23,9,41,49,369
2112,7,2005,29,1,2,43,43,1662,280,636,0.44,92,217,0.424,188,419,0.449,113,136,0.831,34,132,166,146,51,21,92,103,765
2112,7,2005,29,1,2,66,64,2388,408,932,0.438,150,342,0.439,258,590,0.437,168,205,0.82,45,184,229,188,74,30,133,152,1134
2112,8,2006,30,1,3,79,74,2979,429,1008,0.426,83,245,0.339,346,763,0.453,229,273,0.839,50,291,341,238,93,36,145,208,1170
2112,9,2007,31,1,2,78,73,2841,388,882,0.44,101,246,0.411,287,636,0.451,200,239,0.837,52,215,267,198,92,24,145,186,1077
2112,10,2008,32,1,2,77,38,2702,377,870,0.433,67,192,0.349,310,678,0.457,163,199,0.819,50,225,275,202,78,34,123,152,984
2112,11,2009,33,1,2,11,11,365,63,146,0.432,12,35,0.343,51,111,0.459,13,18,0.722,9,20,29,12,15,2,18,21,151
2114,1,1995,24,1,5,46,26,587,78,132,0.591,2,2,1,76,130,0.585,22,45,0.489,55,98,153,21,8,27,24,63,180
2114,2,1996,25,1,5,34,1,611,72,131,0.55,1,2,0.5,71,129,0.55,37,83,0.446,51,77,128,22,13,23,49,82,182
2114,2,1996,25,1,5,39,4,676,74,138,0.536,1,2,0.5,73,136,0.537,39,87,0.448,54,86,140,22,14,24,50,87,188
2114,3,1997,26,1,5,28,8,307,28,63,0.444,0,0,-1,28,63,0.444,16,30,0.533,30,28,58,14,5,10,29,44,72
2115,1,1990,26,1,4,80,30,2414,372,834,0.446,0,9,0,372,825,0.451,268,349,0.768,180,282,462,89,66,54,96,301,1012
2115,2,1991,27,1,4,82,60,3121,445,1010,0.441,0,9,0,445,1001,0.445,307,396,0.775,188,332,520,133,66,57,104,338,1197
2115,3,1992,28,1,4,82,63,2151,307,725,0.423,2,11,0.182,305,714,0.427,209,266,0.786,158,315,473,94,53,39,97,230,825
2115,4,1993,29,1,3,81,1,1402,215,483,0.445,4,23,0.174,211,460,0.459,150,185,0.811,93,155,248,76,23,10,51,207,584
2115,5,1994,30,1,4,75,18,1084,140,306,0.458,0,5,0,140,301,0.465,82,110,0.745,71,119,190,65,33,9,50,152,362
2115,6,1995,31,1,3,81,12,1377,201,413,0.487,1,10,0.1,200,403,0.496,126,174,0.724,95,148,243,61,43,20,54,206,529
2115,7,1996,32,1,3,78,42,2145,303,618,0.49,1,18,0.056,302,600,0.503,237,291,0.814,107,232,339,74,49,26,87,220,844
2115,8,1997,33,1,3,82,5,2044,269,603,0.446,4,25,0.16,265,578,0.458,224,295,0.759,112,214,326,79,51,20,93,232,766
2115,9,1998,34,1,3,81,33,2239,371,800,0.464,15,43,0.349,356,757,0.47,243,292,0.832,118,267,385,107,64,22,66,200,1000
2115,10,1999,35,1,3,50,20,1344,213,522,0.408,9,38,0.237,204,484,0.421,126,165,0.764,55,127,182,98,35,16,34,111,561
2115,11,2000,36,1,3,66,24,1227,168,376,0.447,10,23,0.435,158,353,0.448,81,92,0.88,28,110,138,111,27,14,44,116,427
2115,12,2001,37,1,3,82,4,983,118,289,0.408,9,43,0.209,109,246,0.443,40,55,0.727,28,95,123,57,26,10,36,117,285
2115,13,2002,38,1,3,74,10,726,98,227,0.432,10,35,0.286,88,192,0.458,38,49,0.776,18,64,82,45,12,4,26,79,244
2116,1,2001,22,1,5,24,0,135,12,30,0.4,0,1,0,12,29,0.414,11,26,0.423,12,30,42,3,3,4,18,29,35
2116,2,2003,24,1,5,51,1,644,89,171,0.52,0,0,-1,89,171,0.52,27,41,0.659,59,119,178,22,19,44,46,87,205
2116,3,2004,25,1,4,35,1,417,40,84,0.476,0,1,0,40,83,0.482,22,38,0.579,41,72,113,8,17,12,25,42,102
2116,4,2005,26,1,5,20,1,120,9,18,0.5,0,1,0,9,17,0.529,10,13,0.769,10,27,37,1,3,6,7,13,28
2117,1,1980,23,1,5,12,-1,113,11,33,0.333,0,0,-1,11,33,0.333,7,9,0.778,14,15,29,2,1,6,10,24,29
2117,2,1981,24,1,5,80,-1,1815,224,458,0.489,0,1,0,224,457,0.49,120,200,0.6,141,277,418,135,38,73,160,267,568
2117,3,1982,25,1,5,28,1,345,35,82,0.427,0,2,0,35,80,0.438,23,30,0.767,24,62,86,11,20,17,16,68,93
2117,3,1982,25,1,5,39,3,523,49,111,0.441,0,1,0,49,110,0.445,25,33,0.758,35,87,122,24,13,23,39,103,123
2117,3,1982,25,1,5,67,4,868,84,193,0.435,0,3,0,84,190,0.442,48,63,0.762,59,149,208,35,33,40,55,171,216
2117,4,1983,26,1,5,23,18,539,55,121,0.455,0,0,-1,55,121,0.455,16,26,0.615,47,91,138,26,12,23,27,85,126
2117,4,1983,26,1,5,50,1,589,64,139,0.46,0,1,0,64,138,0.464,34,42,0.81,29,93,122,23,9,21,40,138,162
2117,4,1983,26,1,5,73,19,1128,119,260,0.458,0,1,0,119,259,0.459,50,68,0.735,76,184,260,49,21,44,67,223,288
2117,5,1984,27,1,5,68,4,838,102,213,0.479,1,3,0.333,101,210,0.481,50,72,0.694,51,115,166,44,11,29,44,168,255
2117,6,1985,28,1,5,79,6,1586,205,429,0.478,0,2,0,205,427,0.48,81,116,0.698,107,303,410,99,28,35,85,266,491
2117,7,1986,29,1,5,45,0,521,59,139,0.424,0,0,-1,59,139,0.424,25,34,0.735,36,103,139,30,6,6,25,92,143
2117,8,1987,30,1,5,62,3,626,52,129,0.403,0,1,0,52,128,0.406,46,64,0.719,45,93,138,22,18,13,22,126,150
2117,9,1988,31,1,5,60,0,848,100,210,0.476,0,4,0,100,206,0.485,51,72,0.708,70,151,221,22,27,27,49,194,251
2117,10,1989,32,1,5,74,0,690,59,164,0.36,7,26,0.269,52,138,0.377,40,51,0.784,63,124,187,36,29,21,35,153,165
2117,11,1990,33,1,5,38,1,449,63,150,0.42,0,1,0,63,149,0.423,25,36,0.694,27,72,99,17,8,10,26,76,151
2117,12,1991,34,1,5,36,1,257,21,59,0.356,3,9,0.333,18,50,0.36,12,15,0.8,20,47,67,9,8,3,7,58,57
2120,1,1980,24,1,2,55,-1,1467,259,510,0.508,0,0,-1,259,510,0.508,81,104,0.779,28,69,97,238,53,10,143,135,599
2120,1,1980,24,1,2,61,-1,1549,273,546,0.5,0,0,-1,273,546,0.5,83,106,0.783,31,73,104,254,53,11,155,146,629
2121,1,2006,22,1,3,23,15,336,29,85,0.341,9,33,0.273,20,52,0.385,8,12,0.667,11,40,51,19,6,5,12,41,75
2121,1,2006,22,1,3,26,15,343,29,87,0.333,9,34,0.265,20,53,0.377,10,14,0.714,11,41,52,19,7,5,12,41,77
2122,1,1980,35,1,2,51,-1,633,161,352,0.457,0,0,-1,161,352,0.457,56,64,0.875,16,20,36,67,21,3,28,46,378
2123,1,1992,23,1,3,38,0,313,53,144,0.368,6,27,0.222,47,117,0.402,19,23,0.826,12,21,33,27,12,2,23,19,131
2128,1,1995,23,1,5,78,75,2315,307,575,0.534,0,1,0,307,574,0.535,167,263,0.635,196,370,566,36,29,61,112,299,781
2128,2,1996,24,1,5,61,59,1432,196,346,0.566,0,0,-1,196,346,0.566,50,133,0.376,119,233,352,43,19,29,83,181,442
2128,3,1997,25,1,5,31,31,844,73,162,0.451,0,0,-1,73,162,0.451,11,28,0.393,115,167,282,29,11,39,26,118,157
2128,3,1997,25,1,5,47,46,984,86,187,0.46,0,0,-1,86,187,0.46,10,34,0.294,66,170,236,32,9,34,51,150,182
2128,3,1997,25,1,5,78,77,1828,159,349,0.456,0,0,-1,159,349,0.456,21,62,0.339,181,337,518,61,20,73,77,268,339
2128,4,1998,26,1,5,20,20,337,30,76,0.395,0,0,-1,30,76,0.395,7,19,0.368,28,64,92,7,7,12,15,61,67
2128,4,1998,26,1,5,28,10,354,31,68,0.456,0,0,-1,31,68,0.456,9,21,0.429,41,66,107,4,6,15,14,66,71
2128,4,1998,26,1,5,48,30,691,61,144,0.424,0,0,-1,61,144,0.424,16,40,0.4,69,130,199,11,13,27,29,127,138
2128,5,1999,27,1,5,46,2,577,42,80,0.525,0,1,0,42,79,0.532,11,32,0.344,45,94,139,14,12,27,16,107,95
2128,6,2000,28,1,5,51,0,332,17,55,0.309,0,0,-1,17,55,0.309,6,12,0.5,18,54,72,7,6,9,22,81,40
2128,7,2001,29,1,5,42,20,568,50,121,0.413,0,0,-1,50,121,0.413,7,26,0.269,43,101,144,15,8,23,37,100,107
2128,7,2001,29,1,5,54,21,649,56,138,0.406,0,0,-1,56,138,0.406,8,31,0.258,52,121,173,19,11,26,41,115,120
2128,8,2002,30,1,5,49,24,655,53,132,0.402,0,1,0,53,131,0.405,10,31,0.323,36,104,140,16,12,23,25,92,116
2129,1,2008,27,1,3,78,75,2166,279,575,0.485,40,122,0.328,239,453,0.528,63,85,0.741,92,392,484,90,80,108,51,152,661
2129,2,2009,28,1,3,26,21,689,72,157,0.459,27,73,0.37,45,84,0.536,13,15,0.867,10,106,116,25,21,16,12,48,184
2129,2,2009,28,1,3,54,39,1379,150,317,0.473,38,110,0.345,112,207,0.541,55,65,0.846,48,201,249,70,65,44,31,85,393
2129,2,2009,28,1,3,80,60,2068,222,474,0.468,65,183,0.355,157,291,0.54,68,80,0.85,58,307,365,95,86,60,43,133,577
2129,3,2010,29,1,3,61,2,1052,114,247,0.462,32,100,0.32,82,147,0.558,36,45,0.8,26,165,191,49,34,30,23,69,296
2129,4,2011,30,1,3,19,7,278,25,59,0.424,11,28,0.393,14,31,0.452,5,6,0.833,9,38,47,7,3,6,5,26,66
2129,4,2011,30,1,3,40,13,764,76,189,0.402,27,95,0.284,49,94,0.521,10,11,0.909,14,104,118,45,25,27,17,39,189
2129,4,2011,30,1,3,59,20,1042,101,248,0.407,38,123,0.309,63,125,0.504,15,17,0.882,23,142,165,52,28,33,22,65,255
2129,5,2012,31,1,3,8,0,123,7,24,0.292,2,10,0.2,5,14,0.357,2,2,1,2,20,22,5,1,5,8,5,18
2132,1,1981,23,1,1,71,-1,1406,212,478,0.444,4,27,0.148,208,451,0.461,69,92,0.75,43,125,168,228,61,17,108,179,497
2132,2,1983,25,1,1,37,3,642,81,190,0.426,6,23,0.261,75,167,0.449,42,56,0.75,15,40,55,73,22,1,46,72,210
2138,1,1994,24,1,5,22,15,363,38,81,0.469,0,0,-1,38,81,0.469,18,30,0.6,31,49,80,15,14,2,19,69,94
2138,1,1994,24,1,5,23,15,367,39,82,0.476,0,0,-1,39,82,0.476,18,30,0.6,31,50,81,15,14,2,19,70,96
2139,1,1989,23,1,3,76,48,2096,414,905,0.457,64,175,0.366,350,730,0.479,182,254,0.717,188,209,397,119,102,60,190,250,1074
2139,2,1990,24,1,3,80,76,2449,449,1065,0.422,61,193,0.316,388,872,0.445,228,316,0.722,194,228,422,143,130,79,185,219,1187
2139,3,1991,25,1,3,79,68,2553,409,962,0.425,45,179,0.251,364,783,0.465,179,244,0.734,210,311,521,220,138,96,167,248,1042
2139,4,1992,26,1,3,77,74,2394,346,726,0.477,22,110,0.2,324,616,0.526,165,231,0.714,199,295,494,197,129,81,171,211,879
2139,5,1993,27,1,3,77,57,2302,436,907,0.481,17,76,0.224,419,831,0.504,197,248,0.794,227,227,454,106,144,52,119,171,1086
2139,6,1994,28,1,3,50,27,1349,203,454,0.447,53,147,0.361,150,307,0.489,85,118,0.72,91,137,228,83,55,49,52,120,544
2139,7,1995,29,1,3,71,49,2131,351,856,0.41,106,317,0.334,245,539,0.455,142,195,0.728,181,221,402,147,86,51,117,155,950
2139,8,1996,30,1,2,66,33,1424,265,606,0.437,63,197,0.32,202,409,0.494,98,127,0.772,100,129,229,77,63,20,71,140,691
2139,9,1997,31,1,3,73,1,977,122,299,0.408,31,113,0.274,91,186,0.489,39,54,0.722,37,125,162,43,29,24,45,121,314
2139,10,1998,32,1,3,54,1,538,85,207,0.411,19,62,0.306,66,145,0.455,44,61,0.721,35,79,114,24,25,17,33,61,233
2139,11,1999,33,1,3,44,2,535,64,149,0.43,16,56,0.286,48,93,0.516,40,46,0.87,54,67,121,23,16,11,21,54,184
2142,1,1990,22,1,2,36,1,153,23,68,0.338,2,7,0.286,21,61,0.344,24,30,0.8,7,13,20,11,2,0,23,20,72
2143,1,1993,23,1,3,25,0,102,26,57,0.456,0,0,-1,26,57,0.456,3,4,0.75,6,6,12,4,3,1,8,14,55
2144,1,2008,22,1,5,18,2,181,21,58,0.362,0,0,-1,21,58,0.362,14,29,0.483,12,25,37,2,4,2,9,37,56
2144,2,2010,24,1,4,28,0,124,23,41,0.561,0,0,-1,23,41,0.561,16,27,0.593,10,28,38,2,5,3,12,34,62
2145,1,1995,23,1,1,41,6,395,50,129,0.388,9,25,0.36,41,104,0.394,58,85,0.682,21,37,58,18,11,15,27,45,167
2146,1,1990,22,1,2,37,3,402,48,161,0.298,7,30,0.233,41,131,0.313,43,62,0.694,7,25,32,67,18,4,51,30,146
2146,2,1991,23,1,3,66,2,1207,120,274,0.438,4,12,0.333,116,262,0.443,113,139,0.813,41,62,103,243,61,18,107,112,357
2146,3,1992,24,1,3,21,0,216,33,81,0.407,2,15,0.133,31,66,0.47,24,29,0.828,3,16,19,27,12,1,24,20,92
2146,3,1992,24,1,3,25,0,270,36,93,0.387,2,16,0.125,34,77,0.442,32,38,0.842,6,20,26,32,13,1,28,23,106
2149,1,1986,27,1,1,12,0,160,21,53,0.396,2,7,0.286,19,46,0.413,11,15,0.733,9,16,25,19,6,3,18,26,55
2149,1,1986,27,1,1,60,0,852,95,239,0.397,5,25,0.2,90,214,0.421,54,74,0.73,25,65,90,89,50,12,61,106,249
2149,1,1986,27,1,1,72,0,1012,116,292,0.397,7,32,0.219,109,260,0.419,65,89,0.73,34,81,115,108,56,15,79,132,304
2149,2,1987,28,1,1,64,0,698,91,207,0.44,1,14,0.071,90,193,0.466,49,69,0.71,29,66,95,90,42,3,57,96,232
2150,1,1996,23,1,2,44,3,573,112,247,0.453,18,55,0.327,94,192,0.49,49,75,0.653,36,25,61,50,29,8,44,54,291
2150,2,1997,24,1,2,67,18,1214,171,441,0.388,41,141,0.291,130,300,0.433,64,99,0.646,43,76,119,129,48,24,81,83,447
2151,1,2001,24,1,3,73,3,989,123,277,0.444,0,3,0,123,274,0.449,73,90,0.811,49,125,174,25,11,9,67,163,319
2151,2,2002,25,1,5,82,14,1371,169,384,0.44,1,13,0.077,168,371,0.453,57,76,0.75,81,187,268,50,20,19,70,174,396
2157,1,1996,25,1,5,24,0,118,13,32,0.406,0,0,-1,13,32,0.406,5,8,0.625,10,15,25,2,1,4,3,23,31
2157,1,1996,25,1,5,33,0,151,16,41,0.39,0,0,-1,16,41,0.39,5,8,0.625,11,17,28,3,2,5,3,29,37
2159,1,1986,22,1,2,55,30,1391,287,620,0.463,5,27,0.185,282,593,0.476,189,211,0.896,42,73,115,105,70,23,75,130,768
2159,2,1987,23,1,2,82,82,2377,477,928,0.514,19,63,0.302,458,865,0.529,269,326,0.825,39,142,181,261,98,36,154,217,1242
2159,3,1988,24,1,3,60,55,2033,470,926,0.508,34,97,0.351,436,829,0.526,239,270,0.885,58,147,205,290,113,32,156,136,1213
2159,4,1989,25,1,3,82,82,3093,830,1630,0.509,23,100,0.23,807,1530,0.527,493,553,0.892,152,331,483,415,176,39,296,178,2176
2159,5,1990,26,1,3,78,78,2830,682,1272,0.536,87,234,0.372,595,1038,0.573,505,568,0.889,130,333,463,319,123,45,239,142,1956
2159,6,1991,27,1,3,82,82,3315,777,1449,0.536,40,133,0.301,737,1316,0.56,513,580,0.884,141,302,443,329,173,63,245,176,2107
2159,7,1992,28,1,3,81,81,3346,830,1584,0.524,64,175,0.366,766,1409,0.544,350,420,0.833,127,323,450,286,173,62,202,171,2074
2159,8,1993,29,1,3,46,46,1902,474,930,0.51,60,133,0.451,414,797,0.519,183,226,0.81,42,190,232,166,68,41,139,76,1191
2159,9,1994,30,1,3,62,39,2324,410,869,0.472,55,151,0.364,355,718,0.494,165,219,0.753,64,281,345,315,107,53,178,114,1040
2159,10,1995,31,1,3,25,23,890,170,348,0.489,42,93,0.452,128,255,0.502,94,107,0.879,25,90,115,125,38,19,93,53,476
2159,11,1996,32,1,3,55,19,1617,269,539,0.499,59,150,0.393,210,389,0.54,137,160,0.856,44,115,159,194,75,32,122,127,734
2159,12,1997,33,1,3,79,63,2733,438,792,0.553,83,202,0.411,355,590,0.602,184,213,0.864,75,242,317,322,130,33,192,155,1143
2159,13,1998,34,1,3,82,82,2177,333,692,0.481,107,243,0.44,226,449,0.503,154,164,0.939,38,211,249,186,95,39,117,186,927
2159,14,1999,35,1,3,50,50,1179,177,371,0.477,73,157,0.465,104,214,0.486,80,92,0.87,25,135,160,81,47,13,60,101,507
2159,15,2000,36,1,2,47,2,582,80,187,0.428,45,110,0.409,35,77,0.455,37,41,0.902,14,62,76,37,28,9,28,60,242
2159,16,2001,37,1,3,20,8,374,36,106,0.34,19,52,0.365,17,54,0.315,24,28,0.857,10,31,41,19,16,10,19,28,115
2162,1,1992,23,1,1,50,0,478,76,183,0.415,5,26,0.192,71,157,0.452,46,61,0.754,21,33,54,92,30,7,50,52,203
2162,2,1993,24,1,1,79,78,2437,438,936,0.468,31,119,0.261,407,817,0.498,231,296,0.78,95,189,284,603,174,7,207,177,1138
2162,3,1994,25,1,1,82,76,2533,477,1019,0.468,69,168,0.411,408,851,0.479,234,288,0.813,91,170,261,546,197,12,206,189,1257
2162,4,1995,26,1,1,75,32,2158,338,814,0.415,90,240,0.375,248,574,0.432,211,267,0.79,48,166,214,482,113,12,194,139,977
2162,5,1996,27,1,1,9,0,193,24,66,0.364,6,23,0.261,18,43,0.419,8,12,0.667,5,9,14,35,6,0,12,16,62
2162,5,1996,27,1,1,64,14,1480,220,521,0.422,39,122,0.32,181,399,0.454,106,131,0.809,21,134,155,292,129,9,120,124,585
2162,5,1996,27,1,1,73,14,1673,244,587,0.416,45,145,0.31,199,442,0.45,114,143,0.797,26,143,169,327,135,9,132,140,647
2162,6,1997,28,1,1,12,0,114,15,33,0.455,4,10,0.4,11,23,0.478,11,12,0.917,1,10,11,24,9,2,11,9,45
2162,7,1998,29,1,1,82,1,1395,177,419,0.422,28,91,0.308,149,328,0.454,125,156,0.801,39,117,156,219,103,13,104,173,507
2162,8,1999,30,1,1,15,8,401,45,114,0.395,8,22,0.364,37,92,0.402,21,26,0.808,3,32,35,66,22,2,29,35,119
2162,9,2000,31,1,1,40,15,693,79,205,0.385,16,42,0.381,63,163,0.387,51,80,0.638,15,62,77,108,47,5,58,67,225
2164,1,1980,31,1,2,76,-1,2676,624,1267,0.493,1,25,0.04,623,1242,0.502,271,302,0.897,68,82,150,299,143,9,162,269,1520
2164,2,1981,32,1,1,76,-1,2014,528,1074,0.492,4,17,0.235,524,1057,0.496,206,215,0.958,33,54,87,222,111,6,129,209,1266
2164,3,1982,33,1,1,64,0,1204,277,648,0.427,1,16,0.063,276,632,0.437,100,110,0.909,20,41,61,163,43,1,82,142,655
2164,4,1983,34,1,1,64,0,1423,337,754,0.447,4,14,0.286,333,740,0.45,138,150,0.92,34,40,74,158,59,4,89,163,816
2166,1,1985,22,1,4,23,0,149,8,50,0.16,0,1,0,8,49,0.163,12,21,0.571,6,35,41,4,1,2,8,21,28
2166,2,1986,23,1,3,14,0,100,16,45,0.356,0,2,0,16,43,0.372,9,14,0.643,7,8,15,3,4,3,5,12,41
2166,3,1987,24,1,4,21,0,141,31,72,0.431,0,0,-1,31,72,0.431,9,16,0.563,17,22,39,5,3,2,6,21,71
2169,1,2002,21,1,4,82,4,1448,178,423,0.421,3,9,0.333,175,414,0.423,121,156,0.776,99,223,322,70,36,21,84,217,480
2169,2,2003,22,1,4,79,79,2510,338,749,0.451,3,14,0.214,335,735,0.456,244,290,0.841,228,578,806,106,65,30,111,246,923
2169,3,2004,23,1,4,28,0,610,107,243,0.44,5,17,0.294,102,226,0.451,60,80,0.75,48,125,173,20,12,17,34,58,279
2169,4,2005,24,1,4,70,69,2375,392,947,0.414,59,148,0.399,333,799,0.417,233,319,0.73,251,505,756,97,53,33,108,190,1076
2169,5,2006,25,1,4,74,74,2516,363,838,0.433,58,181,0.32,305,657,0.464,251,319,0.787,195,548,743,101,47,26,108,191,1035
2169,6,2007,26,1,4,26,17,667,81,180,0.45,22,59,0.373,59,121,0.488,47,66,0.712,37,120,157,60,21,17,29,63,231
2169,6,2007,26,1,4,42,31,1185,185,401,0.461,36,88,0.409,149,313,0.476,61,79,0.772,63,194,257,66,25,25,49,133,467
2169,6,2007,26,1,4,68,48,1852,266,581,0.458,58,147,0.395,208,434,0.479,108,145,0.745,100,314,414,126,46,42,78,196,698
2169,7,2008,27,1,4,75,61,2106,315,693,0.455,94,236,0.398,221,457,0.484,192,241,0.797,108,435,543,165,49,32,96,217,916
2169,8,2009,28,1,4,73,73,2482,364,767,0.475,161,358,0.45,203,409,0.496,152,184,0.826,146,715,861,172,58,34,114,226,1041
2169,9,2010,29,1,4,72,69,2344,384,813,0.472,128,333,0.384,256,480,0.533,154,193,0.798,129,608,737,150,72,34,100,175,1050
2169,10,2011,30,1,4,17,0,178,16,38,0.421,1,10,0.1,15,28,0.536,11,13,0.846,11,27,38,6,8,1,7,19,44
2169,10,2011,30,1,4,18,4,288,26,76,0.342,4,23,0.174,22,53,0.415,9,17,0.529,11,64,75,17,7,2,13,28,65
2169,10,2011,30,1,4,35,4,466,42,114,0.368,5,33,0.152,37,81,0.457,20,30,0.667,22,91,113,23,15,3,20,47,109
2169,11,2012,31,1,4,59,0,956,77,171,0.45,28,67,0.418,49,104,0.471,6,9,0.667,40,151,191,51,15,16,26,98,188
2169,12,2013,32,1,4,14,1,256,22,61,0.361,11,35,0.314,11,26,0.423,10,11,0.909,7,42,49,7,10,6,7,29,65
2170,1,2004,24,1,1,82,18,2021,389,915,0.425,67,229,0.293,322,686,0.469,168,235,0.715,45,159,204,205,81,28,149,158,1013
2170,2,2005,25,1,2,49,6,883,131,363,0.361,24,95,0.253,107,268,0.399,59,80,0.738,15,83,98,65,30,11,57,59,345
2170,3,2006,26,1,2,28,25,1027,142,317,0.448,20,65,0.308,122,252,0.484,73,104,0.702,15,52,67,77,38,7,56,64,377
2170,3,2006,26,1,2,48,2,1085,179,451,0.397,17,76,0.224,162,375,0.432,99,138,0.717,18,68,86,120,30,4,79,69,474
2170,3,2006,26,1,2,76,27,2112,321,768,0.418,37,141,0.262,284,627,0.453,172,242,0.711,33,120,153,197,68,11,135,133,851
2170,4,2007,27,1,2,69,18,1477,177,438,0.404,24,83,0.289,153,355,0.431,87,120,0.725,26,87,113,187,49,13,90,96,465
2170,5,2008,28,1,1,19,2,347,57,139,0.41,6,27,0.222,51,112,0.455,22,37,0.595,13,23,36,64,13,1,31,19,142
2170,5,2008,28,1,1,23,17,527,97,228,0.425,14,36,0.389,83,192,0.432,46,61,0.754,10,37,47,80,25,3,53,31,254
2170,5,2008,28,1,1,42,19,874,154,367,0.42,20,63,0.317,134,304,0.441,68,98,0.694,23,60,83,144,38,4,84,50,396
2170,6,2009,29,1,2,80,2,1975,355,795,0.447,87,242,0.36,268,553,0.485,177,233,0.76,22,146,168,158,88,17,128,173,974
2170,7,2010,30,1,2,29,1,680,108,272,0.397,28,90,0.311,80,182,0.44,48,63,0.762,13,72,85,51,18,4,26,49,292
2170,7,2010,30,1,2,46,1,993,160,411,0.389,41,131,0.313,119,280,0.425,93,131,0.71,15,83,98,84,28,12,65,77,454
2170,7,2010,30,1,2,75,2,1673,268,683,0.392,69,221,0.312,199,462,0.431,141,194,0.727,28,155,183,135,46,16,91,126,746
2171,1,1993,21,1,3,48,14,495,108,260,0.415,21,70,0.3,87,190,0.458,35,40,0.875,40,43,83,11,8,5,31,59,272
2171,2,1994,22,1,3,66,1,820,167,355,0.47,50,109,0.459,117,246,0.476,50,72,0.694,43,68,111,31,21,20,37,76,434
2171,3,1995,23,1,3,25,0,203,32,80,0.4,19,45,0.422,13,35,0.371,5,8,0.625,2,20,22,5,7,3,15,31,88
2171,3,1995,23,1,3,29,3,313,63,153,0.412,16,41,0.39,47,112,0.42,28,34,0.824,18,19,37,14,7,1,20,42,170
2171,3,1995,23,1,3,54,3,516,95,233,0.408,35,86,0.407,60,147,0.408,33,42,0.786,20,39,59,19,14,4,35,73,258
2171,4,1996,24,1,3,82,37,2458,496,1092,0.454,151,358,0.422,345,734,0.47,182,219,0.831,114,238,352,131,87,40,132,208,1325
2171,5,1997,25,1,3,82,1,1814,288,678,0.425,106,300,0.353,182,378,0.481,135,161,0.839,84,169,253,78,69,19,86,150,817
2171,6,1998,26,1,3,82,12,2227,449,1007,0.446,158,403,0.392,291,604,0.482,182,209,0.871,75,202,277,84,67,25,102,167,1238
2171,7,1999,27,1,3,36,0,653,83,237,0.35,33,103,0.32,50,134,0.373,34,42,0.81,18,63,81,27,21,6,29,65,233
2171,8,2000,28,1,3,80,8,1831,290,670,0.433,113,263,0.43,177,407,0.435,120,141,0.851,63,208,271,72,45,24,84,185,813
2171,9,2001,29,1,3,13,0,135,17,55,0.309,7,23,0.304,10,32,0.313,9,10,0.9,4,18,22,9,4,1,6,8,50
2171,9,2001,29,1,3,38,1,453,77,193,0.399,29,80,0.363,48,113,0.425,24,32,0.75,18,41,59,14,8,6,20,45,207
2171,9,2001,29,1,3,51,1,588,94,248,0.379,36,103,0.35,58,145,0.4,33,42,0.786,22,59,81,23,12,7,26,53,257
2171,10,2002,30,1,3,40,3,473,85,207,0.411,40,104,0.385,45,103,0.437,17,21,0.81,18,35,53,19,11,8,25,38,227
2171,11,2003,31,1,3,31,0,193,23,71,0.324,8,38,0.211,15,33,0.455,7,9,0.778,5,18,23,12,5,3,14,22,61
2174,1,1997,22,1,4,32,0,321,49,117,0.419,3,20,0.15,46,97,0.474,38,56,0.679,33,29,62,17,12,10,15,55,139
2174,1,1997,22,1,4,42,0,348,54,131,0.412,4,24,0.167,50,107,0.467,44,70,0.629,35,32,67,20,12,11,18,58,156
2174,2,1998,23,1,4,41,7,603,83,191,0.435,16,38,0.421,67,153,0.438,51,67,0.761,46,68,114,30,29,14,29,96,233
2176,1,1991,21,1,4,62,5,825,106,228,0.465,0,1,0,106,227,0.467,56,87,0.644,51,118,169,36,15,14,61,109,268
2176,2,1992,22,1,4,52,3,545,92,193,0.477,0,0,-1,92,193,0.477,49,71,0.69,45,100,145,45,21,16,51,59,233
2176,3,1993,23,1,4,32,9,336,57,130,0.438,0,1,0,57,129,0.442,33,53,0.623,29,54,83,10,14,11,22,40,147
2176,4,1994,24,1,4,33,2,196,30,84,0.357,0,0,-1,30,84,0.357,13,22,0.591,20,35,55,8,4,5,10,29,73
2178,1,1990,23,1,2,31,0,193,19,58,0.328,0,2,0,19,56,0.339,2,3,0.667,9,19,28,11,3,4,4,27,40
2178,2,1991,24,1,2,68,5,1011,139,303,0.459,15,43,0.349,124,260,0.477,26,36,0.722,65,80,145,53,22,13,52,100,319
2178,3,1992,25,1,2,15,0,136,15,51,0.294,3,15,0.2,12,36,0.333,8,12,0.667,7,20,27,5,9,2,8,11,41
2178,3,1992,25,1,2,24,0,190,28,73,0.384,10,26,0.385,18,47,0.383,8,14,0.571,9,15,24,7,7,6,8,21,74
2178,3,1992,25,1,2,39,0,326,43,124,0.347,13,41,0.317,30,83,0.361,16,26,0.615,16,35,51,12,16,8,16,32,115
2179,1,1992,25,1,5,71,71,2716,428,869,0.493,0,0,-1,428,869,0.493,321,500,0.642,316,554,870,156,43,210,252,273,1177
2179,2,1993,26,1,5,82,82,3029,398,781,0.51,0,0,-1,398,781,0.51,335,492,0.681,344,726,1070,147,43,287,216,284,1131
2179,3,1994,27,1,5,82,82,2853,365,642,0.569,0,1,0,365,641,0.569,256,439,0.583,286,685,971,127,59,336,206,262,986
2179,4,1995,28,1,5,82,82,3100,349,628,0.556,0,0,-1,349,628,0.556,248,379,0.654,319,710,1029,113,40,321,192,284,946
2179,5,1996,29,1,5,74,74,2713,284,569,0.499,0,1,0,284,568,0.5,246,354,0.695,249,622,871,108,38,332,150,258,814
2179,6,1997,30,1,5,80,80,2973,380,721,0.527,0,0,-1,380,721,0.527,306,434,0.705,268,661,929,110,49,264,186,249,1066
2179,7,1998,31,1,5,82,82,2917,399,743,0.537,0,0,-1,399,743,0.537,303,452,0.67,276,656,932,82,34,277,168,254,1101
2179,8,1999,32,1,5,50,50,1829,173,338,0.512,0,0,-1,173,338,0.512,195,285,0.684,192,418,610,57,16,147,94,145,541
2179,9,2000,33,1,5,82,82,2984,322,573,0.562,0,0,-1,322,573,0.562,298,421,0.708,304,853,1157,105,27,269,174,248,942
2179,10,2001,34,1,5,26,26,875,100,202,0.495,0,0,-1,100,202,0.495,104,137,0.759,119,203,322,22,9,66,52,65,304
2179,10,2001,34,1,5,49,49,1716,169,354,0.477,0,0,-1,169,354,0.477,107,154,0.695,188,505,693,54,20,137,92,139,445
2179,10,2001,34,1,5,75,75,2591,269,556,0.484,0,0,-1,269,556,0.484,211,291,0.725,307,708,1015,76,29,203,144,204,749
2179,11,2002,35,1,5,80,80,2907,321,641,0.501,0,0,-1,321,641,0.501,278,364,0.764,254,609,863,83,29,190,156,242,920
2179,12,2003,36,1,5,24,16,514,49,131,0.374,0,0,-1,49,131,0.374,40,55,0.727,54,99,153,19,4,37,34,54,138
2179,13,2004,37,1,5,65,56,1494,141,295,0.478,0,0,-1,141,295,0.478,81,119,0.681,145,292,437,25,17,123,54,141,363
2179,14,2005,38,1,5,80,2,1212,108,217,0.498,0,0,-1,108,217,0.498,106,143,0.741,150,276,426,10,16,101,51,135,322
2179,15,2006,39,1,5,64,23,955,50,95,0.526,0,0,-1,50,95,0.526,69,91,0.758,100,206,306,4,17,57,35,128,169
2179,16,2007,40,1,5,75,33,1289,85,153,0.556,0,0,-1,85,153,0.556,60,87,0.69,164,324,488,13,22,76,38,156,230
2179,17,2008,41,1,5,39,25,619,43,80,0.538,0,0,-1,43,80,0.538,32,45,0.711,68,131,199,5,11,48,17,55,118
2182,1,1982,22,1,2,43,0,369,54,100,0.54,2,3,0.667,52,97,0.536,35,69,0.507,13,16,29,57,16,2,42,65,145
2182,2,1983,23,1,2,54,2,439,84,172,0.488,4,18,0.222,80,154,0.519,30,73,0.411,12,35,47,104,34,4,74,78,202
2184,1,1994,26,1,4,80,47,2303,491,942,0.521,0,1,0,491,941,0.522,226,301,0.751,191,386,577,114,70,67,149,276,1208
2184,2,1995,27,1,4,66,48,2147,450,919,0.49,0,1,0,450,918,0.49,233,307,0.759,149,424,573,111,60,86,159,232,1133
2184,3,1996,28,1,4,53,52,1984,426,852,0.5,0,0,-1,426,852,0.5,191,275,0.695,113,409,522,83,48,81,117,161,1043
2184,4,1997,29,1,5,25,25,874,149,339,0.44,0,1,0,149,338,0.441,51,71,0.718,44,167,211,48,23,48,70,76,349
2190,1,1982,25,1,3,49,15,637,77,177,0.435,0,2,0,77,175,0.44,38,64,0.594,37,43,80,40,18,2,25,74,192
2190,2,1983,26,1,3,34,1,292,33,83,0.398,0,1,0,33,82,0.402,29,43,0.674,25,19,44,22,10,1,25,35,95
2192,1,2003,24,1,1,42,0,244,22,58,0.379,5,12,0.417,17,46,0.37,29,36,0.806,4,13,17,33,4,0,23,25,78
2193,1,1982,23,1,4,64,43,1131,118,228,0.518,0,1,0,118,227,0.52,59,117,0.504,116,232,348,56,60,76,77,167,295
2193,2,1983,24,1,4,78,77,1806,235,413,0.569,0,2,0,235,411,0.572,114,166,0.687,164,367,531,90,105,63,145,233,584
2193,3,1984,25,1,4,47,31,743,63,113,0.558,0,0,-1,63,113,0.558,42,66,0.636,82,184,266,34,30,14,56,108,168
2193,4,1985,26,1,4,82,46,1617,181,327,0.554,0,0,-1,181,327,0.554,68,103,0.66,164,364,528,69,82,47,97,211,430
2193,5,1986,27,1,4,74,74,1573,160,269,0.595,0,0,-1,160,269,0.595,88,122,0.721,156,361,517,69,66,33,97,198,408
2193,6,1987,28,1,4,78,10,1514,163,313,0.521,0,0,-1,163,313,0.521,120,157,0.764,159,294,453,63,74,41,104,201,446
2193,7,1988,29,1,4,70,20,845,102,186,0.548,0,0,-1,102,186,0.548,73,93,0.785,103,165,268,54,39,13,59,103,277
2193,8,1989,30,1,4,75,75,2233,325,627,0.518,0,3,0,325,624,0.521,182,248,0.734,269,434,703,159,100,57,148,208,832
2193,9,1990,31,1,4,16,16,448,58,116,0.5,0,1,0,58,115,0.504,30,55,0.545,48,72,120,28,32,10,29,45,146
2193,9,1990,31,1,4,58,45,1456,132,257,0.514,0,2,0,132,255,0.518,52,72,0.722,108,297,405,107,68,27,75,163,316
2193,9,1990,31,1,4,74,61,1904,190,373,0.509,0,3,0,190,370,0.514,82,127,0.646,156,369,525,135,100,37,104,208,462
2193,10,1991,32,1,4,62,17,900,83,167,0.497,0,2,0,83,165,0.503,60,85,0.706,77,189,266,64,25,11,45,107,226
2193,11,1992,33,1,4,28,5,381,38,82,0.463,0,0,-1,38,82,0.463,14,18,0.778,23,83,106,37,12,14,25,46,90
2193,12,1993,34,1,4,67,1,781,63,122,0.516,0,2,0,63,120,0.525,42,63,0.667,75,146,221,52,40,18,36,119,168
2193,12,1993,34,1,4,72,1,822,67,129,0.519,0,2,0,67,127,0.528,43,65,0.662,77,150,227,53,43,18,42,122,177
2193,13,1994,35,1,4,50,1,635,59,114,0.518,0,1,0,59,113,0.522,46,71,0.648,84,105,189,32,22,23,26,89,164
2193,14,1995,36,1,4,26,1,195,18,35,0.514,0,0,-1,18,35,0.514,8,12,0.667,10,24,34,16,3,9,8,35,44
2195,1,1992,24,1,4,39,0,374,58,127,0.457,3,14,0.214,55,113,0.487,26,35,0.743,35,27,62,26,12,3,19,31,145
2195,1,1992,24,1,4,54,0,441,68,149,0.456,3,16,0.188,65,133,0.489,32,43,0.744,39,32,71,33,12,3,25,39,171
2195,2,1993,25,1,4,35,0,240,40,79,0.506,1,7,0.143,39,72,0.542,16,26,0.615,27,28,55,10,4,2,16,32,97
2195,2,1993,25,1,4,37,0,248,40,80,0.5,1,8,0.125,39,72,0.542,16,26,0.615,27,28,55,11,4,2,17,33,97
2195,3,1994,26,1,4,28,0,155,17,50,0.34,2,14,0.143,15,36,0.417,22,28,0.786,9,13,22,11,8,3,10,18,58
2196,1,1981,22,1,3,25,-1,153,21,57,0.368,0,0,-1,21,57,0.368,13,28,0.464,17,13,30,17,7,1,26,33,55
2198,1,1981,22,1,1,80,-1,2431,525,1162,0.452,3,31,0.097,522,1131,0.462,164,219,0.749,42,153,195,555,88,9,232,201,1217
2198,2,1982,23,1,1,78,68,2418,504,1095,0.46,3,38,0.079,501,1057,0.474,242,318,0.761,39,147,186,555,97,4,229,169,1253
2198,3,1983,24,1,1,76,4,1607,343,746,0.46,2,16,0.125,341,730,0.467,152,199,0.764,44,103,147,280,58,4,129,109,840
2198,4,1984,25,1,1,80,50,1937,304,700,0.434,7,32,0.219,297,668,0.445,145,183,0.792,28,99,127,483,91,6,141,182,760
2198,5,1985,26,1,1,81,29,1689,300,654,0.459,2,11,0.182,298,643,0.463,122,142,0.859,40,90,130,355,87,7,113,134,724
2198,6,1986,27,1,1,79,15,1504,231,505,0.457,3,24,0.125,228,481,0.474,121,148,0.818,34,82,116,252,51,4,114,128,586
2201,1,1986,23,1,5,48,1,330,61,150,0.407,0,0,-1,61,150,0.407,31,39,0.795,37,60,97,16,3,10,40,63,153
2201,2,1987,24,1,5,74,23,1421,268,570,0.47,0,0,-1,268,570,0.47,169,231,0.732,183,282,465,60,24,58,79,224,705
2201,3,1988,25,1,5,79,45,1779,435,884,0.492,0,0,-1,435,884,0.492,132,170,0.776,130,307,437,78,22,81,73,241,1002
2201,4,1989,26,1,5,77,22,1308,257,577,0.445,0,0,-1,257,577,0.445,69,81,0.852,105,182,287,49,29,41,49,194,583
2201,5,1990,27,1,5,81,55,1995,445,895,0.497,0,1,0,445,894,0.498,111,134,0.828,174,420,594,82,40,104,75,300,1001
2201,6,1991,28,1,5,70,69,2325,405,885,0.458,2,5,0.4,403,880,0.458,63,93,0.677,170,508,678,70,52,132,81,307,875
2201,7,1992,29,1,5,81,61,1968,347,726,0.478,5,23,0.217,342,703,0.486,30,40,0.75,94,299,393,107,35,48,51,233,729
2201,8,1993,30,1,5,22,6,283,30,80,0.375,2,6,0.333,28,74,0.378,9,13,0.692,20,35,55,5,5,10,12,61,71
2205,1,1996,22,1,5,75,2,1305,128,230,0.557,0,1,0,128,229,0.559,85,120,0.708,110,187,297,13,16,116,56,144,341
2205,2,1997,23,1,5,76,38,1292,179,337,0.531,0,0,-1,179,337,0.531,81,116,0.698,109,147,256,13,29,111,56,181,439
2205,3,1998,24,1,5,24,12,586,57,111,0.514,0,0,-1,57,111,0.514,43,63,0.683,46,75,121,15,12,55,34,83,157
2205,3,1998,24,1,5,58,55,1861,249,486,0.512,0,0,-1,249,486,0.512,154,218,0.706,175,251,426,42,38,203,82,209,652
2205,3,1998,24,1,5,82,67,2447,306,597,0.513,0,0,-1,306,597,0.513,197,281,0.701,221,326,547,57,50,258,116,292,809
2205,4,1999,25,1,4,50,50,1627,197,419,0.47,0,0,-1,197,419,0.47,166,229,0.725,139,268,407,30,45,149,92,180,560
2205,5,2000,26,1,4,57,56,1795,247,491,0.503,0,0,-1,247,491,0.503,182,236,0.771,140,295,435,36,32,171,108,185,676
2205,6,2001,27,1,5,50,50,1800,228,457,0.499,0,0,-1,228,457,0.499,165,217,0.76,125,288,413,58,30,187,126,165,621
2205,7,2003,29,1,5,81,81,2518,276,595,0.464,0,0,-1,276,595,0.464,154,214,0.72,154,453,607,73,56,262,137,271,706
2205,8,2004,30,1,5,32,31,1016,95,176,0.54,0,0,-1,95,176,0.54,44,70,0.629,90,143,233,20,24,141,34,111,234
2205,8,2004,30,1,5,53,52,1648,171,373,0.458,0,0,-1,171,373,0.458,96,147,0.653,105,276,381,51,30,166,86,189,438
2205,8,2004,30,1,5,85,83,2664,266,549,0.485,0,0,-1,266,549,0.485,140,217,0.645,195,419,614,71,54,307,120,300,672
2205,9,2005,31,1,5,63,45,1731,115,257,0.447,0,0,-1,115,257,0.447,74,107,0.692,111,220,331,34,23,158,56,183,304
2205,10,2006,32,1,5,55,19,1301,108,189,0.571,0,0,-1,108,189,0.571,54,83,0.651,89,190,279,28,18,88,47,143,270
2205,11,2008,34,1,4,10,6,214,23,45,0.511,0,1,0,23,44,0.523,17,25,0.68,13,26,39,7,3,19,12,30,63
2205,11,2008,34,1,5,16,3,223,18,40,0.45,0,0,-1,18,40,0.45,12,18,0.667,19,31,50,7,4,18,9,29,48
2205,11,2008,34,1,5,26,9,437,41,85,0.482,0,1,0,41,84,0.488,29,43,0.674,32,57,89,14,7,37,21,59,111
2205,12,2009,35,1,5,46,0,579,34,64,0.531,0,0,-1,34,64,0.531,21,35,0.6,46,82,128,9,17,47,14,77,89
2205,13,2010,36,1,5,21,3,183,16,36,0.444,0,0,-1,16,36,0.444,2,4,0.5,15,25,40,9,3,18,16,27,34
2205,13,2010,36,1,5,28,26,624,54,116,0.466,0,0,-1,54,116,0.466,36,46,0.783,44,73,117,16,9,43,25,60,144
2205,13,2010,36,1,5,49,29,807,70,152,0.461,0,0,-1,70,152,0.461,38,50,0.76,59,98,157,25,12,61,41,87,178
2207,1,1984,23,1,3,28,3,196,21,58,0.362,0,0,-1,21,58,0.362,6,10,0.6,9,24,33,29,9,2,19,31,48
2208,1,2007,22,1,2,47,5,710,100,259,0.386,48,116,0.414,52,143,0.364,42,55,0.764,18,51,69,43,20,3,42,85,290
2210,1,1980,31,1,5,81,-1,1683,203,383,0.53,0,2,0,203,381,0.533,84,149,0.564,122,344,466,183,51,32,155,266,490
2210,2,1981,32,1,5,66,-1,838,64,152,0.421,0,0,-1,64,152,0.421,29,62,0.468,73,144,217,52,24,13,74,194,157
2213,1,2002,29,1,5,74,4,1179,189,374,0.505,0,0,-1,189,374,0.505,135,175,0.771,84,206,290,38,28,73,84,192,513
2213,2,2003,30,1,5,30,12,488,80,145,0.552,0,0,-1,80,145,0.552,38,48,0.792,27,65,92,9,6,17,29,79,198
2213,3,2004,31,1,5,21,2,222,22,54,0.407,0,0,-1,22,54,0.407,22,28,0.786,19,30,49,4,5,9,13,45,66
2213,3,2004,31,1,5,24,2,273,34,77,0.442,0,0,-1,34,77,0.442,23,30,0.767,23,35,58,6,5,11,17,52,91
2213,4,2005,32,1,5,58,2,928,133,234,0.568,0,0,-1,133,234,0.568,73,85,0.859,49,135,184,26,13,40,49,130,339
2213,5,2006,33,1,5,29,2,412,52,96,0.542,0,0,-1,52,96,0.542,31,41,0.756,13,51,64,9,5,19,24,59,135
2215,1,1981,23,1,4,18,-1,148,15,49,0.306,0,1,0,15,48,0.313,7,10,0.7,13,24,37,11,4,4,13,31,37
2215,2,1982,24,1,4,40,4,262,51,116,0.44,1,1,1,50,115,0.435,21,36,0.583,18,47,65,26,10,16,37,59,124
2215,3,1983,25,1,4,45,3,433,70,153,0.458,0,1,0,70,152,0.461,33,51,0.647,37,89,126,39,24,19,50,83,173
2217,1,1996,28,1,2,63,27,1275,149,359,0.415,81,191,0.424,68,168,0.405,57,66,0.864,31,113,144,170,23,5,61,111,436
2217,2,1997,29,1,2,71,4,1207,148,350,0.423,58,140,0.414,90,210,0.429,51,58,0.879,35,80,115,94,38,4,65,97,405
2217,3,1998,30,1,2,59,14,1454,206,452,0.456,62,148,0.419,144,304,0.474,74,79,0.937,32,110,142,117,41,1,91,94,548
2217,4,1999,31,1,1,44,2,708,82,184,0.446,24,60,0.4,58,124,0.468,34,39,0.872,20,57,77,91,17,1,58,66,222
2217,5,2001,33,1,1,43,0,403,38,114,0.333,13,39,0.333,25,75,0.333,14,18,0.778,13,37,50,39,6,1,27,30,103
2218,1,2002,22,1,2,67,8,1417,294,609,0.483,88,198,0.444,206,411,0.501,91,115,0.791,77,147,224,91,42,7,57,96,767
2218,2,2003,23,1,2,82,14,2316,455,971,0.469,182,416,0.438,273,555,0.492,149,185,0.805,98,273,371,117,100,13,74,143,1241
2218,3,2004,24,1,2,82,82,3021,633,1439,0.44,127,363,0.35,506,1076,0.47,383,441,0.868,118,289,407,185,81,6,116,152,1776
2218,4,2005,25,1,2,75,75,2848,625,1418,0.441,104,293,0.355,521,1125,0.463,369,432,0.854,72,240,312,172,63,8,133,152,1723
2218,5,2006,26,1,2,80,80,3130,682,1516,0.45,163,413,0.395,519,1103,0.471,501,571,0.877,78,264,342,229,95,5,170,157,2028
2218,6,2007,27,1,3,53,53,2036,477,1025,0.465,117,306,0.382,360,719,0.501,345,416,0.829,42,154,196,124,63,9,122,78,1416
2218,7,2008,28,1,2,72,71,2702,550,1243,0.442,130,359,0.362,420,884,0.475,402,490,0.82,85,224,309,247,65,13,181,120,1632
2218,8,2009,29,1,2,33,32,1203,249,547,0.455,70,191,0.366,179,356,0.503,131,161,0.814,24,83,107,88,35,2,53,45,699
2218,9,2010,30,1,2,18,12,492,75,213,0.352,18,60,0.3,57,153,0.373,47,66,0.712,11,43,54,39,19,2,15,24,215
2218,10,2011,31,1,2,10,0,134,18,45,0.4,4,17,0.235,14,28,0.5,4,4,1,0,8,8,12,2,1,4,4,44
2218,11,2012,32,1,2,51,2,770,144,360,0.4,42,132,0.318,102,228,0.447,88,111,0.793,14,63,77,33,13,0,37,29,418
2220,1,1980,24,1,2,24,-1,298,59,138,0.428,0,9,0,59,129,0.457,24,34,0.706,18,34,52,19,4,9,19,27,142
2222,1,2005,23,1,3,23,0,121,15,29,0.517,0,3,0,15,26,0.577,11,15,0.733,8,8,16,10,3,1,5,12,41
2222,2,2006,24,1,3,32,0,291,25,74,0.338,0,0,-1,25,74,0.338,25,40,0.625,13,16,29,7,5,4,15,45,75
2222,2,2006,24,1,3,40,6,706,94,221,0.425,0,1,0,94,220,0.427,62,80,0.775,40,55,95,34,18,11,37,118,250
2222,2,2006,24,1,3,72,6,997,119,295,0.403,0,1,0,119,294,0.405,87,120,0.725,53,71,124,41,23,15,52,163,325
2222,3,2007,25,1,4,41,3,318,40,107,0.374,0,0,-1,40,107,0.374,26,30,0.867,15,31,46,17,5,3,22,44,106
2225,1,1996,22,1,5,77,63,2460,401,877,0.457,0,3,0,401,874,0.459,219,299,0.732,178,392,570,109,43,55,157,226,1021
2225,2,1997,23,1,5,75,75,2777,498,1025,0.486,1,11,0.091,497,1014,0.49,216,307,0.704,174,436,610,160,29,67,175,270,1213
2225,3,1998,24,1,5,74,74,2527,492,941,0.523,0,4,0,492,937,0.525,223,316,0.706,196,389,585,155,39,80,156,278,1207
2225,4,1999,25,1,5,25,14,702,102,251,0.406,0,1,0,102,250,0.408,67,116,0.578,50,88,138,37,13,8,47,103,271
2225,5,2000,26,1,5,69,67,1773,252,562,0.448,0,4,0,252,558,0.452,107,165,0.648,126,264,390,82,33,38,119,245,611
2225,6,2001,27,1,5,75,48,1832,254,552,0.46,1,4,0.25,253,548,0.462,113,142,0.796,132,320,452,80,43,54,90,243,622
2226,1,1995,22,1,1,67,17,1462,206,465,0.443,67,171,0.392,139,294,0.473,140,196,0.714,52,134,186,288,77,10,132,139,619
2226,2,1996,23,1,1,31,7,415,41,109,0.376,17,55,0.309,24,54,0.444,18,31,0.581,7,32,39,46,21,2,33,69,117
2226,2,1996,23,1,1,20,5,418,54,118,0.458,11,36,0.306,43,82,0.524,43,51,0.843,11,29,40,72,16,1,30,46,162
2226,2,1996,23,1,1,51,12,833,95,227,0.419,28,91,0.308,67,136,0.493,61,82,0.744,18,61,79,118,37,3,63,115,279
2226,3,1997,24,1,1,13,12,384,43,111,0.387,7,35,0.2,36,76,0.474,9,12,0.75,12,19,31,56,11,2,26,40,102
2226,3,1997,24,1,1,50,18,1048,141,359,0.393,76,192,0.396,65,167,0.389,56,75,0.747,22,66,88,170,23,7,82,119,414
2226,3,1997,24,1,1,63,30,1432,184,470,0.391,83,227,0.366,101,243,0.416,65,87,0.747,34,85,119,226,34,9,108,159,516
2226,4,1998,25,1,1,82,54,1950,248,593,0.418,56,152,0.368,192,441,0.435,165,213,0.775,54,131,185,230,80,10,130,195,717
2226,5,1999,26,1,1,11,0,112,8,21,0.381,1,3,0.333,7,18,0.389,8,14,0.571,3,4,7,11,4,0,7,13,25
2230,1,1981,23,1,2,59,-1,597,84,185,0.454,0,5,0,84,180,0.467,22,39,0.564,27,33,60,71,33,5,78,111,190
2232,1,1996,22,1,4,69,46,997,106,187,0.567,0,0,-1,106,187,0.567,51,77,0.662,78,125,203,11,47,40,41,199,263
2232,2,1997,23,1,4,47,14,462,54,112,0.482,0,1,0,54,111,0.486,24,32,0.75,36,65,101,14,16,15,23,105,132
2232,3,1998,24,1,4,68,44,994,94,176,0.534,0,0,-1,94,176,0.534,50,71,0.704,77,98,175,26,25,55,28,183,238
2232,4,1999,25,1,4,47,30,935,97,174,0.557,0,0,-1,97,174,0.557,48,79,0.608,66,104,170,33,27,43,36,156,242
2232,5,2000,26,1,4,21,3,165,16,34,0.471,0,0,-1,16,34,0.471,3,6,0.5,5,20,25,1,5,12,11,45,35
2232,5,2000,26,1,4,17,0,333,44,78,0.564,0,0,-1,44,78,0.564,21,28,0.75,26,51,77,10,19,19,12,73,109
2232,5,2000,26,1,4,38,3,498,60,112,0.536,0,0,-1,60,112,0.536,24,34,0.706,31,71,102,11,24,31,23,118,144
2232,6,2001,27,1,4,65,7,764,82,145,0.566,0,0,-1,82,145,0.566,46,75,0.613,84,158,242,21,23,54,48,190,210
2232,7,2002,28,1,4,68,5,714,90,190,0.474,0,0,-1,90,190,0.474,44,68,0.647,65,111,176,27,20,44,54,180,224
2235,1,1996,22,1,1,34,1,397,32,99,0.323,9,29,0.31,23,70,0.329,30,43,0.698,9,33,42,54,16,1,41,36,103
2235,1,1996,22,1,1,36,1,405,33,100,0.33,9,29,0.31,24,71,0.338,31,46,0.674,9,35,44,54,16,2,43,37,106
2239,1,2003,27,1,5,35,0,144,20,59,0.339,4,8,0.5,16,51,0.314,8,9,0.889,10,16,26,7,6,2,4,21,52
2240,1,1996,23,1,2,62,0,845,113,292,0.387,42,122,0.344,71,170,0.418,35,42,0.833,28,46,74,68,32,4,42,67,303
2240,2,1997,24,1,2,27,0,412,53,120,0.442,19,48,0.396,34,72,0.472,27,32,0.844,11,21,32,32,20,2,22,35,152
2240,2,1997,24,1,2,41,0,495,59,139,0.424,20,57,0.351,39,82,0.476,34,39,0.872,14,25,39,40,20,2,30,40,172
2240,3,1998,25,1,2,10,0,215,36,84,0.429,6,26,0.231,30,58,0.517,4,7,0.571,7,20,27,17,5,0,15,17,82
2240,3,1998,25,1,2,47,4,696,94,209,0.45,25,67,0.373,69,142,0.486,44,54,0.815,30,43,73,44,29,1,33,58,257
2240,3,1998,25,1,2,57,4,911,130,293,0.444,31,93,0.333,99,200,0.495,48,61,0.787,37,63,100,61,34,1,48,75,339
2242,1,1980,28,1,3,82,-1,1966,369,727,0.508,5,29,0.172,364,698,0.521,131,161,0.814,142,244,386,189,54,12,129,186,874
2242,2,1981,29,1,3,64,-1,999,192,369,0.52,3,8,0.375,189,361,0.524,62,88,0.705,71,103,174,81,16,14,68,103,449
2242,3,1982,30,1,4,13,0,145,9,28,0.321,0,1,0,9,27,0.333,3,4,0.75,8,27,35,7,1,4,6,16,21
2242,3,1982,30,1,4,34,0,338,23,60,0.383,0,1,0,23,59,0.39,7,12,0.583,31,46,77,15,10,7,14,40,53
2242,3,1982,30,1,4,47,0,483,32,88,0.364,0,2,0,32,86,0.372,10,16,0.625,39,73,112,22,11,11,20,56,74
2244,1,1998,24,1,3,58,13,1070,112,305,0.367,2,8,0.25,110,297,0.37,111,180,0.617,28,42,70,110,62,10,97,125,337
2244,2,1999,25,1,2,10,1,123,11,44,0.25,1,7,0.143,10,37,0.27,11,19,0.579,7,6,13,10,4,2,15,16,34
2244,2,1999,25,1,2,13,1,156,13,52,0.25,1,7,0.143,12,45,0.267,16,25,0.64,9,8,17,11,5,2,20,21,43
2245,1,1990,22,1,3,77,60,2311,470,1071,0.439,17,69,0.246,453,1002,0.452,91,124,0.734,100,252,352,138,67,27,113,198,1048
2245,2,1991,23,1,3,77,77,2646,550,1193,0.461,71,184,0.386,479,1009,0.475,171,209,0.818,85,296,381,189,101,26,166,216,1342
2245,3,1992,24,1,3,79,79,3007,672,1432,0.469,155,396,0.391,517,1036,0.499,266,318,0.836,84,310,394,184,90,35,145,170,1765
2245,4,1993,25,1,3,82,82,3082,582,1324,0.44,148,386,0.383,434,938,0.463,242,295,0.82,92,332,424,180,92,25,157,201,1554
2245,5,1994,26,1,3,81,81,2999,663,1421,0.467,132,346,0.382,531,1075,0.494,250,284,0.88,76,358,434,184,110,32,130,186,1708
2245,6,1995,27,1,3,82,82,3014,667,1403,0.475,185,451,0.41,482,952,0.506,312,365,0.855,99,279,378,192,112,14,153,203,1831
2245,7,1996,28,1,3,79,79,3142,610,1296,0.471,171,403,0.424,439,893,0.492,319,381,0.837,86,292,378,232,91,19,163,217,1710
2245,8,1997,29,1,3,79,78,3362,722,1513,0.477,207,440,0.47,515,1073,0.48,464,535,0.867,67,251,318,160,72,26,177,190,2115
2245,9,1998,30,1,3,82,82,3295,634,1386,0.457,130,300,0.433,504,1086,0.464,428,504,0.849,89,264,353,182,77,22,182,200,1826
2245,10,1999,31,1,3,27,25,985,171,396,0.432,53,135,0.393,118,261,0.452,77,90,0.856,9,90,99,71,17,6,45,67,472
2245,11,2000,32,1,3,80,80,2530,421,980,0.43,84,229,0.367,337,751,0.449,346,396,0.874,56,271,327,176,47,12,114,179,1272
2245,12,2001,33,1,3,75,25,2212,331,752,0.44,82,211,0.389,249,541,0.46,155,182,0.852,61,246,307,89,41,13,96,179,899
2245,13,2002,34,1,3,20,20,606,65,167,0.389,18,64,0.281,47,103,0.456,24,30,0.8,5,42,47,31,12,3,24,34,172
2245,14,2003,35,1,3,62,26,1532,196,457,0.429,101,254,0.398,95,203,0.468,63,83,0.759,28,126,154,65,23,5,55,99,556
2245,15,2004,36,1,3,18,0,262,22,76,0.289,5,28,0.179,17,48,0.354,17,17,1,9,32,41,24,6,0,13,22,66
2247,1,2008,23,1,2,27,1,132,16,44,0.364,7,19,0.368,9,25,0.36,2,2,1,1,8,9,2,3,0,6,13,41
2248,1,1980,23,1,2,52,-1,988,159,348,0.457,1,3,0.333,158,345,0.458,28,45,0.622,55,68,123,107,24,15,64,97,347
2248,2,1981,24,1,2,77,-1,1313,227,464,0.489,0,1,0,227,463,0.49,84,108,0.778,83,93,176,152,36,10,110,102,538
2248,3,1982,25,1,2,77,0,1040,140,310,0.452,2,2,1,138,308,0.448,69,88,0.784,55,63,118,109,36,9,79,109,351
2248,4,1983,26,1,2,77,1,1755,259,559,0.463,0,6,0,259,553,0.468,71,111,0.64,98,149,247,168,71,18,99,164,589
2248,5,1984,27,1,2,69,12,1571,221,473,0.467,0,4,0,221,469,0.471,79,103,0.767,62,103,165,155,49,23,100,145,521
2248,6,1985,28,1,2,74,20,1531,183,404,0.453,1,3,0.333,182,401,0.454,76,89,0.854,60,95,155,157,37,15,78,143,443
2248,7,1986,29,1,2,82,61,2224,335,736,0.455,1,9,0.111,334,727,0.459,123,147,0.837,69,182,251,372,58,8,136,153,794
2248,8,1987,30,1,2,78,14,1396,218,467,0.467,6,17,0.353,212,450,0.471,59,74,0.797,51,92,143,241,49,7,85,106,501
2249,1,1980,24,1,2,82,-1,3060,502,1063,0.472,27,110,0.245,475,953,0.498,223,338,0.66,151,388,539,832,265,35,359,260,1254
2249,2,1981,25,1,2,79,-1,3175,523,1116,0.469,23,102,0.225,500,1014,0.493,224,338,0.663,173,372,545,627,232,35,302,258,1293
2249,3,1982,26,1,1,82,79,3044,619,1343,0.461,19,101,0.188,600,1242,0.483,212,303,0.7,177,388,565,572,213,41,291,317,1469
2249,4,1983,27,1,1,31,26,1002,170,388,0.438,4,20,0.2,166,368,0.451,51,76,0.671,68,82,150,187,81,15,107,116,395
2249,4,1983,27,1,1,33,25,1074,176,427,0.412,4,31,0.129,172,396,0.434,55,87,0.632,45,100,145,245,101,9,137,124,411
2249,4,1983,27,1,1,64,51,2076,346,815,0.425,8,51,0.157,338,764,0.442,106,163,0.65,113,182,295,432,182,24,244,240,806
2249,5,1984,28,1,1,48,25,1285,243,528,0.46,14,58,0.241,229,470,0.487,76,108,0.704,56,116,172,214,103,20,118,156,576
2249,6,1985,29,1,1,82,82,3127,690,1470,0.469,29,115,0.252,661,1355,0.488,240,313,0.767,156,301,457,669,243,22,249,277,1649
2249,7,1986,30,1,1,47,39,1604,296,661,0.448,4,27,0.148,292,634,0.461,141,179,0.788,77,173,250,340,125,11,150,163,737
2252,1,1994,22,1,2,79,60,2415,522,1115,0.468,54,150,0.36,468,965,0.485,215,265,0.811,118,197,315,202,54,28,218,194,1313
2252,2,1995,23,1,2,75,67,2645,558,1249,0.447,139,396,0.351,419,853,0.491,277,339,0.817,90,159,249,245,69,23,232,194,1532
2252,3,1996,24,1,2,75,68,2594,560,1206,0.464,102,275,0.371,458,931,0.492,248,296,0.838,99,210,309,213,48,23,201,204,1470
2252,4,1997,25,1,2,76,68,2563,456,983,0.464,99,257,0.385,357,726,0.492,212,261,0.812,94,210,304,198,45,19,212,199,1223
2252,5,1998,26,1,2,74,66,2786,551,1302,0.423,135,420,0.321,416,882,0.472,221,267,0.828,99,247,346,231,55,19,187,188,1458
2252,6,1999,27,1,2,47,41,1385,249,605,0.412,42,111,0.378,207,494,0.419,111,147,0.755,59,137,196,104,25,9,95,100,651
2252,7,2000,28,1,2,60,47,2084,449,1072,0.419,56,180,0.311,393,892,0.441,204,260,0.785,63,195,258,219,41,6,168,132,1158
2252,8,2001,29,1,2,67,6,1206,201,472,0.426,34,92,0.37,167,380,0.439,71,83,0.855,44,112,156,111,27,7,98,105,507
2252,9,2002,30,1,2,10,1,173,37,81,0.457,6,15,0.4,31,66,0.47,13,17,0.765,10,23,33,12,3,2,14,11,93
2253,1,1990,23,1,1,82,48,2581,426,925,0.461,23,83,0.277,403,842,0.479,63,107,0.589,55,162,217,554,133,25,141,143,938
2253,2,1991,24,1,1,82,82,3154,635,1350,0.47,42,128,0.328,593,1222,0.485,89,165,0.539,82,204,286,734,131,13,174,114,1401
2253,3,1992,25,1,1,82,82,2922,587,1261,0.466,53,155,0.342,534,1106,0.483,123,178,0.691,91,210,301,685,119,25,204,152,1350
2253,4,1993,26,1,1,74,73,2396,337,703,0.479,3,29,0.103,334,674,0.496,92,124,0.742,63,204,267,573,94,12,167,132,769
2253,5,1994,27,1,1,37,25,1022,160,354,0.452,3,12,0.25,157,342,0.459,47,77,0.61,28,82,110,237,32,3,88,78,370
2253,6,1995,28,1,1,80,77,2864,353,897,0.394,87,244,0.357,266,653,0.407,81,125,0.648,38,223,261,632,129,12,171,218,874
2253,7,1996,29,1,1,63,61,2013,281,664,0.423,94,245,0.384,187,419,0.446,78,105,0.743,35,123,158,340,77,13,95,134,734
2253,8,1997,30,1,1,59,18,1065,131,344,0.381,42,128,0.328,89,216,0.412,26,43,0.605,25,73,98,169,54,5,62,82,330
2253,9,1998,31,1,1,69,17,1252,124,333,0.372,11,57,0.193,113,276,0.409,30,43,0.698,17,79,96,226,44,3,54,71,289
2253,10,1999,32,1,1,11,0,130,12,36,0.333,0,6,0,12,30,0.4,4,4,1,1,12,13,30,4,0,9,5,28
2254,1,1989,23,1,2,79,79,2717,649,1386,0.468,33,90,0.367,616,1296,0.475,410,506,0.81,158,310,468,334,82,13,269,223,1741
2254,2,1990,24,1,2,78,78,2799,640,1287,0.497,34,95,0.358,606,1192,0.508,406,469,0.866,98,262,360,223,98,24,201,210,1720
2254,3,1991,25,1,2,77,77,3027,703,1424,0.494,40,115,0.348,663,1309,0.506,394,465,0.847,147,305,452,238,126,34,230,207,1840
2254,4,1992,26,1,2,80,80,3095,685,1465,0.468,103,268,0.384,582,1197,0.486,330,406,0.813,62,257,319,411,92,34,247,231,1803
2254,5,1993,27,1,2,45,45,1728,371,782,0.474,48,130,0.369,323,652,0.495,197,233,0.845,18,136,154,221,53,9,130,137,987
2254,6,1994,28,1,2,78,78,2897,635,1428,0.445,127,312,0.407,508,1116,0.455,426,511,0.834,70,216,286,313,103,17,216,211,1823
2254,7,1995,29,1,2,82,82,3172,668,1497,0.446,156,424,0.368,512,1073,0.477,375,445,0.843,69,288,357,311,91,29,234,227,1867
2254,8,1996,30,1,2,81,81,2946,611,1368,0.447,225,515,0.437,386,853,0.453,425,491,0.866,54,215,269,255,125,19,220,233,1872
2254,9,1997,31,1,2,81,81,3125,717,1578,0.454,204,477,0.428,513,1101,0.466,457,531,0.861,59,260,319,338,118,24,237,211,2095
2254,10,1998,32,1,2,70,70,2569,543,1220,0.445,130,334,0.389,413,886,0.466,407,471,0.864,50,179,229,279,88,15,181,154,1623
2254,11,1999,33,1,2,50,50,1912,331,803,0.412,70,221,0.317,261,582,0.448,251,293,0.857,30,142,172,122,64,10,136,121,983
2254,12,2000,34,1,2,74,69,2397,447,1049,0.426,93,241,0.386,354,808,0.438,298,340,0.876,37,176,213,185,110,13,154,191,1285
2254,13,2001,35,1,2,37,30,1216,205,504,0.407,45,133,0.338,160,371,0.431,143,160,0.894,15,94,109,111,43,7,84,86,598
2254,14,2002,36,1,2,64,2,709,100,247,0.405,18,62,0.29,82,185,0.443,42,44,0.955,14,80,94,57,18,6,40,61,260
2267,1,1984,22,1,1,81,47,1938,250,541,0.462,2,12,0.167,248,529,0.469,255,325,0.785,72,148,220,314,127,30,174,286,757
2267,2,1985,23,1,1,69,58,2126,334,701,0.476,15,36,0.417,319,665,0.48,291,378,0.77,66,148,214,410,163,53,176,250,974
2267,3,1986,24,1,1,53,50,1571,220,464,0.474,0,16,0,220,448,0.491,172,283,0.608,49,113,162,443,120,13,141,185,612
2267,4,1987,25,1,1,82,82,2590,342,758,0.451,4,21,0.19,338,737,0.459,365,441,0.828,83,216,299,823,171,30,217,287,1053
2267,5,1988,26,1,1,80,80,2502,403,890,0.453,9,33,0.273,394,857,0.46,319,421,0.758,83,283,366,747,140,41,210,272,1134
2267,6,1989,27,1,1,76,76,2462,371,816,0.455,43,124,0.347,328,692,0.474,247,287,0.861,89,197,286,525,181,40,158,263,1032
2267,7,1990,28,1,1,48,44,1526,218,480,0.454,24,66,0.364,194,414,0.469,138,170,0.812,47,153,200,264,116,22,98,151,598
2267,8,1991,29,1,1,79,79,2586,444,1020,0.435,88,262,0.336,356,758,0.47,221,262,0.844,47,206,253,340,148,47,125,216,1197
2267,9,1992,30,1,1,59,25,1657,226,533,0.424,26,92,0.283,200,441,0.454,163,196,0.832,23,124,147,233,111,19,92,166,641
2267,10,1993,31,1,1,77,45,1886,216,494,0.437,39,123,0.317,177,371,0.477,133,162,0.821,26,166,192,405,123,9,114,215,604
2267,11,1994,32,1,1,19,19,499,55,127,0.433,19,52,0.365,36,75,0.48,14,22,0.636,4,35,39,100,25,5,29,44,143
2267,12,1995,33,1,1,60,0,942,104,289,0.36,42,122,0.344,62,167,0.371,52,71,0.732,13,87,100,154,61,21,56,142,302
2267,12,1995,33,1,1,63,0,989,108,302,0.358,45,127,0.354,63,175,0.36,60,82,0.732,15,94,109,162,65,21,60,150,321
2267,13,1996,34,1,1,78,0,1235,108,290,0.372,47,137,0.343,61,153,0.399,48,64,0.75,30,108,138,123,73,21,57,175,311
2272,1,2006,23,1,5,33,0,181,20,44,0.455,0,2,0,20,42,0.476,11,23,0.478,26,23,49,5,8,2,5,30,51
2272,2,2007,24,1,4,54,18,969,94,208,0.452,0,2,0,94,206,0.456,95,131,0.725,101,160,261,30,36,13,36,133,283
2280,1,1980,24,1,5,82,27,1918,379,727,0.521,0,1,0,379,726,0.522,184,269,0.684,209,321,530,92,53,15,151,244,942
2280,2,1981,25,1,5,82,4,1569,298,547,0.545,0,1,0,298,546,0.546,144,251,0.574,132,258,390,126,38,19,141,204,740
2280,3,1982,26,1,5,80,4,1186,185,375,0.493,0,2,0,185,373,0.496,84,157,0.535,114,181,295,68,27,14,92,183,454
2280,4,1983,27,1,5,59,6,855,100,214,0.467,0,0,-1,100,214,0.467,45,78,0.577,79,140,219,65,13,8,72,131,245
2280,5,1984,28,1,5,61,4,856,140,257,0.545,1,1,1,139,256,0.543,61,88,0.693,80,118,198,65,20,14,77,120,342
2280,6,1986,30,1,5,46,1,629,72,191,0.377,0,3,0,72,188,0.383,33,48,0.688,40,108,148,58,19,5,66,92,177
2281,1,2005,24,1,2,31,1,328,36,81,0.444,3,8,0.375,33,73,0.452,18,26,0.692,14,34,48,30,11,4,20,42,93
2281,2,2006,25,1,3,66,18,1303,157,365,0.43,2,21,0.095,155,344,0.451,106,134,0.791,62,157,219,77,81,10,74,141,422
2281,3,2007,26,1,2,21,0,241,16,54,0.296,0,2,0,16,52,0.308,19,22,0.864,9,33,42,17,13,1,16,28,51
2281,3,2007,26,1,2,31,0,278,19,62,0.306,0,2,0,19,60,0.317,23,27,0.852,10,38,48,19,17,2,16,32,61
2282,1,1997,22,1,2,41,6,681,69,182,0.379,34,89,0.382,35,93,0.376,16,26,0.615,23,48,71,65,28,9,34,85,188
2282,2,1998,23,1,2,16,0,143,23,63,0.365,7,24,0.292,16,39,0.41,1,2,0.5,0,13,13,10,7,1,15,21,54
2282,2,1998,23,1,2,19,0,271,42,111,0.378,17,42,0.405,25,69,0.362,7,14,0.5,9,24,33,29,12,3,18,29,108
2282,2,1998,23,1,2,35,0,414,65,174,0.374,24,66,0.364,41,108,0.38,8,16,0.5,9,37,46,39,19,4,33,50,162
2283,1,1990,23,1,4,82,0,1565,298,751,0.397,12,44,0.273,286,707,0.405,138,251,0.55,110,198,308,72,53,53,129,226,746
2283,2,1991,24,1,4,82,11,1940,373,806,0.463,6,19,0.316,367,787,0.466,205,314,0.653,123,226,349,151,78,76,133,263,957
2283,3,1992,25,1,3,82,7,2124,398,854,0.466,1,11,0.091,397,843,0.471,219,330,0.664,140,276,416,137,85,107,154,274,1016
2283,4,1993,26,1,4,82,12,2575,632,1336,0.473,19,77,0.247,613,1259,0.487,287,416,0.69,165,377,542,182,98,163,173,287,1570
2283,5,1994,27,1,5,82,64,2853,641,1404,0.457,13,53,0.245,628,1351,0.465,352,460,0.765,164,386,550,159,118,111,169,263,1647
2283,6,1995,28,1,3,75,73,2725,597,1320,0.452,142,383,0.371,455,937,0.486,265,382,0.694,152,271,423,198,79,82,158,240,1601
2283,7,1996,29,1,3,78,76,2980,553,1306,0.423,178,471,0.378,375,835,0.449,360,542,0.664,123,320,443,190,86,68,194,248,1644
2283,8,1997,30,1,3,81,79,3077,444,1043,0.426,121,350,0.346,323,693,0.466,215,309,0.696,90,231,321,261,99,66,172,251,1224
2283,9,1998,31,1,3,80,64,2359,429,895,0.479,27,84,0.321,402,811,0.496,248,360,0.689,152,258,410,170,92,90,140,249,1133
2283,10,1999,32,1,3,50,35,1740,299,629,0.475,58,139,0.417,241,490,0.492,163,234,0.697,69,158,227,128,75,59,88,153,819
2283,11,2000,33,1,3,80,67,2839,530,1142,0.464,120,324,0.37,410,818,0.501,298,381,0.782,105,254,359,224,90,61,166,239,1478
2283,12,2001,34,1,4,82,82,2751,501,1186,0.422,90,249,0.361,411,937,0.439,253,357,0.709,105,229,334,237,87,82,186,258,1345
2283,13,2002,35,1,4,80,80,2855,454,1069,0.425,115,304,0.378,339,765,0.443,143,206,0.694,79,307,386,202,89,95,151,243,1166
2283,14,2003,36,1,4,81,69,2825,372,935,0.398,87,259,0.336,285,676,0.422,161,238,0.676,81,237,318,268,87,88,158,259,992
2283,15,2004,37,1,4,82,82,2846,366,945,0.387,112,314,0.357,254,631,0.403,123,173,0.711,54,268,322,271,68,73,173,237,967
2283,16,2005,38,1,4,29,0,599,61,169,0.361,25,66,0.379,36,103,0.35,27,39,0.692,23,72,95,30,18,14,25,74,174
2283,16,2005,38,1,5,42,29,1090,141,354,0.398,42,127,0.331,99,227,0.436,35,58,0.603,31,83,114,74,44,39,41,107,359
2283,16,2005,38,1,5,71,29,1689,202,523,0.386,67,193,0.347,135,330,0.409,62,97,0.639,54,155,209,104,62,53,66,181,533
2283,17,2006,39,1,4,80,13,1863,219,513,0.427,60,175,0.343,159,338,0.47,52,79,0.658,55,212,267,89,44,40,62,206,550
2283,18,2007,40,1,5,50,1,955,81,218,0.372,25,66,0.379,56,152,0.368,16,36,0.444,31,91,122,51,12,23,30,98,203
2284,1,1990,24,1,5,82,81,3002,690,1300,0.531,0,2,0,690,1298,0.532,613,837,0.732,303,680,983,164,138,319,257,259,1993
2284,2,1991,25,1,5,82,81,3095,754,1366,0.552,1,7,0.143,753,1359,0.554,592,777,0.762,335,728,1063,208,127,320,270,264,2101
2284,3,1992,26,1,5,68,68,2564,592,1074,0.551,1,8,0.125,591,1066,0.554,393,561,0.701,261,568,829,181,158,305,182,219,1578
2284,4,1993,27,1,5,82,82,3211,676,1348,0.501,3,17,0.176,673,1331,0.506,561,766,0.732,229,727,956,301,127,264,241,239,1916
2284,5,1994,28,1,5,80,80,3241,840,1658,0.507,10,29,0.345,830,1629,0.51,693,925,0.749,241,614,855,381,139,265,253,228,2383
2284,6,1995,29,1,5,81,81,3074,788,1487,0.53,6,20,0.3,782,1467,0.533,656,847,0.774,234,643,877,236,134,262,233,230,2238
2284,7,1996,30,1,5,82,82,3019,711,1378,0.516,3,9,0.333,708,1369,0.517,626,823,0.761,319,681,1000,247,111,271,190,262,2051
2284,8,1997,31,1,5,6,6,147,36,72,0.5,0,0,-1,36,72,0.5,34,52,0.654,19,32,51,8,6,6,8,9,106
2284,9,1998,32,1,5,73,73,2457,544,1065,0.511,1,4,0.25,543,1061,0.512,485,660,0.735,239,536,775,199,64,192,202,204,1574
2284,10,1999,33,1,5,49,49,1554,268,527,0.509,0,1,0,268,526,0.51,239,363,0.658,148,344,492,103,69,119,108,143,775
2284,11,2000,34,1,5,80,80,2557,528,1031,0.512,0,2,0,528,1029,0.513,371,511,0.726,193,577,770,142,97,183,164,247,1427
2284,12,2001,35,1,5,80,80,2371,400,823,0.486,0,1,0,400,822,0.487,351,470,0.747,208,483,691,116,80,197,122,212,1151
2284,13,2002,36,1,5,78,78,2303,341,672,0.507,0,0,-1,341,672,0.507,269,395,0.681,191,456,647,94,86,140,104,193,951
2284,14,2003,37,1,5,64,64,1676,197,420,0.469,0,0,-1,197,420,0.469,152,214,0.71,163,345,508,61,52,111,83,126,546
2285,1,2000,23,1,3,67,8,1112,212,386,0.549,0,4,0,212,382,0.555,47,64,0.734,54,130,184,32,48,25,39,67,471
2285,2,2001,24,1,3,67,6,1201,216,407,0.531,2,4,0.5,214,403,0.531,64,88,0.727,60,138,198,59,50,32,43,66,498
2285,3,2002,25,1,3,29,12,653,112,247,0.453,2,5,0.4,110,242,0.455,36,48,0.75,24,54,78,37,23,11,36,35,262
2285,4,2003,26,1,3,64,18,1355,155,315,0.492,3,14,0.214,152,301,0.505,51,63,0.81,76,124,200,66,62,13,52,120,364
2285,5,2004,27,1,3,51,4,1024,157,326,0.482,1,5,0.2,156,321,0.486,28,43,0.651,27,77,104,58,33,10,45,57,343
2287,1,1995,22,1,3,80,76,2958,636,1410,0.451,86,268,0.321,550,1142,0.482,397,499,0.796,169,344,513,197,115,22,313,234,1755
2287,2,1996,23,1,3,82,82,3249,627,1382,0.454,90,263,0.342,537,1119,0.48,316,389,0.812,136,368,504,293,95,42,282,236,1660
2287,3,1997,24,1,3,80,79,3114,669,1438,0.465,63,180,0.35,606,1258,0.482,288,364,0.791,130,372,502,248,103,68,269,225,1689
2287,4,1998,25,1,3,56,56,2294,534,1136,0.47,25,65,0.385,509,1071,0.475,215,266,0.808,82,225,307,158,69,34,200,164,1308
2287,5,1999,26,1,3,47,47,1579,347,756,0.459,31,79,0.392,316,677,0.467,140,161,0.87,73,203,276,100,46,41,106,114,865
2287,6,2000,27,1,3,81,81,2909,690,1461,0.472,86,237,0.363,604,1224,0.493,227,283,0.802,107,378,485,193,78,41,223,212,1693
2287,7,2001,28,1,3,76,74,2813,684,1460,0.468,55,184,0.299,629,1276,0.493,251,306,0.82,124,402,526,252,86,62,219,191,1674
2287,8,2002,29,1,3,66,63,2346,536,1147,0.467,58,178,0.326,478,969,0.493,236,282,0.837,70,336,406,168,97,41,174,173,1366
2287,9,2003,30,1,3,69,68,2591,539,1248,0.432,90,263,0.342,449,985,0.456,268,306,0.876,86,371,457,205,91,26,248,183,1436
2287,10,2004,31,1,3,42,42,1336,275,614,0.448,34,100,0.34,241,514,0.469,114,137,0.832,46,143,189,57,42,9,106,96,698
2287,11,2005,32,1,3,9,0,157,34,77,0.442,2,6,0.333,32,71,0.451,20,23,0.87,4,20,24,8,4,3,7,19,90
2290,1,1983,22,1,2,35,0,147,35,97,0.361,1,11,0.091,34,86,0.395,30,45,0.667,6,11,17,21,4,2,13,18,101
2292,1,1980,28,1,4,82,-1,2710,545,1064,0.512,0,0,-1,545,1064,0.512,325,487,0.667,213,557,770,142,58,59,251,262,1415
2292,2,1981,29,1,4,82,-1,3088,647,1280,0.505,0,0,-1,647,1280,0.505,249,396,0.629,216,573,789,206,68,38,250,220,1543
2292,3,1982,30,1,4,74,72,2745,579,1128,0.513,1,1,1,578,1127,0.513,255,371,0.687,202,519,721,179,42,28,202,215,1414
2292,4,1983,31,1,4,81,76,2426,326,706,0.462,0,0,-1,326,706,0.462,118,201,0.587,199,458,657,145,57,24,190,241,770
2292,5,1984,32,1,4,65,63,2135,284,581,0.489,0,0,-1,284,581,0.489,133,206,0.646,171,374,545,94,43,27,160,217,701
2293,1,1981,22,1,4,81,-1,1592,234,509,0.46,0,6,0,234,503,0.465,175,240,0.729,117,177,294,112,46,24,149,186,643
2297,1,1980,27,1,4,81,-1,1917,362,723,0.501,1,2,0.5,361,721,0.501,200,274,0.73,184,342,526,62,106,23,148,311,925
2297,2,1981,28,1,4,70,-1,1932,378,794,0.476,1,6,0.167,377,788,0.478,213,273,0.78,164,356,520,113,71,9,177,256,970
2297,2,1981,28,1,4,78,-1,2016,392,826,0.475,1,6,0.167,391,820,0.477,218,281,0.776,168,365,533,118,75,9,187,275,1003
2297,3,1982,29,1,4,56,9,651,131,294,0.446,0,0,-1,131,294,0.446,61,75,0.813,56,88,144,49,37,5,83,156,323
2298,1,1980,30,1,5,82,-1,2670,489,940,0.52,0,3,0,489,937,0.522,277,329,0.842,225,433,658,192,53,53,138,211,1255
2298,2,1981,31,1,5,11,-1,372,37,98,0.378,0,0,-1,37,98,0.378,29,36,0.806,27,58,85,44,7,6,14,21,103
2298,2,1981,31,1,5,73,-1,1744,293,642,0.456,0,0,-1,293,642,0.456,171,211,0.81,130,284,414,129,30,28,69,152,757
2298,2,1981,31,1,5,84,-1,2116,330,740,0.446,0,0,-1,330,740,0.446,200,247,0.81,157,342,499,173,37,34,83,173,860
2298,3,1982,32,1,5,12,0,257,48,106,0.453,0,0,-1,48,106,0.453,48,55,0.873,14,49,63,32,3,4,13,29,144
2298,4,1983,33,1,5,61,0,711,96,251,0.382,0,1,0,96,250,0.384,92,118,0.78,34,117,151,53,10,9,45,61,284
2298,5,1984,34,1,5,19,0,141,13,40,0.325,0,0,-1,13,40,0.325,11,13,0.846,1,20,21,13,0,1,11,13,37
2298,5,1984,34,1,5,8,0,162,18,48,0.375,0,0,-1,18,48,0.375,11,13,0.846,12,17,29,6,3,1,0,15,47
2298,5,1984,34,1,5,31,0,340,35,96,0.365,0,0,-1,35,96,0.365,22,26,0.846,15,43,58,20,3,2,12,36,92
2299,1,2007,20,1,1,67,1,862,101,239,0.423,24,85,0.282,77,154,0.5,21,26,0.808,20,71,91,218,35,2,77,72,247
2299,2,2008,21,1,1,72,0,628,69,196,0.352,17,58,0.293,52,138,0.377,25,38,0.658,13,45,58,123,24,0,53,57,180
2299,3,2009,22,1,1,80,13,1225,129,329,0.392,37,114,0.325,92,215,0.428,61,77,0.792,43,87,130,286,54,2,119,133,356
2299,4,2010,23,1,1,39,0,517,88,190,0.463,15,42,0.357,73,148,0.493,43,62,0.694,15,35,50,121,29,3,59,46,234
2299,4,2010,23,1,1,27,8,531,79,161,0.491,17,49,0.347,62,112,0.554,25,31,0.806,9,30,39,91,21,2,55,38,200
2299,4,2010,23,1,1,66,8,1048,167,351,0.476,32,91,0.352,135,260,0.519,68,93,0.731,24,65,89,212,50,5,114,84,434
2300,1,1996,23,1,3,49,2,372,32,90,0.356,2,9,0.222,30,81,0.37,24,32,0.75,30,48,78,15,10,8,17,42,90
2300,2,1997,24,1,3,17,0,107,14,48,0.292,3,11,0.273,11,37,0.297,9,19,0.474,7,7,14,6,3,1,11,10,40
2302,1,1987,25,1,4,77,1,1155,213,391,0.545,0,1,0,213,390,0.546,74,126,0.587,163,169,332,56,38,48,93,166,500
2302,2,1988,26,1,4,82,32,2147,398,709,0.561,5,17,0.294,393,692,0.568,152,284,0.535,318,397,715,110,75,45,156,273,953
2302,3,1989,27,1,4,82,8,2208,316,531,0.595,6,26,0.231,310,505,0.614,97,155,0.626,327,445,772,99,55,76,126,292,735
2302,4,1990,28,1,4,82,43,2377,288,496,0.581,1,9,0.111,287,487,0.589,142,217,0.654,336,456,792,72,52,60,90,276,719
2302,5,1991,29,1,4,82,77,2747,276,560,0.493,6,30,0.2,270,530,0.509,111,176,0.631,361,665,1026,85,65,55,94,281,669
2302,6,1992,30,1,4,82,80,3301,342,635,0.539,32,101,0.317,310,534,0.581,84,140,0.6,523,1007,1530,191,68,70,140,248,800
2302,7,1993,31,1,4,62,55,2410,183,429,0.427,15,73,0.205,168,356,0.472,87,163,0.534,367,765,1132,102,48,45,103,201,468
2302,8,1994,32,1,4,79,51,2989,156,292,0.534,5,24,0.208,151,268,0.563,53,102,0.52,453,914,1367,184,52,32,138,229,370
2302,9,1995,33,1,4,49,26,1568,137,240,0.571,0,2,0,137,238,0.576,75,111,0.676,274,549,823,97,31,23,98,159,349
2302,10,1996,34,1,4,64,57,2088,146,304,0.48,3,27,0.111,143,277,0.516,56,106,0.528,356,596,952,160,36,27,138,196,351
2302,11,1997,35,1,4,55,54,1947,128,286,0.448,5,19,0.263,123,267,0.461,50,88,0.568,320,563,883,170,32,19,111,172,311
2302,12,1998,36,1,4,80,66,2856,155,360,0.431,4,23,0.174,151,337,0.448,61,111,0.55,421,780,1201,230,47,18,147,238,375
2302,13,1999,37,1,4,23,11,657,16,46,0.348,0,2,0,16,44,0.364,17,39,0.436,62,196,258,30,10,12,31,71,49
2302,14,2000,38,1,4,12,12,389,12,31,0.387,0,1,0,12,30,0.4,10,14,0.714,48,123,171,14,2,1,19,41,34
2303,1,1995,23,1,5,49,18,1017,180,340,0.529,2,14,0.143,178,326,0.546,76,146,0.521,108,170,278,37,22,52,84,124,438
2303,2,1996,24,1,4,56,18,1043,178,344,0.517,3,21,0.143,175,323,0.542,71,130,0.546,80,90,170,35,25,48,61,87,430
2303,3,1997,25,1,4,56,3,1397,212,404,0.525,25,66,0.379,187,338,0.553,102,170,0.6,120,184,304,37,42,69,53,140,551
2303,4,1998,26,1,4,18,0,351,45,87,0.517,0,1,0,45,86,0.523,18,32,0.563,34,31,65,16,9,8,13,34,108
2303,4,1998,26,1,4,21,0,376,47,91,0.516,0,2,0,47,89,0.528,18,32,0.563,35,32,67,18,10,8,14,35,112
2303,5,2000,28,1,5,53,15,1101,170,324,0.525,1,14,0.071,169,310,0.545,81,137,0.591,98,177,275,42,14,34,63,77,422
2303,6,2001,29,1,5,39,0,544,75,110,0.682,0,1,0,75,109,0.688,29,52,0.558,48,91,139,9,10,18,17,33,179
2303,7,2002,30,1,5,22,1,168,24,43,0.558,1,6,0.167,23,37,0.622,10,19,0.526,14,24,38,3,5,6,5,17,59
2305,1,1987,23,1,4,45,15,468,90,185,0.486,0,5,0,90,180,0.5,9,15,0.6,30,47,77,26,9,8,20,66,189
2305,2,1988,24,1,4,24,0,168,26,61,0.426,0,2,0,26,59,0.441,10,13,0.769,8,19,27,3,4,3,10,23,62
2310,1,1994,22,1,3,79,14,1406,239,545,0.439,35,92,0.38,204,453,0.45,127,189,0.672,90,136,226,101,63,48,131,195,640
2310,2,1995,23,1,4,80,77,2142,375,769,0.488,50,148,0.338,325,621,0.523,179,275,0.651,132,253,385,161,95,46,173,281,979
2310,3,1996,24,1,3,67,51,1950,306,641,0.477,49,153,0.32,257,488,0.527,113,180,0.628,113,173,286,167,75,35,144,216,774
2310,4,1997,25,1,3,81,62,2480,408,884,0.462,65,180,0.361,343,704,0.487,191,288,0.663,137,274,411,222,88,61,221,272,1072
2310,5,1998,26,1,3,76,70,2499,426,935,0.456,72,212,0.34,354,723,0.49,225,328,0.686,155,269,424,202,93,38,193,242,1149
2310,6,1999,27,1,3,47,7,968,131,297,0.441,18,63,0.286,113,234,0.483,68,101,0.673,65,114,179,77,47,22,66,140,348
2310,7,2000,28,1,4,82,7,2286,428,881,0.486,115,262,0.439,313,619,0.506,159,249,0.639,138,309,447,170,94,47,163,290,1130
2310,8,2001,29,1,3,82,3,2183,377,876,0.43,56,189,0.296,321,687,0.467,188,247,0.761,94,265,359,180,97,47,157,269,998
2310,9,2002,30,1,3,27,1,626,107,222,0.482,39,95,0.411,68,127,0.535,35,50,0.7,34,73,107,40,16,12,42,78,288
2310,9,2002,30,1,3,50,7,1254,249,534,0.466,49,140,0.35,200,394,0.508,82,99,0.828,95,146,241,72,50,17,66,148,629
2310,9,2002,30,1,3,77,8,1880,356,756,0.471,88,235,0.374,268,521,0.514,117,149,0.785,129,219,348,112,66,29,108,226,917
2310,10,2003,31,1,4,68,0,1303,183,455,0.402,44,132,0.333,139,323,0.43,68,90,0.756,61,202,263,107,50,31,91,192,478
2310,11,2004,32,1,4,69,15,1409,207,505,0.41,50,152,0.329,157,353,0.445,75,98,0.765,100,207,307,137,59,27,98,183,539
2310,12,2005,33,1,4,28,7,485,63,161,0.391,23,76,0.303,40,85,0.471,20,28,0.714,33,71,104,26,22,8,20,69,169
2310,12,2005,33,1,3,30,26,882,109,289,0.377,25,92,0.272,84,197,0.426,32,42,0.762,28,114,142,60,19,12,66,103,275
2310,12,2005,33,1,3,58,33,1367,172,450,0.382,48,168,0.286,124,282,0.44,52,70,0.743,61,185,246,86,41,20,86,172,444
2312,1,1980,24,1,5,82,-1,2123,287,514,0.558,0,0,-1,287,514,0.558,157,220,0.714,283,491,774,76,54,244,99,322,731
2312,2,1981,25,1,5,40,-1,1044,116,210,0.552,0,1,0,116,209,0.555,46,57,0.807,102,184,286,35,29,117,57,151,278
2312,3,1982,26,1,5,79,39,2018,202,346,0.584,0,0,-1,202,346,0.584,79,129,0.612,168,443,611,59,35,224,79,285,483
2312,4,1983,27,1,5,80,80,2472,261,512,0.51,0,1,0,261,511,0.511,98,135,0.726,210,533,743,75,49,343,95,294,620
2312,5,1984,28,1,5,77,76,2351,274,529,0.518,0,0,-1,274,529,0.518,118,190,0.621,200,393,593,62,35,277,101,297,666
2312,6,1985,29,1,5,70,60,1750,186,339,0.549,0,0,-1,186,339,0.549,67,93,0.72,113,329,442,52,35,167,80,213,439
2312,7,1986,30,1,5,74,61,1781,173,347,0.499,0,1,0,173,346,0.5,69,90,0.767,131,327,458,41,38,167,91,239,415
2312,8,1987,31,1,5,75,58,1764,171,313,0.546,0,0,-1,171,313,0.546,63,87,0.724,155,333,488,22,43,140,61,240,405
2312,9,1988,32,1,5,76,59,1765,133,260,0.512,0,0,-1,133,260,0.512,70,80,0.875,142,317,459,20,31,132,51,229,336
2312,10,1989,33,1,5,60,2,583,62,138,0.449,0,1,0,62,137,0.453,12,19,0.632,38,101,139,19,11,38,22,89,136
2312,11,1990,34,1,5,48,19,674,57,125,0.456,0,1,0,57,124,0.46,11,16,0.688,58,95,153,24,13,53,35,83,125
2312,12,1991,35,1,5,37,0,202,14,33,0.424,0,0,-1,14,33,0.424,8,14,0.571,13,29,42,4,2,20,15,35,36
2312,13,1992,36,1,5,59,5,697,46,86,0.535,0,0,-1,46,86,0.535,26,30,0.867,61,110,171,15,14,62,18,85,118
2312,14,1993,37,1,5,42,0,247,11,41,0.268,0,2,0,11,39,0.282,9,12,0.75,12,48,60,10,6,15,9,43,31
2312,15,1994,38,1,5,45,1,384,29,53,0.547,0,0,-1,29,53,0.547,18,30,0.6,33,63,96,9,7,35,13,55,76
2312,16,1995,39,1,5,51,3,478,20,42,0.476,0,0,-1,20,42,0.476,21,31,0.677,31,64,95,9,7,36,23,63,61
2313,1,1981,22,1,1,53,-1,726,87,211,0.412,2,6,0.333,85,205,0.415,43,63,0.683,10,46,56,136,27,3,52,64,219
2313,2,1982,23,1,1,79,11,1259,203,403,0.504,3,15,0.2,200,388,0.515,79,96,0.823,12,86,98,226,60,13,89,103,488
2313,3,1983,24,1,1,82,64,2130,266,572,0.465,10,33,0.303,256,539,0.475,78,105,0.743,23,115,138,455,98,5,141,142,620
2313,4,1984,25,1,1,65,9,1007,159,346,0.46,4,32,0.125,155,314,0.494,65,90,0.722,21,71,92,192,55,8,63,76,387
2313,4,1984,25,1,1,68,9,1022,161,351,0.459,4,33,0.121,157,318,0.494,67,94,0.713,21,72,93,193,55,8,63,77,393
2319,1,1997,22,1,4,54,1,525,61,128,0.477,0,2,0,61,126,0.484,38,62,0.613,70,94,164,32,28,17,41,114,160
2319,2,1998,23,1,4,53,0,429,59,136,0.434,1,3,0.333,58,133,0.436,39,61,0.639,40,50,90,19,21,7,44,79,158
2319,3,1999,24,1,4,47,0,608,93,201,0.463,0,1,0,93,200,0.465,98,146,0.671,90,92,182,29,40,22,56,120,284
2319,4,2000,25,1,4,74,3,1341,176,385,0.457,1,3,0.333,175,382,0.458,143,198,0.722,133,202,335,47,35,52,99,232,496
2319,5,2001,26,1,4,57,9,1219,160,368,0.435,3,17,0.176,157,351,0.447,114,160,0.713,95,213,308,48,59,40,74,148,437
2319,6,2002,27,1,4,82,1,1725,293,633,0.463,1,12,0.083,292,621,0.47,185,257,0.72,172,320,492,61,70,42,140,208,772
2319,7,2003,28,1,4,79,13,1933,289,630,0.459,2,5,0.4,287,625,0.459,242,306,0.791,148,358,506,124,57,40,170,206,822
2319,8,2004,29,1,4,67,13,1256,173,404,0.428,0,3,0,173,401,0.431,183,225,0.813,110,210,320,69,36,24,112,164,529
2319,9,2005,30,1,4,26,4,613,74,174,0.425,1,6,0.167,73,168,0.435,68,87,0.782,34,80,114,18,15,7,46,84,217
2319,9,2005,30,1,4,50,1,862,124,267,0.464,0,4,0,124,263,0.471,69,99,0.697,95,132,227,41,31,9,56,124,317
2319,9,2005,30,1,4,76,5,1475,198,441,0.449,1,10,0.1,197,431,0.457,137,186,0.737,129,212,341,59,46,16,102,208,534
2319,10,2006,31,1,4,72,35,1119,105,281,0.374,1,1,1,104,280,0.371,107,137,0.781,84,175,259,67,43,14,80,145,318
2319,11,2007,32,1,4,65,2,810,74,186,0.398,2,8,0.25,72,178,0.404,42,52,0.808,47,128,175,65,26,9,65,120,192
2319,12,2008,33,1,4,49,3,494,66,180,0.367,2,7,0.286,64,173,0.37,37,51,0.725,31,72,103,28,16,7,40,80,171
2319,13,2009,34,1,4,18,0,160,11,41,0.268,0,4,0,11,37,0.297,8,11,0.727,4,27,31,10,1,1,17,24,30
2319,13,2009,34,1,3,20,0,310,34,90,0.378,0,3,0,34,87,0.391,32,40,0.8,13,52,65,26,9,2,19,48,100
2319,13,2009,34,1,3,38,0,470,45,131,0.344,0,7,0,45,124,0.363,40,51,0.784,17,79,96,36,10,3,36,72,130
2320,1,1993,23,1,5,72,68,2087,368,747,0.493,0,2,0,368,745,0.494,234,389,0.602,196,340,536,95,38,81,160,204,970
2320,2,1994,24,1,5,47,28,1255,193,393,0.491,0,1,0,193,392,0.492,150,210,0.714,84,175,259,49,21,44,80,109,536
2320,3,1995,25,1,5,80,70,2405,289,615,0.47,0,5,0,289,610,0.474,290,381,0.761,165,321,486,97,29,71,142,208,868
2320,4,1996,26,1,5,16,0,215,32,58,0.552,0,1,0,32,57,0.561,29,43,0.674,21,30,51,9,4,14,31,35,93
2320,4,1996,26,1,5,49,7,902,112,227,0.493,1,6,0.167,111,221,0.502,106,159,0.667,60,144,204,38,19,28,49,106,331
2320,4,1996,26,1,5,65,7,1117,144,285,0.505,1,7,0.143,143,278,0.514,135,202,0.668,81,174,255,47,23,42,80,141,424
2320,5,1997,27,1,5,69,3,735,87,185,0.47,0,1,0,87,184,0.473,91,130,0.7,56,107,163,42,17,38,51,123,265
2320,6,1998,28,1,5,41,1,425,46,101,0.455,0,0,-1,46,101,0.455,47,79,0.595,46,72,118,24,2,23,19,68,139
2320,7,1999,29,1,5,36,0,315,32,79,0.405,0,2,0,32,77,0.416,34,48,0.708,33,39,72,9,2,9,21,61,98
2320,8,2000,30,1,5,71,13,1001,122,283,0.431,0,0,-1,122,283,0.431,65,89,0.73,82,166,248,68,29,52,70,169,309
2320,9,2001,31,1,5,82,0,1553,169,395,0.428,1,2,0.5,168,393,0.427,107,143,0.748,91,212,303,77,34,64,73,197,446
2320,10,2002,32,1,5,61,2,728,81,194,0.418,0,0,-1,81,194,0.418,21,29,0.724,32,92,124,25,12,21,20,114,183
2320,11,2003,33,1,5,70,38,1344,125,297,0.421,0,1,0,125,296,0.422,47,58,0.81,53,163,216,69,34,44,66,174,297
2320,12,2004,34,1,5,20,0,270,20,57,0.351,0,1,0,20,56,0.357,21,22,0.955,14,33,47,18,5,5,7,41,61
2320,12,2004,34,1,5,35,0,325,34,94,0.362,0,0,-1,34,94,0.362,12,15,0.8,10,40,50,11,9,5,15,48,80
2320,12,2004,34,1,5,55,0,595,54,151,0.358,0,1,0,54,150,0.36,33,37,0.892,24,73,97,29,14,10,22,89,141
2321,1,1995,22,1,3,81,37,1798,227,500,0.454,36,114,0.316,191,386,0.495,173,234,0.739,57,160,217,389,65,22,160,206,663
2321,2,1996,23,1,2,80,37,2134,290,604,0.48,32,108,0.296,258,496,0.52,191,277,0.69,46,214,260,495,53,39,234,229,803
2321,3,1997,24,1,3,66,6,1188,172,377,0.456,21,72,0.292,151,305,0.495,117,156,0.75,27,94,121,155,57,18,107,136,482
2321,4,1998,25,1,3,82,0,1706,290,607,0.478,25,73,0.342,265,534,0.496,166,228,0.728,28,167,195,155,56,14,132,171,771
2321,5,1999,26,1,3,49,1,1238,200,496,0.403,17,65,0.262,183,431,0.425,125,158,0.791,34,120,154,93,50,15,72,128,542
2321,6,2000,27,1,3,80,80,2978,563,1196,0.471,77,196,0.393,486,1000,0.486,254,307,0.827,42,345,387,320,84,49,188,234,1457
2321,7,2001,28,1,3,72,72,2943,567,1242,0.457,59,174,0.339,508,1068,0.476,285,344,0.828,37,322,359,435,65,43,211,230,1478
2321,8,2002,29,1,3,30,30,1216,276,587,0.47,37,100,0.37,239,487,0.491,125,149,0.839,14,110,124,158,33,16,96,103,714
2321,8,2002,29,1,3,53,53,1937,387,871,0.444,52,146,0.356,335,725,0.462,156,186,0.839,29,220,249,197,45,29,105,148,982
2321,8,2002,29,1,3,83,83,3153,663,1458,0.455,89,246,0.362,574,1212,0.474,281,335,0.839,43,330,373,355,78,45,201,251,1696
2321,9,2003,30,1,3,82,82,3351,642,1583,0.406,133,359,0.37,509,1224,0.416,399,467,0.854,68,283,351,395,72,23,285,271,1816
2321,10,2004,31,1,3,16,14,529,75,200,0.375,23,54,0.426,52,146,0.356,39,51,0.765,7,57,64,56,12,4,37,45,212
2321,10,2004,31,1,1,50,50,1968,308,752,0.41,46,148,0.311,262,604,0.434,148,180,0.822,27,175,202,273,39,18,171,139,810
2321,10,2004,31,1,1,66,64,2497,383,952,0.402,69,202,0.342,314,750,0.419,187,231,0.81,34,232,266,329,51,22,208,184,1022
2321,11,2005,32,1,3,81,65,2710,527,1159,0.455,108,274,0.394,419,885,0.473,333,390,0.854,44,232,276,209,63,10,180,190,1495
2321,12,2006,33,1,2,26,23,747,110,239,0.46,28,57,0.491,82,182,0.451,82,101,0.812,13,69,82,68,10,3,50,55,330
2321,12,2006,33,1,3,46,22,1236,180,446,0.404,31,115,0.27,149,331,0.45,166,217,0.765,15,114,129,113,20,10,65,101,557
2321,12,2006,33,1,3,72,45,1983,290,685,0.423,59,172,0.343,231,513,0.45,248,318,0.78,28,183,211,181,30,13,115,156,887
2321,13,2007,34,1,3,29,0,246,38,86,0.442,21,47,0.447,17,39,0.436,11,12,0.917,3,20,23,16,5,2,9,22,108
2322,1,2005,23,1,2,78,19,1659,161,373,0.432,1,4,0.25,160,369,0.434,74,110,0.673,59,151,210,109,51,22,54,165,397
2322,2,2006,24,1,2,67,45,1515,130,308,0.422,0,7,0,130,301,0.432,57,75,0.76,38,132,170,79,51,16,47,155,317
2322,3,2007,25,1,2,81,43,1700,177,379,0.467,2,10,0.2,175,369,0.474,68,87,0.782,60,130,190,86,70,32,33,179,424
2322,4,2008,26,1,2,76,44,1505,131,335,0.391,9,21,0.429,122,314,0.389,40,60,0.667,54,118,172,88,43,33,29,132,311
2322,5,2009,27,1,3,68,7,1164,99,259,0.382,33,88,0.375,66,171,0.386,34,42,0.81,29,97,126,47,32,14,36,114,265
2322,6,2010,28,1,2,25,0,261,17,55,0.309,1,8,0.125,16,47,0.34,3,6,0.5,6,16,22,5,6,2,8,35,38
2322,6,2010,28,1,3,27,7,301,23,56,0.411,3,13,0.231,20,43,0.465,5,8,0.625,11,16,27,7,7,4,3,34,54
2322,6,2010,28,1,3,52,7,562,40,111,0.36,4,21,0.19,36,90,0.4,8,14,0.571,17,32,49,12,13,6,11,69,92
2322,7,2011,29,1,3,36,4,353,26,59,0.441,0,3,0,26,56,0.464,5,14,0.357,10,20,30,10,3,6,7,40,57
2323,1,1990,22,1,5,42,0,412,37,86,0.43,0,1,0,37,85,0.435,7,14,0.5,44,76,120,20,8,13,16,70,81
2324,1,1988,24,1,3,26,0,201,30,74,0.405,2,11,0.182,28,63,0.444,22,30,0.733,7,21,28,16,12,0,11,37,84
2324,2,1989,25,1,3,47,3,464,52,143,0.364,2,10,0.2,50,133,0.376,52,76,0.684,20,36,56,48,19,4,33,55,158
2324,2,1989,25,1,3,63,3,536,59,167,0.353,3,16,0.188,56,151,0.371,60,87,0.69,20,44,64,55,24,5,40,69,181
2324,3,1990,26,1,3,71,3,1061,159,420,0.379,18,52,0.346,141,368,0.383,150,201,0.746,34,78,112,115,51,6,85,144,486
2327,1,1980,26,1,4,81,-1,2588,502,1007,0.499,0,4,0,502,1003,0.5,330,465,0.71,293,544,837,184,101,139,233,317,1334
2327,2,1981,27,1,4,63,-1,2128,426,808,0.527,0,1,0,426,807,0.528,256,355,0.721,231,403,634,161,76,119,178,258,1108
2327,3,1982,28,1,4,61,58,2217,424,910,0.466,1,5,0.2,423,905,0.467,285,375,0.76,227,494,721,162,64,93,183,210,1134
2327,4,1983,29,1,4,77,76,2811,561,1193,0.47,5,27,0.185,556,1166,0.477,337,450,0.749,259,621,880,225,60,115,245,239,1464
2327,5,1984,30,1,4,73,72,2610,503,1038,0.485,0,11,0,503,1027,0.49,374,486,0.77,206,515,721,184,61,74,205,221,1380
2327,6,1985,31,1,4,56,43,1492,236,505,0.467,0,2,0,236,503,0.469,139,178,0.781,175,278,453,102,26,54,123,147,611
2327,7,1986,32,1,4,79,21,2321,322,660,0.488,0,6,0,322,654,0.492,273,362,0.754,210,432,642,167,36,51,187,194,917
2327,8,1987,33,1,4,36,0,669,90,220,0.409,1,5,0.2,89,215,0.414,57,72,0.792,64,106,170,39,11,16,49,77,238
2331,1,1990,29,1,4,14,0,112,14,32,0.438,0,0,-1,14,32,0.438,22,26,0.846,17,12,29,5,1,2,10,19,50
2333,1,1989,23,1,4,34,0,517,80,162,0.494,1,1,1,79,161,0.491,65,81,0.802,56,81,137,24,10,12,18,69,226
2333,2,1990,24,1,4,44,2,559,78,179,0.436,1,2,0.5,77,177,0.435,68,83,0.819,44,87,131,22,18,11,25,58,225
2337,1,1995,22,1,5,66,34,1494,189,390,0.485,2,7,0.286,187,383,0.488,68,152,0.447,200,286,486,45,35,39,89,196,448
2337,2,1996,23,1,5,59,1,723,79,135,0.585,0,2,0,79,133,0.594,26,55,0.473,71,100,171,22,19,30,40,135,184
2337,3,1997,24,1,5,41,29,732,79,173,0.457,0,2,0,79,171,0.462,31,61,0.508,102,132,234,31,24,44,29,97,189
2337,3,1997,24,1,5,42,29,737,79,174,0.454,0,2,0,79,172,0.459,31,61,0.508,102,132,234,31,24,44,29,97,189
2339,1,1990,27,1,1,77,2,850,111,259,0.429,16,56,0.286,95,203,0.468,35,53,0.66,12,43,55,177,22,1,88,81,273
2339,2,1991,28,1,1,82,0,874,124,285,0.435,17,61,0.279,107,224,0.478,59,71,0.831,14,52,66,216,36,2,102,92,324
2339,3,1992,29,1,2,65,0,538,75,188,0.399,11,47,0.234,64,141,0.454,32,42,0.762,15,39,54,109,15,1,49,64,193
2341,1,1995,24,1,1,49,1,319,84,197,0.426,38,99,0.384,46,98,0.469,27,38,0.711,8,15,23,48,14,2,47,52,233
2341,2,1996,25,1,1,61,23,1551,263,648,0.406,104,284,0.366,159,364,0.437,148,182,0.813,21,111,132,269,43,2,149,132,778
2346,1,1994,23,1,3,67,48,1121,135,279,0.484,2,22,0.091,133,257,0.518,62,101,0.614,61,120,181,54,68,19,55,138,334
2346,2,1995,24,1,3,63,15,860,104,238,0.437,13,44,0.295,91,194,0.469,62,93,0.667,44,97,141,34,48,11,42,101,283
2346,3,1996,25,1,3,59,9,577,56,142,0.394,14,40,0.35,42,102,0.412,48,67,0.716,28,62,90,29,29,8,36,66,174
2346,4,1997,26,1,3,81,81,2525,297,620,0.479,108,264,0.409,189,356,0.531,171,244,0.701,79,252,331,123,129,27,94,237,873
2346,5,1998,27,1,3,82,7,2219,226,525,0.43,73,214,0.341,153,311,0.492,213,278,0.766,78,248,326,101,90,31,81,229,738
2346,6,1999,28,1,3,50,50,1770,217,468,0.464,52,147,0.354,165,321,0.514,136,171,0.795,65,201,266,74,76,15,76,154,622
2346,7,2000,29,1,3,82,70,2900,408,914,0.446,106,268,0.396,302,646,0.467,237,316,0.75,99,328,427,158,128,23,101,255,1159
2346,8,2001,30,1,3,78,46,2473,308,700,0.44,95,230,0.413,213,470,0.453,222,285,0.779,94,236,330,160,96,20,113,229,933
2346,9,2002,31,1,2,66,40,1998,222,584,0.38,77,226,0.341,145,358,0.405,115,140,0.821,79,216,295,136,64,19,110,205,636
2346,10,2003,32,1,3,70,23,1388,108,306,0.353,46,140,0.329,62,166,0.373,53,69,0.768,43,165,208,72,70,7,55,130,315
2346,11,2004,33,1,3,72,1,945,98,244,0.402,43,112,0.384,55,132,0.417,50,65,0.769,32,114,146,71,32,12,37,110,289
2346,12,2005,34,1,3,70,2,1026,95,252,0.377,56,149,0.376,39,103,0.379,61,77,0.792,50,122,172,72,44,11,35,130,307
2349,1,1983,22,1,1,68,1,757,67,184,0.364,2,18,0.111,65,166,0.392,47,58,0.81,19,54,73,131,16,1,92,71,183
2349,2,1984,23,1,1,16,0,119,14,42,0.333,1,2,0.5,13,40,0.325,12,13,0.923,6,13,19,22,4,0,9,25,41
2349,3,1985,24,1,1,21,2,377,34,63,0.54,1,1,1,33,62,0.532,14,17,0.824,8,32,40,66,17,4,40,37,83
2349,4,1987,26,1,1,48,0,511,64,165,0.388,2,16,0.125,62,149,0.416,27,37,0.73,18,37,55,129,20,5,60,62,157
2350,1,2012,29,1,1,28,0,357,33,95,0.347,4,13,0.308,29,82,0.354,14,22,0.636,7,19,26,58,18,1,33,29,84
2358,1,1984,23,1,5,78,8,1040,123,238,0.517,0,1,0,123,237,0.519,31,51,0.608,64,163,227,60,24,85,65,164,277
2358,2,1985,24,1,5,62,5,703,85,190,0.447,0,1,0,85,189,0.45,29,50,0.58,57,113,170,30,16,44,55,107,199
2358,3,1986,25,1,5,43,0,156,13,39,0.333,0,1,0,13,38,0.342,1,6,0.167,15,13,28,8,4,10,11,30,27
2358,4,1987,26,1,5,44,26,534,40,93,0.43,0,1,0,40,92,0.435,5,9,0.556,38,49,87,22,10,31,16,83,85
2358,5,1988,27,1,5,22,0,114,9,29,0.31,0,1,0,9,28,0.321,0,2,0,9,19,28,1,2,15,6,26,18
2361,1,1997,20,1,4,82,68,2970,576,1354,0.425,52,159,0.327,524,1195,0.438,231,366,0.631,288,453,741,262,105,53,230,271,1435
2361,2,1998,21,1,4,82,82,3268,722,1705,0.423,91,292,0.312,631,1413,0.447,305,473,0.645,270,566,836,273,142,60,292,262,1840
2361,3,1999,22,1,4,42,41,1549,303,735,0.412,65,176,0.369,238,559,0.426,113,202,0.559,106,253,359,130,63,28,119,142,784
2361,4,2000,23,1,4,82,82,3003,648,1506,0.43,73,285,0.256,575,1221,0.471,311,445,0.699,199,453,652,305,117,32,259,263,1680
2361,5,2001,24,1,4,81,81,3396,711,1720,0.413,221,603,0.367,490,1117,0.439,249,348,0.716,151,568,719,445,138,49,301,251,1892
2361,6,2002,25,1,4,81,81,3406,666,1689,0.394,222,645,0.344,444,1044,0.425,240,324,0.741,150,564,714,407,122,38,251,237,1794
2361,7,2003,26,1,4,78,78,3235,603,1554,0.388,188,582,0.323,415,972,0.427,176,286,0.615,99,464,563,373,116,31,260,221,1570
2361,8,2004,27,1,4,82,82,2840,483,1129,0.428,82,305,0.269,401,824,0.487,103,186,0.554,198,486,684,369,65,65,202,212,1151
2361,9,2005,28,1,4,24,24,827,161,364,0.442,25,73,0.342,136,291,0.467,44,79,0.557,56,142,198,71,25,26,70,70,391
2361,9,2005,28,1,4,53,53,2128,420,1013,0.415,85,268,0.317,335,745,0.45,157,294,0.534,126,371,497,194,64,32,183,147,1082
2361,9,2005,28,1,4,77,77,2955,581,1377,0.422,110,341,0.323,471,1036,0.455,201,373,0.539,182,513,695,265,89,58,253,217,1473
2361,10,2006,29,1,4,82,19,2199,391,898,0.435,137,383,0.358,254,515,0.493,81,129,0.628,103,318,421,166,47,30,150,187,1000
2361,11,2007,30,1,4,78,15,1818,265,668,0.397,84,305,0.275,181,363,0.499,46,105,0.438,92,247,339,130,48,17,141,173,660
2361,12,2008,31,1,4,46,1,892,136,375,0.363,61,188,0.324,75,187,0.401,35,66,0.53,56,112,168,45,33,8,46,80,368
2362,1,2009,21,1,3,29,0,216,36,58,0.621,0,1,0,36,57,0.632,16,23,0.696,8,21,29,13,6,2,18,51,88
2362,2,2010,22,1,2,27,13,739,117,226,0.518,50,116,0.431,67,110,0.609,37,47,0.787,15,68,83,37,23,3,26,79,321
2362,2,2010,22,1,2,35,13,768,120,232,0.517,50,116,0.431,70,116,0.603,39,49,0.796,15,73,88,40,23,3,28,83,329
2362,3,2011,23,1,2,61,1,784,104,236,0.441,59,153,0.386,45,83,0.542,31,44,0.705,16,106,122,34,21,6,37,81,298
2362,4,2012,24,1,2,32,8,620,68,171,0.398,36,113,0.319,32,58,0.552,17,20,0.85,9,71,80,37,19,7,35,84,189
2365,1,1984,22,1,1,82,0,1324,216,518,0.417,4,15,0.267,212,503,0.421,208,263,0.791,74,93,167,284,127,15,194,202,644
2365,2,1985,23,1,1,82,66,2489,430,989,0.435,0,17,0,430,972,0.442,243,347,0.7,128,150,278,408,167,21,204,244,1103
2365,3,1986,24,1,1,81,35,2023,324,753,0.43,0,10,0,324,743,0.436,190,277,0.686,100,120,220,337,146,36,192,216,838
2365,4,1987,25,1,1,81,25,2020,358,742,0.482,0,4,0,358,738,0.485,272,365,0.745,157,170,327,282,120,37,187,229,988
2365,5,1988,26,1,2,52,0,940,114,291,0.392,0,6,0,114,285,0.4,82,105,0.781,43,84,127,100,62,10,69,105,310
2365,6,1989,27,1,1,79,78,2565,286,681,0.42,0,9,0,286,672,0.426,142,184,0.772,135,372,507,496,155,23,184,215,714
2365,7,1990,28,1,1,81,81,2883,316,696,0.454,2,21,0.095,314,675,0.465,138,201,0.687,173,541,714,652,139,30,173,220,772
2365,8,1991,29,1,1,71,65,2305,230,535,0.43,0,9,0,230,526,0.437,93,154,0.604,140,358,498,459,78,33,154,199,553
2365,9,1992,30,1,2,74,4,1541,161,381,0.423,0,10,0,161,371,0.434,65,105,0.619,85,153,238,205,63,18,79,134,387
2365,10,1993,31,1,2,9,2,144,3,19,0.158,0,1,0,3,18,0.167,2,6,0.333,4,15,19,9,10,0,13,12,8
2365,10,1993,31,1,1,28,0,367,31,77,0.403,0,0,-1,31,77,0.403,10,20,0.5,18,21,39,44,23,2,12,51,72
2365,10,1993,31,1,1,37,2,511,34,96,0.354,0,1,0,34,95,0.358,12,26,0.462,22,36,58,53,33,2,25,63,80
2366,1,1980,28,1,1,76,-1,2422,258,568,0.454,1,9,0.111,257,559,0.46,195,243,0.802,78,209,287,607,155,12,157,202,712
2366,2,1981,29,1,1,41,-1,1172,72,169,0.426,2,9,0.222,70,160,0.438,88,111,0.793,22,80,102,253,52,1,85,105,234
2366,3,1982,30,1,1,77,54,1861,156,378,0.413,3,9,0.333,153,369,0.415,141,194,0.727,31,119,150,398,120,6,107,179,456
2366,4,1983,31,1,1,79,10,1388,114,250,0.456,2,12,0.167,112,238,0.471,116,149,0.779,30,106,136,264,78,3,104,134,346
2366,5,1984,32,1,1,34,0,378,32,90,0.356,2,5,0.4,30,85,0.353,24,27,0.889,8,23,31,81,20,3,31,37,90
2372,1,1980,25,1,3,70,-1,844,139,274,0.507,0,0,-1,139,274,0.507,48,64,0.75,64,106,170,53,21,4,50,102,326
2372,2,1981,26,1,3,82,-1,1796,290,626,0.463,0,3,0,290,623,0.465,109,169,0.645,105,210,315,122,53,15,115,168,689
2372,3,1982,27,1,3,70,70,1965,302,629,0.48,0,2,0,302,627,0.482,90,134,0.672,108,197,305,218,36,28,111,215,694
2372,4,1983,28,1,3,82,59,2251,362,806,0.449,1,4,0.25,361,802,0.45,72,116,0.621,137,236,373,199,37,22,144,202,797
2372,5,1984,29,1,3,58,18,612,118,241,0.49,2,6,0.333,116,235,0.494,6,18,0.333,26,66,92,55,17,4,33,65,244
2374,1,1997,20,1,4,43,12,602,83,187,0.444,0,1,0,83,186,0.446,48,74,0.649,47,100,147,17,15,22,39,71,214
2374,2,1998,21,1,4,41,19,1027,156,321,0.486,0,1,0,156,320,0.488,53,97,0.546,96,206,302,24,30,40,61,127,365
2374,3,1999,22,1,4,39,2,568,88,190,0.463,0,1,0,88,189,0.466,53,98,0.541,46,97,143,6,9,16,37,87,229
2374,4,2000,23,1,4,71,7,980,137,305,0.449,0,0,-1,137,305,0.449,86,126,0.683,77,195,272,38,10,35,64,108,360
2374,5,2001,24,1,4,61,1,963,121,252,0.48,1,3,0.333,120,249,0.482,78,124,0.629,67,176,243,29,10,41,68,103,321
2374,6,2002,25,1,4,69,63,1655,187,365,0.512,0,0,-1,187,365,0.512,86,129,0.667,129,352,481,64,28,88,53,170,460
2374,7,2003,26,1,5,67,39,1243,115,274,0.42,0,1,0,115,273,0.421,66,101,0.653,115,253,368,64,20,55,56,143,296
2374,8,2004,27,1,4,33,0,418,38,99,0.384,0,2,0,38,97,0.392,29,44,0.659,42,70,112,6,9,11,15,54,105
2374,9,2005,28,1,4,14,0,134,11,31,0.355,0,0,-1,11,31,0.355,2,3,0.667,8,10,18,4,3,7,8,25,24
2375,1,1997,22,1,4,34,0,197,16,46,0.348,0,0,-1,16,46,0.348,6,20,0.3,25,33,58,2,8,11,18,27,38
2375,2,1998,23,1,5,67,16,1124,85,164,0.518,0,0,-1,85,164,0.518,35,98,0.357,112,212,324,18,61,72,28,116,205
2375,3,1999,24,1,5,46,16,1231,115,199,0.578,0,0,-1,115,199,0.578,47,132,0.356,137,247,384,18,50,90,36,111,277
2375,4,2000,25,1,4,81,81,1959,168,334,0.503,0,0,-1,168,334,0.503,54,114,0.474,211,454,665,67,72,130,67,162,390
2375,5,2001,26,1,5,80,80,2760,215,439,0.49,1,4,0.25,214,435,0.492,80,238,0.336,303,749,1052,123,107,186,117,192,511
2375,6,2002,27,1,5,80,80,2921,255,480,0.531,0,3,0,255,477,0.535,99,234,0.423,318,721,1039,115,138,278,70,178,609
2375,7,2003,28,1,5,73,73,2873,210,437,0.481,1,6,0.167,209,431,0.485,85,189,0.45,293,833,1126,120,104,230,88,179,506
2375,8,2004,29,1,5,81,81,3050,315,748,0.421,1,8,0.125,314,740,0.424,142,290,0.49,324,682,1006,138,143,246,123,162,773
2375,9,2005,30,1,5,74,74,2671,295,651,0.453,1,9,0.111,294,642,0.458,130,304,0.428,292,610,902,123,106,176,82,159,721
2375,10,2006,31,1,5,82,82,2890,237,465,0.51,0,4,0,237,461,0.514,123,296,0.416,301,622,923,158,146,181,88,164,597
2375,11,2007,32,1,5,77,77,2697,192,424,0.453,1,5,0.2,191,419,0.456,109,267,0.408,303,518,821,186,111,156,101,153,494
2375,12,2008,33,1,4,22,22,578,37,81,0.457,0,0,-1,37,81,0.457,19,44,0.432,59,104,163,13,19,37,18,35,93
2375,12,2008,33,1,5,50,50,1627,101,271,0.373,0,4,0,101,267,0.378,53,125,0.424,175,266,441,92,69,80,49,86,255
2375,12,2008,33,1,5,72,72,2205,138,352,0.392,0,4,0,138,348,0.397,72,169,0.426,234,370,604,105,88,117,67,121,348
2375,13,2009,34,1,4,56,53,1314,69,155,0.445,0,0,-1,69,155,0.445,27,64,0.422,136,226,362,44,48,75,34,82,165
2375,14,2010,35,1,5,69,67,1975,158,292,0.541,0,2,0,158,290,0.545,65,160,0.406,245,352,597,105,86,84,64,131,381
2375,15,2011,36,1,5,54,49,1238,67,149,0.45,1,2,0.5,66,147,0.449,19,57,0.333,129,221,350,72,54,54,44,81,154
2375,16,2012,37,1,5,62,11,980,34,86,0.395,1,4,0.25,33,82,0.402,16,47,0.34,81,188,269,43,47,51,34,60,85
2377,1,1994,23,1,2,48,0,386,60,115,0.522,14,28,0.5,46,87,0.529,28,34,0.824,6,32,38,71,15,3,30,41,162
2377,2,1995,24,1,2,80,30,1435,206,469,0.439,71,196,0.362,135,273,0.495,40,52,0.769,18,75,93,121,37,16,71,135,523
2377,3,1996,25,1,2,33,8,523,49,115,0.426,19,54,0.352,30,61,0.492,36,46,0.783,11,37,48,95,22,4,34,49,153
2377,3,1996,25,1,2,44,8,610,61,148,0.412,22,66,0.333,39,82,0.476,42,52,0.808,13,42,55,106,25,4,41,53,186
2377,4,1997,26,1,2,59,16,1041,148,325,0.455,57,148,0.385,91,177,0.514,49,62,0.79,21,86,107,113,28,3,61,75,402
2377,5,1998,27,1,2,19,0,108,13,24,0.542,3,8,0.375,10,16,0.625,9,11,0.818,2,13,15,14,3,1,10,11,38
2377,5,1998,27,1,2,19,0,127,11,29,0.379,3,14,0.214,8,15,0.533,17,17,1,3,6,9,21,5,0,17,17,42
2377,5,1998,27,1,2,38,0,235,24,53,0.453,6,22,0.273,18,31,0.581,26,28,0.929,5,19,24,35,8,1,27,28,80
2377,6,1999,28,1,2,33,13,506,35,95,0.368,12,38,0.316,23,57,0.404,19,23,0.826,10,40,50,58,10,3,32,63,101
2377,7,2000,29,1,1,33,0,389,38,91,0.418,5,20,0.25,33,71,0.465,12,16,0.75,8,28,36,65,6,0,29,44,93
2380,1,1980,26,1,1,76,-1,1243,110,242,0.455,1,3,0.333,109,239,0.456,49,71,0.69,33,58,91,285,43,2,112,68,270
2380,2,1981,27,1,1,61,-1,821,90,218,0.413,0,1,0,90,217,0.415,26,33,0.788,13,35,48,208,32,2,80,45,206
2383,1,1996,25,1,1,62,1,787,87,218,0.399,33,99,0.333,54,119,0.454,37,54,0.685,29,73,102,132,54,6,79,98,244
2383,2,1997,26,1,1,79,21,1763,133,337,0.395,48,154,0.312,85,183,0.464,95,125,0.76,45,175,220,326,83,15,147,188,409
2383,3,1998,27,1,1,82,82,2317,235,516,0.455,81,215,0.377,154,301,0.512,91,113,0.805,32,242,274,466,144,37,175,195,642
2383,4,1999,28,1,1,50,50,1556,135,334,0.404,53,149,0.356,82,185,0.443,55,78,0.705,23,149,172,271,103,8,131,105,378
2383,5,2000,29,1,1,72,69,1986,189,447,0.423,102,264,0.386,87,183,0.475,48,58,0.828,22,206,228,300,95,16,102,176,528
2383,6,2001,30,1,1,61,33,1492,155,373,0.416,67,175,0.383,88,198,0.444,56,70,0.8,32,127,159,273,70,10,112,132,433
2383,7,2002,31,1,1,63,0,1058,113,303,0.373,53,164,0.323,60,139,0.432,47,58,0.81,15,112,127,203,68,14,75,100,326
2383,8,2003,32,1,1,66,6,1465,165,414,0.399,101,267,0.378,64,147,0.435,41,53,0.774,25,152,177,306,78,11,95,146,472
2383,9,2004,33,1,1,36,0,425,45,130,0.346,25,68,0.368,20,62,0.323,4,6,0.667,2,46,48,45,17,3,27,33,119
2383,9,2004,33,1,1,35,10,827,115,260,0.442,59,138,0.428,56,122,0.459,16,21,0.762,10,86,96,170,47,8,69,74,305
2383,9,2004,33,1,1,71,10,1252,160,390,0.41,84,206,0.408,76,184,0.413,20,27,0.741,12,132,144,215,64,11,96,107,424
2383,10,2005,34,1,1,14,13,360,24,77,0.312,16,51,0.314,8,26,0.308,11,13,0.846,6,33,39,43,15,0,18,22,75
2387,1,2011,21,1,1,19,0,134,13,35,0.371,5,15,0.333,8,20,0.4,6,8,0.75,1,11,12,27,6,0,8,16,37
2392,1,1983,23,1,1,43,20,727,65,171,0.38,0,5,0,65,166,0.392,42,57,0.737,15,54,69,126,21,8,71,103,172
2392,2,1984,24,1,1,32,0,254,27,66,0.409,1,3,0.333,26,63,0.413,8,16,0.5,5,17,22,43,9,3,20,37,63
2392,3,1985,25,1,1,58,1,713,85,173,0.491,1,4,0.25,84,169,0.497,44,57,0.772,10,48,58,153,23,6,70,85,215
2392,4,1986,26,1,1,31,5,658,81,172,0.471,2,10,0.2,79,162,0.488,53,67,0.791,10,56,66,109,25,2,48,76,217
2392,4,1986,26,1,1,36,5,685,85,182,0.467,3,12,0.25,82,170,0.482,54,68,0.794,10,59,69,115,27,2,53,79,227
2394,1,1987,21,1,5,35,2,385,57,145,0.393,0,1,0,57,144,0.396,18,51,0.353,36,65,101,16,6,8,39,51,132
2394,2,1988,22,1,5,29,0,174,22,49,0.449,0,0,-1,22,49,0.449,13,23,0.565,19,36,55,3,4,8,10,19,57
2394,2,1988,22,1,5,37,0,260,36,81,0.444,0,0,-1,36,81,0.444,18,31,0.581,28,47,75,6,5,8,17,29,90
2395,1,2006,23,1,4,68,2,724,101,228,0.443,0,0,-1,101,228,0.443,76,115,0.661,43,101,144,30,14,21,56,113,278
2395,2,2007,24,1,4,82,43,2152,373,712,0.524,0,8,0,373,704,0.53,299,388,0.771,130,290,420,75,43,30,161,232,1045
2395,3,2008,25,1,4,75,30,1754,328,653,0.502,13,48,0.271,315,605,0.521,183,260,0.704,123,233,356,53,36,28,85,156,852
2395,4,2009,26,1,4,82,7,2029,340,693,0.491,5,23,0.217,335,670,0.5,266,374,0.711,129,277,406,66,48,39,98,170,951
2395,5,2010,27,1,4,28,0,533,83,172,0.483,0,1,0,83,171,0.485,77,102,0.755,40,62,102,17,7,8,23,43,243
2395,5,2010,27,1,4,48,6,1024,182,378,0.481,1,6,0.167,181,372,0.487,125,172,0.727,87,125,212,35,17,10,57,83,490
2395,5,2010,27,1,4,76,6,1557,265,550,0.482,1,7,0.143,264,543,0.486,202,274,0.737,127,187,314,52,24,18,80,126,733
2395,6,2011,28,1,4,80,6,1416,228,446,0.511,1,11,0.091,227,435,0.522,212,294,0.721,88,208,296,69,32,9,79,100,669
2395,7,2012,29,1,4,35,0,503,74,180,0.411,1,10,0.1,73,170,0.429,76,99,0.768,31,61,92,30,8,3,36,35,225
2395,8,2013,30,1,4,27,14,482,66,163,0.405,0,3,0,66,160,0.413,58,86,0.674,21,68,89,25,12,6,29,37,190
2395,8,2013,30,1,4,28,14,489,67,165,0.406,0,3,0,67,162,0.414,60,88,0.682,21,68,89,25,13,6,29,37,194
2397,1,2008,22,1,2,18,0,146,21,48,0.438,4,12,0.333,17,36,0.472,7,13,0.538,4,16,20,15,5,0,14,16,53
2399,1,1998,23,1,2,66,36,1539,201,498,0.404,44,137,0.321,157,361,0.435,65,83,0.783,47,80,127,78,53,25,72,143,511
2399,2,1999,24,1,2,38,6,761,73,184,0.397,37,97,0.381,36,87,0.414,22,32,0.688,35,54,89,30,25,18,34,87,205
2401,1,1987,23,1,1,72,61,1600,257,538,0.478,4,24,0.167,253,514,0.492,98,125,0.784,37,92,129,301,92,7,175,184,616
2401,2,1988,24,1,1,68,10,1379,245,547,0.448,11,49,0.224,234,498,0.47,132,189,0.698,54,64,118,206,91,4,141,163,633
2401,3,1989,25,1,1,54,8,1065,164,387,0.424,1,14,0.071,163,373,0.437,82,104,0.788,49,74,123,226,73,4,122,101,411
2402,1,1980,24,1,4,75,-1,1092,197,421,0.468,0,0,-1,197,421,0.468,46,76,0.605,95,181,276,55,26,48,63,166,440
2402,2,1981,25,1,4,11,-1,307,51,117,0.436,0,0,-1,51,117,0.436,17,23,0.739,25,59,84,16,5,7,21,37,119
2402,2,1981,25,1,4,69,-1,1505,289,630,0.459,1,2,0.5,288,628,0.459,102,136,0.75,133,236,369,113,41,54,108,246,681
2402,2,1981,25,1,4,80,-1,1812,340,747,0.455,1,2,0.5,339,745,0.455,119,159,0.748,158,295,453,129,46,61,129,283,800
2402,3,1982,26,1,4,18,2,313,50,115,0.435,0,2,0,50,113,0.442,9,15,0.6,32,43,75,15,8,2,35,51,109
2409,1,1993,22,1,3,82,82,2654,494,1053,0.469,1,4,0.25,493,1049,0.47,291,408,0.713,179,410,589,147,85,67,176,188,1280
2409,2,1994,23,1,3,82,82,3147,602,1246,0.483,4,17,0.235,598,1229,0.487,298,430,0.693,254,578,832,192,100,116,195,152,1506
2409,3,1995,24,1,3,76,76,2991,543,1238,0.439,4,21,0.19,539,1217,0.443,283,377,0.751,144,382,526,215,115,67,191,195,1373
2409,4,1996,25,1,3,78,75,3096,491,1015,0.484,0,2,0,491,1013,0.485,318,426,0.746,237,516,753,158,112,108,179,214,1300
2409,5,1997,26,1,3,82,82,2949,398,811,0.491,1,6,0.167,397,805,0.493,206,279,0.738,219,460,679,140,74,86,137,187,1003
2409,6,1998,27,1,4,31,31,1035,127,277,0.458,0,0,-1,127,277,0.458,77,103,0.748,89,169,258,49,42,22,50,86,331
2409,6,1998,27,1,4,48,18,1290,141,331,0.426,0,0,-1,141,331,0.426,123,174,0.707,109,227,336,40,43,52,69,108,405
2409,6,1998,27,1,4,79,49,2325,268,608,0.441,0,0,-1,268,608,0.441,200,277,0.722,198,396,594,89,85,74,119,194,736
2409,7,1999,28,1,3,49,3,1040,141,264,0.534,0,0,-1,141,264,0.534,115,143,0.804,72,171,243,34,28,17,61,107,397
2409,8,2000,29,1,4,78,2,1615,215,419,0.513,0,0,-1,215,419,0.513,135,183,0.738,128,321,449,93,51,49,100,165,565
2409,9,2001,30,1,4,82,82,2774,347,692,0.501,0,0,-1,347,692,0.501,230,291,0.79,223,573,796,103,85,105,112,171,924
2409,10,2002,31,1,4,56,41,1728,189,452,0.418,0,0,-1,189,452,0.418,116,146,0.795,149,311,460,60,37,48,47,132,494
2409,11,2003,32,1,4,79,19,2024,186,414,0.449,0,0,-1,186,414,0.449,149,194,0.768,214,385,599,68,69,36,63,174,521
2409,12,2004,33,1,4,15,1,216,18,40,0.45,0,0,-1,18,40,0.45,18,19,0.947,14,36,50,13,8,2,9,19,54
2409,12,2004,33,1,4,37,0,652,86,171,0.503,0,1,0,86,170,0.506,35,53,0.66,60,94,154,17,22,13,26,56,207
2409,12,2004,33,1,4,52,1,868,104,211,0.493,0,1,0,104,210,0.495,53,72,0.736,74,130,204,30,30,15,35,75,261
2409,13,2005,34,1,4,40,18,525,47,114,0.412,0,0,-1,47,114,0.412,29,35,0.829,35,87,122,17,9,6,15,74,123
2410,1,1980,29,1,3,57,-1,1124,164,378,0.434,0,0,-1,164,378,0.434,63,91,0.692,83,125,208,54,34,17,86,136,391
2411,1,2009,22,1,2,56,19,1166,113,246,0.459,32,93,0.344,81,153,0.529,41,58,0.707,31,99,130,101,47,25,69,81,299
2411,2,2010,23,1,2,12,0,144,12,33,0.364,7,19,0.368,5,14,0.357,5,6,0.833,1,17,18,11,6,6,4,13,36
2418,1,1980,27,1,3,68,-1,2347,569,1112,0.512,7,22,0.318,562,1090,0.516,145,181,0.801,114,272,386,145,84,45,112,230,1290
2418,2,1981,28,1,3,81,-1,2902,685,1437,0.477,25,77,0.325,660,1360,0.485,140,204,0.686,128,305,433,226,97,46,161,294,1535
2418,3,1982,29,1,3,54,39,1638,260,589,0.441,5,23,0.217,255,566,0.451,66,90,0.733,128,176,304,133,73,14,73,189,591
2418,4,1983,30,1,3,40,0,503,94,205,0.459,1,10,0.1,93,195,0.477,20,30,0.667,29,45,74,31,20,6,32,83,209
2418,4,1983,30,1,3,35,35,1290,280,583,0.48,9,22,0.409,271,561,0.483,65,77,0.844,69,139,208,86,23,11,94,145,634
2418,4,1983,30,1,3,75,35,1793,374,788,0.475,10,32,0.313,364,756,0.481,85,107,0.794,98,184,282,117,43,17,126,228,843
2418,5,1984,31,1,3,68,5,916,148,333,0.444,2,13,0.154,146,320,0.456,29,35,0.829,41,98,139,67,27,7,43,107,327
2418,6,1985,32,1,3,78,5,1127,220,460,0.478,17,34,0.5,203,426,0.477,42,55,0.764,57,102,159,94,23,10,47,111,499
2418,7,1986,33,1,3,79,19,1402,286,605,0.473,17,48,0.354,269,557,0.483,45,68,0.662,66,126,192,83,38,22,54,127,634
2419,1,1994,20,1,5,76,76,2438,572,1037,0.552,0,14,0,572,1023,0.559,189,355,0.532,305,389,694,272,93,164,206,247,1333
2419,2,1995,21,1,4,54,52,2067,464,938,0.495,40,145,0.276,424,793,0.535,117,233,0.502,200,318,518,256,83,85,167,186,1085
2419,3,1996,22,1,4,15,15,558,150,276,0.543,15,34,0.441,135,242,0.558,41,69,0.594,37,77,114,75,27,9,49,51,356
2419,4,1997,23,1,4,72,72,2806,604,1167,0.518,60,151,0.397,544,1016,0.535,177,313,0.565,238,505,743,331,122,137,230,258,1445
2419,5,1998,24,1,5,71,71,2809,647,1341,0.482,65,205,0.317,582,1136,0.512,196,333,0.589,176,498,674,273,111,124,185,269,1555
2419,6,1999,25,1,4,42,42,1719,378,778,0.486,4,34,0.118,374,744,0.503,79,174,0.454,149,396,545,173,60,89,148,145,839
2419,7,2000,26,1,4,75,75,2880,748,1548,0.483,27,95,0.284,721,1453,0.496,311,414,0.751,189,598,787,345,120,128,218,264,1834
2419,8,2001,27,1,4,70,70,2836,786,1635,0.481,2,28,0.071,784,1607,0.488,324,461,0.703,179,598,777,294,93,118,195,226,1898
2419,9,2002,28,1,4,54,54,2071,532,1075,0.495,5,19,0.263,527,1056,0.499,253,338,0.749,150,396,546,258,90,76,158,181,1322
2419,10,2003,29,1,4,67,67,2622,661,1433,0.461,5,21,0.238,656,1412,0.465,215,354,0.607,160,544,704,364,106,88,215,204,1542
2419,11,2004,30,1,4,23,23,831,174,421,0.413,1,5,0.2,173,416,0.416,81,114,0.711,48,152,200,105,31,20,60,76,430
2419,12,2005,31,1,4,21,21,702,143,366,0.391,4,15,0.267,139,351,0.396,38,49,0.776,36,129,165,66,26,19,49,70,328
2419,12,2005,31,1,4,46,46,1668,412,917,0.449,11,29,0.379,401,888,0.452,143,179,0.799,94,353,447,252,68,34,133,144,978
2419,12,2005,31,1,4,67,67,2370,555,1283,0.433,15,44,0.341,540,1239,0.436,181,228,0.794,130,482,612,318,94,53,182,214,1306
2419,13,2006,32,1,4,75,75,2893,617,1422,0.434,21,77,0.273,596,1345,0.443,263,348,0.756,184,557,741,256,103,62,182,219,1518
2419,14,2007,33,1,4,18,18,544,89,230,0.387,2,5,0.4,87,225,0.387,18,28,0.643,37,112,149,61,18,15,33,36,198
2419,14,2007,33,1,4,43,42,1277,200,409,0.489,2,6,0.333,198,403,0.491,84,132,0.636,87,201,288,127,42,26,74,107,486
2419,14,2007,33,1,4,61,60,1821,289,639,0.452,4,11,0.364,285,628,0.454,102,160,0.638,124,313,437,188,60,41,107,143,684
2419,15,2008,34,1,4,9,8,126,15,31,0.484,0,0,-1,15,31,0.484,5,12,0.417,2,30,32,18,4,6,11,17,35
2420,1,2010,23,1,2,69,19,1368,236,458,0.515,2,15,0.133,234,443,0.528,44,64,0.688,42,150,192,101,39,25,65,126,518
2420,2,2011,24,1,3,59,28,1413,228,513,0.444,17,61,0.279,211,452,0.467,72,94,0.766,39,114,153,104,34,2,86,87,545
2423,1,1998,23,1,2,39,2,395,48,116,0.414,1,6,0.167,47,110,0.427,31,43,0.721,22,46,68,34,15,4,31,40,128
2426,1,1988,24,1,5,10,0,132,18,31,0.581,0,0,-1,18,31,0.581,12,18,0.667,11,13,24,5,5,5,9,25,48
2426,2,1989,25,1,5,72,0,843,99,222,0.446,0,1,0,99,221,0.448,48,73,0.658,59,134,193,29,23,41,42,176,246
2426,3,1990,26,1,5,14,2,142,16,38,0.421,0,0,-1,16,38,0.421,18,23,0.783,11,25,36,4,5,8,9,37,50
2426,3,1990,26,1,5,27,3,198,23,61,0.377,0,0,-1,23,61,0.377,19,25,0.76,18,30,48,9,6,8,15,58,65
2429,1,2000,23,1,3,66,0,1162,236,480,0.492,20,53,0.377,216,427,0.506,88,129,0.682,78,104,182,97,69,12,97,153,580
2429,2,2001,24,1,3,75,46,1995,387,726,0.533,17,50,0.34,370,676,0.547,159,240,0.663,120,247,367,208,94,20,169,203,950
2429,3,2002,25,1,2,74,69,2348,487,1039,0.469,66,172,0.384,421,867,0.486,215,290,0.741,121,323,444,204,113,25,191,208,1255
2429,4,2003,26,1,2,75,65,2396,437,990,0.441,38,130,0.292,399,860,0.464,226,313,0.722,98,296,394,246,123,18,215,220,1138
2429,5,2004,27,1,2,13,10,404,68,175,0.389,1,8,0.125,67,167,0.401,21,27,0.778,21,40,61,35,20,3,32,38,158
2429,5,2004,27,1,2,59,17,1468,295,675,0.437,21,61,0.344,274,614,0.446,117,156,0.75,57,142,199,104,71,16,129,159,728
2429,5,2004,27,1,2,72,27,1872,363,850,0.427,22,69,0.319,341,781,0.437,138,183,0.754,78,182,260,139,91,19,161,197,886
2429,6,2005,28,1,2,69,19,1489,272,617,0.441,36,104,0.346,236,513,0.46,141,188,0.75,49,180,229,80,85,27,90,165,721
2429,7,2006,29,1,2,52,41,1684,284,613,0.463,10,45,0.222,274,568,0.482,129,190,0.679,142,259,401,144,94,25,126,156,707
2429,8,2007,30,1,3,28,1,590,85,207,0.411,1,7,0.143,84,200,0.42,46,82,0.561,26,94,120,31,24,13,57,62,217
2429,9,2008,31,1,2,22,0,438,77,157,0.49,4,12,0.333,73,145,0.503,35,53,0.66,21,50,71,17,24,8,27,44,193
2429,9,2008,31,1,2,51,7,1124,175,412,0.425,8,38,0.211,167,374,0.447,111,174,0.638,63,197,260,80,51,24,76,113,469
2429,9,2008,31,1,2,73,7,1562,252,569,0.443,12,50,0.24,240,519,0.462,146,227,0.643,84,247,331,97,75,32,103,157,662
2430,1,2003,23,1,3,37,0,234,19,75,0.253,1,4,0.25,18,71,0.254,22,29,0.759,12,16,28,27,8,2,19,32,61
2430,2,2004,24,1,2,81,68,2179,262,612,0.428,69,181,0.381,193,431,0.448,153,206,0.743,60,236,296,183,101,7,129,176,746
2430,3,2005,25,1,3,16,0,192,12,51,0.235,2,11,0.182,10,40,0.25,20,28,0.714,6,22,28,19,5,0,15,16,46
2430,3,2005,25,1,2,55,32,1125,137,320,0.428,32,99,0.323,105,221,0.475,109,141,0.773,20,119,139,84,39,5,58,105,415
2430,3,2005,25,1,2,71,32,1317,149,371,0.402,34,110,0.309,115,261,0.441,129,169,0.763,26,141,167,103,44,5,73,121,461
2430,4,2006,26,1,3,58,2,866,86,222,0.387,14,49,0.286,72,173,0.416,65,87,0.747,22,89,111,62,34,1,41,65,251
2433,1,1994,23,1,1,60,0,542,64,174,0.368,11,47,0.234,53,127,0.417,44,53,0.83,10,34,44,123,38,4,52,47,183
2433,2,1995,24,1,1,51,36,1380,128,313,0.409,51,119,0.429,77,194,0.397,71,94,0.755,31,86,117,266,82,9,87,144,378
2433,3,1996,25,1,1,82,53,2104,338,736,0.459,116,272,0.426,222,464,0.478,217,288,0.753,68,196,264,390,100,11,159,207,1009
2433,4,1997,26,1,1,74,73,2991,456,974,0.468,103,286,0.36,353,688,0.513,225,288,0.781,67,197,264,537,162,13,211,221,1240
2433,5,1998,27,1,1,81,81,2845,383,864,0.443,59,170,0.347,324,694,0.467,229,288,0.795,49,164,213,529,140,30,226,229,1054
2433,6,1999,28,1,1,50,50,1848,243,545,0.446,61,170,0.359,182,375,0.485,159,191,0.832,23,138,161,322,100,10,142,130,706
2433,7,2000,29,1,1,82,82,2760,407,955,0.426,88,248,0.355,319,707,0.451,214,275,0.778,39,186,225,463,109,11,159,186,1116
2433,8,2001,30,1,2,82,82,3106,523,1239,0.422,97,258,0.376,426,981,0.434,271,339,0.799,64,160,224,361,128,16,171,220,1414
2433,9,2002,31,1,2,67,63,2487,364,910,0.4,85,256,0.332,279,654,0.427,138,188,0.734,44,99,143,236,74,15,119,147,951
2433,10,2003,32,1,2,73,73,2710,449,1037,0.433,134,316,0.424,315,721,0.437,185,237,0.781,38,137,175,251,109,9,132,173,1217
2433,11,2004,33,1,2,61,60,2001,311,800,0.389,92,285,0.323,219,515,0.425,137,182,0.753,28,106,134,175,71,14,100,147,851
2433,12,2005,34,1,2,26,26,934,133,342,0.389,28,80,0.35,105,262,0.401,67,76,0.882,12,73,85,109,35,1,54,65,361
2433,12,2005,34,1,2,54,53,1840,201,498,0.404,90,235,0.383,111,263,0.422,95,113,0.841,26,117,143,156,61,8,59,150,587
2433,12,2005,34,1,2,80,79,2774,334,840,0.398,118,315,0.375,216,525,0.411,162,189,0.857,38,190,228,265,96,9,113,215,948
2433,13,2006,35,1,2,71,59,2372,226,561,0.403,99,271,0.365,127,290,0.438,151,187,0.807,24,154,178,204,59,6,120,212,702
2433,14,2007,36,1,2,35,5,352,22,75,0.293,9,38,0.237,13,37,0.351,20,28,0.714,3,32,35,37,12,4,17,32,73
2435,1,2005,21,1,2,39,7,507,66,155,0.426,24,67,0.358,42,88,0.477,19,27,0.704,14,51,65,53,21,8,24,69,175
2435,2,2006,22,1,1,71,71,2418,333,684,0.487,84,218,0.385,249,466,0.534,86,101,0.851,57,232,289,329,84,46,133,197,836
2435,3,2007,23,1,2,69,47,2219,306,717,0.427,65,178,0.365,241,539,0.447,168,197,0.853,32,176,208,304,74,34,140,152,845
2435,4,2008,24,1,1,35,5,727,97,250,0.388,19,56,0.339,78,194,0.402,26,39,0.667,13,83,96,113,30,10,66,44,239
2435,4,2008,24,1,1,26,26,806,99,225,0.44,29,79,0.367,70,146,0.479,41,52,0.788,18,79,97,116,29,19,51,59,268
2435,4,2008,24,1,1,61,31,1533,196,475,0.413,48,135,0.356,148,340,0.435,67,91,0.736,31,162,193,229,59,29,117,103,507
2435,5,2009,25,1,2,64,64,2152,285,624,0.457,91,228,0.399,194,396,0.49,90,108,0.833,31,172,203,226,94,13,92,125,751
2435,6,2010,26,1,2,60,3,1500,194,436,0.445,25,77,0.325,169,359,0.471,115,142,0.81,29,140,169,196,55,28,90,86,528
2435,7,2011,27,1,1,24,2,453,55,120,0.458,12,33,0.364,43,87,0.494,13,15,0.867,6,31,37,64,20,10,30,29,135
2435,8,2012,28,1,1,44,33,1060,166,360,0.461,27,76,0.355,139,284,0.489,62,70,0.886,13,88,101,139,58,11,76,67,421
2436,1,1990,22,1,2,52,0,378,53,135,0.393,3,11,0.273,50,124,0.403,26,32,0.813,24,46,70,18,10,6,31,61,135
2436,2,1991,23,1,2,75,1,824,118,246,0.48,0,1,0,118,245,0.482,58,84,0.69,56,80,136,48,35,23,41,115,294
2436,3,1992,24,1,2,80,72,2540,463,894,0.518,4,23,0.174,459,871,0.527,186,231,0.805,107,150,257,281,66,26,120,239,1116
2436,4,1993,25,1,2,80,80,3104,646,1249,0.517,2,23,0.087,644,1226,0.525,249,296,0.841,89,158,247,235,85,21,165,279,1543
2436,5,1994,26,1,2,72,61,2182,434,891,0.487,1,8,0.125,433,883,0.49,187,231,0.81,61,170,231,172,65,24,137,236,1056
2436,6,1995,27,1,2,71,65,2328,351,762,0.461,11,61,0.18,340,701,0.485,206,246,0.837,60,167,227,185,65,24,126,250,919
2436,7,1996,28,1,2,73,16,1639,175,393,0.445,1,13,0.077,174,380,0.458,114,144,0.792,48,113,161,119,30,17,81,228,465
2436,8,1997,29,1,2,68,66,1920,226,484,0.467,15,45,0.333,211,439,0.481,64,94,0.681,37,111,148,113,61,24,66,218,531
2436,9,1998,30,1,2,38,10,688,64,171,0.374,0,2,0,64,169,0.379,29,40,0.725,23,59,82,45,11,5,21,97,157
2436,10,1999,31,1,2,14,2,294,31,65,0.477,0,2,0,31,63,0.492,19,25,0.76,5,20,25,19,16,7,12,38,81
2436,11,2000,32,1,2,38,0,581,59,145,0.407,0,3,0,59,142,0.415,34,40,0.85,18,53,71,43,12,8,19,80,152
2436,12,2001,33,1,2,15,6,171,11,38,0.289,0,2,0,11,36,0.306,6,7,0.857,4,11,15,14,3,4,4,21,28
2438,1,2008,23,1,2,64,2,269,21,49,0.429,0,4,0,21,45,0.467,17,26,0.654,26,22,48,13,12,4,9,61,59
2438,2,2009,24,1,2,53,3,269,14,34,0.412,1,1,1,13,33,0.394,14,30,0.467,24,32,56,19,18,4,13,35,43
2438,3,2010,25,1,2,39,1,142,12,21,0.571,0,1,0,12,20,0.6,6,10,0.6,8,19,27,9,8,0,7,25,30
2438,4,2011,26,1,2,6,3,116,9,21,0.429,1,4,0.25,8,17,0.471,3,5,0.6,2,9,11,10,7,0,2,13,22
2439,1,1984,23,1,5,34,0,202,15,42,0.357,0,0,-1,15,42,0.357,7,22,0.318,19,27,46,13,1,15,12,55,37
2439,2,1985,24,1,5,65,25,882,106,193,0.549,0,1,0,106,192,0.552,41,85,0.482,89,161,250,15,13,48,57,193,253
2439,2,1985,24,1,5,66,25,888,106,194,0.546,0,1,0,106,193,0.549,43,87,0.494,90,161,251,15,13,49,59,197,255
2439,3,1986,25,1,5,67,26,1172,113,209,0.541,0,0,-1,113,209,0.541,54,103,0.524,97,225,322,20,27,62,91,235,280
2439,4,1987,26,1,5,78,13,1333,209,385,0.543,0,2,0,209,383,0.546,89,173,0.514,126,213,339,41,22,81,106,229,507
2439,5,1988,27,1,5,29,29,915,134,257,0.521,0,1,0,134,256,0.523,75,132,0.568,82,160,242,24,22,68,82,107,343
2439,5,1988,27,1,5,54,12,1183,182,316,0.576,0,0,-1,182,316,0.576,95,153,0.621,83,198,281,50,25,79,91,158,459
2439,5,1988,27,1,5,83,41,2098,316,573,0.551,0,1,0,316,572,0.552,170,285,0.596,165,358,523,74,47,147,173,265,802
2439,6,1989,28,1,5,82,32,2019,243,372,0.653,0,0,-1,243,372,0.653,108,202,0.535,167,384,551,39,35,187,103,273,594
2439,7,1990,29,1,5,82,79,2399,331,530,0.625,0,0,-1,331,530,0.625,199,288,0.691,212,516,728,45,36,184,126,277,861
2439,8,1991,30,1,5,82,64,1957,247,382,0.647,0,0,-1,247,382,0.647,135,206,0.655,171,393,564,37,32,161,86,266,629
2439,9,1992,31,1,5,82,11,1436,196,310,0.632,0,0,-1,196,310,0.632,109,171,0.637,134,238,372,22,14,81,82,239,501
2439,10,1993,32,1,5,82,82,1558,175,285,0.614,0,0,-1,175,285,0.614,86,166,0.518,153,305,458,29,16,103,93,243,436
2439,11,1994,33,1,5,82,50,1236,162,286,0.566,0,0,-1,162,286,0.566,58,116,0.5,112,183,295,33,31,109,74,214,382
2439,12,1995,34,1,5,67,58,1543,217,390,0.556,0,0,-1,217,390,0.556,66,138,0.478,160,248,408,18,27,102,85,247,500
2439,13,1996,35,1,5,47,21,682,61,126,0.484,0,0,-1,61,126,0.484,28,45,0.622,49,84,133,6,6,37,35,135,150
2439,14,1997,36,1,5,70,43,959,100,180,0.556,0,0,-1,100,180,0.556,27,56,0.482,69,117,186,19,11,55,52,142,227
2439,15,1998,37,1,5,15,1,105,10,21,0.476,0,0,-1,10,21,0.476,3,6,0.5,6,9,15,2,2,4,8,15,23
2439,16,1999,38,1,5,49,0,499,22,59,0.373,0,0,-1,22,59,0.373,16,45,0.356,49,76,125,13,4,22,17,81,60
2439,17,2000,39,1,5,22,2,127,5,12,0.417,0,0,-1,5,12,0.417,5,8,0.625,6,25,31,2,2,4,6,23,15
2442,1,2006,23,1,5,23,0,212,23,57,0.404,0,0,-1,23,57,0.404,3,6,0.5,16,27,43,17,7,8,14,41,49
2443,1,1988,28,1,1,59,0,513,62,132,0.47,0,0,-1,62,132,0.47,25,34,0.735,19,21,40,103,36,2,52,37,149
2443,2,1989,29,1,1,8,0,143,24,42,0.571,0,0,-1,24,42,0.571,8,10,0.8,5,7,12,21,8,0,6,9,56
2443,2,1989,29,1,1,20,0,211,21,45,0.467,0,1,0,21,44,0.477,7,10,0.7,12,7,19,33,19,0,18,17,49
2443,2,1989,29,1,1,28,0,354,45,87,0.517,0,1,0,45,86,0.523,15,20,0.75,17,14,31,54,27,0,24,26,105
2445,1,1998,24,1,1,34,0,150,20,50,0.4,8,17,0.471,12,33,0.364,9,15,0.6,3,8,11,25,6,1,9,12,57
2445,2,1999,25,1,1,46,0,590,73,193,0.378,22,60,0.367,51,133,0.383,40,55,0.727,11,34,45,102,26,2,48,59,208
2446,1,1988,22,1,3,17,4,352,66,124,0.532,1,1,1,65,123,0.528,45,57,0.789,31,31,62,9,7,3,21,32,178
2446,2,1989,23,1,3,37,0,434,62,119,0.521,0,0,-1,62,119,0.521,34,42,0.81,34,36,70,17,10,1,26,39,158
2446,2,1989,23,1,3,38,0,436,62,120,0.517,0,0,-1,62,120,0.517,34,42,0.81,34,36,70,17,10,1,26,40,158
2448,1,1980,29,1,2,82,-1,2665,692,1317,0.525,26,93,0.28,666,1224,0.544,382,443,0.862,46,141,187,416,119,35,207,162,1792
2448,2,1981,30,1,2,36,-1,1078,221,500,0.442,6,25,0.24,215,475,0.453,153,184,0.832,11,57,68,148,46,14,78,70,601
2448,3,1982,31,1,2,18,12,451,86,194,0.443,2,8,0.25,84,186,0.452,36,47,0.766,9,13,22,100,19,8,47,61,210
2448,4,1983,32,1,2,80,59,1978,318,693,0.459,14,48,0.292,304,645,0.471,148,184,0.804,19,96,115,439,87,16,196,180,798
2448,5,1984,33,1,2,59,2,865,144,313,0.46,7,26,0.269,137,287,0.477,117,142,0.824,8,35,43,148,41,6,77,69,412
2450,1,1999,22,1,4,20,0,191,17,32,0.531,0,0,-1,17,32,0.531,15,35,0.429,23,35,58,1,3,11,16,39,49
2450,2,2000,23,1,5,80,59,1537,228,450,0.507,0,0,-1,228,450,0.507,113,211,0.536,202,351,553,15,31,83,94,234,569
2450,3,2001,24,1,5,68,56,1609,203,408,0.498,0,1,0,203,407,0.499,177,312,0.567,178,343,521,20,32,111,136,211,583
2450,4,2002,25,1,5,71,69,1346,150,279,0.538,0,0,-1,150,279,0.538,83,154,0.539,159,285,444,17,25,75,65,163,383
2450,5,2003,26,1,5,16,8,230,25,53,0.472,0,0,-1,25,53,0.472,17,25,0.68,37,36,73,2,1,12,9,33,67
2450,6,2004,27,1,5,61,17,861,99,189,0.524,0,0,-1,99,189,0.524,63,126,0.5,97,164,261,7,25,50,65,176,261
2450,6,2004,27,1,5,62,17,865,99,190,0.521,0,0,-1,99,190,0.521,63,126,0.5,97,164,261,7,25,51,66,176,261
2450,7,2005,28,1,5,17,0,135,14,31,0.452,0,0,-1,14,31,0.452,14,40,0.35,11,23,34,1,2,12,11,31,42
2451,1,1980,33,1,1,78,-1,2052,336,706,0.476,1,6,0.167,335,700,0.479,97,114,0.851,42,139,181,239,88,13,157,186,770
2451,2,1981,34,1,1,13,-1,236,36,82,0.439,0,0,-1,36,82,0.439,11,18,0.611,3,18,21,37,11,1,18,21,83
2452,1,1990,22,1,4,55,2,707,93,252,0.369,1,14,0.071,92,238,0.387,50,89,0.562,78,95,173,21,24,6,47,124,237
2452,2,1991,23,1,4,79,29,1901,265,665,0.398,6,37,0.162,259,628,0.412,159,225,0.707,173,331,504,63,81,44,131,308,695
2452,3,1992,24,1,4,65,12,1021,145,382,0.38,4,27,0.148,141,355,0.397,124,162,0.765,96,140,236,31,31,22,68,157,418
2452,4,1993,25,1,4,64,20,1433,235,540,0.435,10,42,0.238,225,498,0.452,138,184,0.75,154,216,370,49,63,45,108,226,618
2452,5,1994,26,1,4,18,3,320,45,112,0.402,6,20,0.3,39,92,0.424,19,33,0.576,30,53,83,11,10,10,18,46,115
2453,1,2002,21,1,3,16,0,129,21,60,0.35,2,9,0.222,19,51,0.373,12,14,0.857,2,16,18,12,9,2,14,6,56
2453,2,2003,22,1,2,72,19,1563,260,638,0.408,32,134,0.239,228,504,0.452,98,125,0.784,43,170,213,121,45,32,156,134,650
2453,3,2004,23,1,3,72,0,985,215,468,0.459,33,87,0.379,182,381,0.478,78,104,0.75,44,121,165,60,32,20,78,105,541
2453,4,2005,24,1,3,16,0,146,23,62,0.371,5,16,0.313,18,46,0.391,6,10,0.6,4,11,15,8,2,1,10,13,57
2453,4,2005,24,1,3,42,2,531,98,227,0.432,19,44,0.432,79,183,0.432,21,34,0.618,20,54,74,36,30,10,27,51,236
2453,4,2005,24,1,3,58,2,677,121,289,0.419,24,60,0.4,97,229,0.424,27,44,0.614,24,65,89,44,32,11,37,64,293
2454,1,1983,23,1,3,65,0,626,127,234,0.543,0,1,0,127,233,0.545,70,109,0.642,47,58,105,30,16,2,51,54,324
2454,2,1984,24,1,3,22,2,308,69,144,0.479,0,0,-1,69,144,0.479,24,42,0.571,30,32,62,14,13,2,18,25,162
2454,2,1984,24,1,3,36,2,372,80,170,0.471,0,0,-1,80,170,0.471,26,47,0.553,37,37,74,15,15,3,24,31,186
2454,3,1985,25,1,4,80,14,1106,144,279,0.516,0,0,-1,144,279,0.516,90,130,0.692,94,101,195,34,35,20,87,115,378
2454,4,1986,26,1,3,75,30,1761,355,684,0.519,1,9,0.111,354,675,0.524,164,222,0.739,82,99,181,74,74,8,95,161,875
2454,5,1987,27,1,3,68,35,1545,265,552,0.48,0,3,0,265,549,0.483,94,144,0.653,90,104,194,79,47,19,73,159,624
2455,1,1988,22,1,1,12,0,117,17,46,0.37,0,1,0,17,45,0.378,9,13,0.692,1,2,3,10,1,0,13,14,43
2455,1,1988,22,1,1,35,0,462,94,203,0.463,0,5,0,94,198,0.475,30,41,0.732,11,17,28,49,19,2,34,43,218
2455,1,1988,22,1,1,49,0,581,111,249,0.446,0,6,0,111,243,0.457,39,54,0.722,12,19,31,59,20,2,47,57,261
2456,1,1985,22,1,2,39,0,234,52,124,0.419,4,11,0.364,48,113,0.425,21,31,0.677,15,21,36,29,5,2,30,24,129
2456,2,1986,23,1,2,43,4,343,74,168,0.44,6,21,0.286,68,147,0.463,19,23,0.826,17,27,44,53,18,2,25,24,173
2457,1,1980,23,1,5,18,-1,225,27,45,0.6,0,0,-1,27,45,0.6,5,18,0.278,29,41,70,6,1,6,8,32,59
2457,1,1980,23,1,5,32,-1,328,31,69,0.449,0,0,-1,31,69,0.449,5,17,0.294,27,70,97,18,7,11,28,65,67
2457,1,1980,23,1,5,50,-1,553,58,114,0.509,0,0,-1,58,114,0.509,10,35,0.286,56,111,167,24,8,17,36,97,126
2457,2,1981,24,1,5,7,-1,118,16,38,0.421,0,0,-1,16,38,0.421,5,11,0.455,8,20,28,2,4,1,11,16,37
2457,2,1981,24,1,5,38,-1,562,66,139,0.475,0,1,0,66,138,0.478,23,45,0.511,48,135,183,24,15,8,45,100,155
2457,2,1981,24,1,5,48,-1,688,83,180,0.461,0,1,0,83,179,0.464,28,56,0.5,58,156,214,26,20,9,56,122,194
2457,3,1982,25,1,5,72,63,2214,406,726,0.559,0,0,-1,406,726,0.559,184,241,0.763,231,433,664,102,48,44,141,290,996
2457,4,1983,26,1,5,46,23,905,164,306,0.536,0,0,-1,164,306,0.536,72,87,0.828,105,156,261,42,21,15,65,139,400
2457,5,1984,27,1,5,70,1,921,144,294,0.49,0,0,-1,144,294,0.49,88,107,0.822,94,151,245,19,17,12,59,159,376
2457,6,1985,28,1,5,79,78,2536,421,825,0.51,0,0,-1,421,825,0.51,184,235,0.783,219,403,622,53,45,43,141,322,1026
2457,7,1986,29,1,5,81,3,1079,126,294,0.429,0,0,-1,126,294,0.429,60,97,0.619,94,234,328,19,18,19,64,176,312
2457,8,1987,30,1,5,73,1,937,147,327,0.45,0,1,0,147,326,0.451,79,113,0.699,110,152,262,24,16,12,50,175,373
2457,9,1988,31,1,5,72,27,1221,174,360,0.483,0,0,-1,174,360,0.483,59,82,0.72,109,212,321,39,32,21,49,209,407
2457,10,1989,32,1,5,52,4,580,69,176,0.392,0,0,-1,69,176,0.392,30,45,0.667,49,80,129,17,22,4,22,107,168
2457,10,1989,32,1,5,57,4,622,72,182,0.396,0,0,-1,72,182,0.396,31,47,0.66,49,85,134,19,23,4,24,115,175
2459,1,1997,27,1,1,27,1,259,18,55,0.327,12,36,0.333,6,19,0.316,11,15,0.733,2,10,12,36,11,0,17,23,59
2460,1,1981,23,1,2,47,-1,782,149,306,0.487,2,6,0.333,147,300,0.49,50,65,0.769,29,77,106,68,47,6,48,98,350
2460,2,1982,24,1,2,23,4,266,25,71,0.352,0,1,0,25,70,0.357,4,7,0.571,13,27,40,19,12,1,14,31,54
2461,1,1980,30,1,4,71,-1,2146,210,496,0.423,0,1,0,210,495,0.424,83,152,0.546,138,271,409,213,76,52,167,241,503
2461,2,1981,31,1,4,49,-1,1083,125,286,0.437,0,1,0,125,285,0.439,76,150,0.507,79,144,223,111,40,40,94,168,326
2462,1,2012,22,1,5,18,0,109,12,27,0.444,0,0,-1,12,27,0.444,5,12,0.417,16,23,39,0,3,15,5,12,29
2463,1,1996,23,1,4,8,1,122,13,30,0.433,0,0,-1,13,30,0.433,14,22,0.636,9,16,25,2,3,2,8,14,40
2464,1,1994,22,1,1,40,4,339,25,82,0.305,10,30,0.333,15,52,0.288,12,15,0.8,5,24,29,53,11,1,37,53,72
2464,2,1995,23,1,1,25,0,179,14,47,0.298,3,19,0.158,11,28,0.393,11,11,1,4,9,13,28,4,0,18,34,42
2464,3,1996,24,1,1,21,0,335,45,99,0.455,19,44,0.432,26,55,0.473,41,44,0.932,2,31,33,51,18,1,23,46,150
2464,4,1997,25,1,1,82,1,1117,139,330,0.421,58,163,0.356,81,167,0.485,94,113,0.832,13,91,104,182,49,4,68,100,430
2464,5,1998,26,1,1,82,6,1073,126,355,0.355,52,169,0.308,74,186,0.398,118,129,0.915,16,99,115,196,34,6,65,106,422
2464,6,1999,27,1,1,39,1,441,64,156,0.41,32,95,0.337,32,61,0.525,27,31,0.871,8,39,47,69,18,2,36,49,187
2464,7,2000,28,1,1,82,15,1627,217,521,0.417,96,255,0.376,121,266,0.455,112,132,0.848,20,114,134,313,55,5,107,166,642
2464,8,2001,29,1,1,59,31,1532,182,470,0.387,93,248,0.375,89,222,0.401,101,113,0.894,12,94,106,248,55,3,103,150,558
2464,9,2002,30,1,1,82,81,2171,274,656,0.418,131,323,0.406,143,333,0.429,154,175,0.88,11,141,152,314,72,6,85,182,833
2464,10,2003,31,1,1,22,1,290,30,88,0.341,7,36,0.194,23,52,0.442,11,12,0.917,2,19,21,21,12,1,16,15,78
2464,10,2003,31,1,1,29,20,762,94,261,0.36,43,128,0.336,51,133,0.383,46,57,0.807,1,45,46,124,17,1,55,77,277
2464,10,2003,31,1,1,51,21,1052,124,349,0.355,50,164,0.305,74,185,0.4,57,69,0.826,3,64,67,145,29,2,71,92,355
2464,11,2004,32,1,1,16,5,186,17,45,0.378,8,18,0.444,9,27,0.333,5,5,1,3,12,15,14,6,2,6,6,47
2470,1,1981,23,1,4,33,-1,271,76,138,0.551,0,2,0,76,136,0.559,36,48,0.75,22,42,64,11,8,6,28,38,188
2470,2,1982,24,1,4,61,1,1013,203,359,0.565,0,5,0,203,354,0.573,98,141,0.695,67,115,182,52,40,16,71,127,504
2473,1,1989,22,1,1,51,1,408,46,114,0.404,6,24,0.25,40,90,0.444,13,16,0.813,13,34,47,76,25,6,34,61,111
2473,2,1990,23,1,1,40,2,638,92,208,0.442,17,46,0.37,75,162,0.463,28,38,0.737,13,39,52,114,45,3,63,65,229
2473,3,1991,24,1,1,34,0,350,45,108,0.417,6,12,0.5,39,96,0.406,17,25,0.68,4,13,17,73,24,0,34,37,113
2473,4,1992,25,1,1,41,19,767,71,160,0.444,14,38,0.368,57,122,0.467,21,30,0.7,22,51,73,166,43,3,52,73,177
2473,4,1992,25,1,1,53,19,870,83,193,0.43,14,42,0.333,69,151,0.457,24,35,0.686,24,57,81,180,47,3,60,89,204
2473,5,1993,26,1,1,25,2,354,26,81,0.321,15,51,0.294,11,30,0.367,5,8,0.625,9,26,35,81,26,2,29,49,72
2473,5,1993,26,1,1,33,13,641,70,173,0.405,39,103,0.379,31,70,0.443,12,18,0.667,20,36,56,100,39,1,51,78,191
2473,5,1993,26,1,1,58,15,995,96,254,0.378,54,154,0.351,42,100,0.42,17,26,0.654,29,62,91,181,65,3,80,127,263
2473,6,1994,27,1,1,12,0,124,6,21,0.286,2,6,0.333,4,15,0.267,0,0,-1,0,6,6,16,13,0,11,17,14
2473,6,1994,27,1,1,16,0,158,9,29,0.31,3,10,0.3,6,19,0.316,0,0,-1,0,10,10,23,15,0,17,21,21
2473,7,1995,28,1,1,38,2,407,47,111,0.423,29,75,0.387,18,36,0.5,7,10,0.7,6,33,39,69,21,1,19,44,130
2473,7,1995,28,1,1,43,2,424,50,117,0.427,30,79,0.38,20,38,0.526,7,10,0.7,6,37,43,75,22,2,23,44,137
2474,1,1980,25,1,3,75,-1,2381,430,1030,0.417,7,34,0.206,423,996,0.425,166,222,0.748,85,231,316,243,93,27,193,194,1033
2474,2,1981,26,1,2,80,-1,2238,330,715,0.462,1,10,0.1,329,705,0.467,137,163,0.84,86,196,282,272,102,23,175,170,798
2474,3,1982,27,1,3,65,38,1805,284,679,0.418,3,18,0.167,281,661,0.425,145,185,0.784,60,190,250,237,92,25,138,188,716
2474,4,1983,28,1,3,77,11,1702,213,511,0.417,0,4,0,213,507,0.42,93,124,0.75,62,180,242,189,68,16,160,157,519
2475,1,1980,26,1,3,82,-1,3111,726,1358,0.535,3,17,0.176,723,1341,0.539,189,234,0.808,176,349,525,250,129,28,157,220,1644
2475,2,1981,27,1,3,81,-1,3028,786,1495,0.526,1,13,0.077,785,1482,0.53,254,335,0.758,146,289,435,235,121,29,207,223,1827
2475,3,1982,28,1,3,82,82,2906,744,1417,0.525,0,4,0,744,1413,0.527,246,336,0.732,153,240,393,143,89,24,164,240,1734
2475,4,1983,29,1,3,80,80,2552,684,1290,0.53,0,6,0,684,1284,0.533,203,268,0.757,146,197,343,182,65,17,150,221,1571
2475,5,1984,30,1,3,75,74,2507,542,1055,0.514,2,8,0.25,540,1047,0.516,208,280,0.743,130,210,340,214,72,41,137,205,1294
2475,6,1985,31,1,3,42,8,761,148,303,0.488,0,1,0,148,302,0.49,51,66,0.773,35,59,94,41,19,3,49,65,347
2475,7,1986,32,1,3,13,1,195,26,65,0.4,1,3,0.333,25,62,0.403,22,27,0.815,13,16,29,15,7,2,16,19,75
2476,1,1981,22,1,3,48,-1,540,85,184,0.462,0,1,0,85,183,0.464,29,42,0.69,36,60,96,30,25,12,34,86,199
2476,2,1982,23,1,3,57,22,862,128,266,0.481,0,1,0,128,265,0.483,58,80,0.725,62,97,159,64,30,18,62,112,314
2476,3,1983,24,1,3,9,0,129,11,34,0.324,0,1,0,11,33,0.333,12,15,0.8,9,10,19,10,3,1,5,22,34
2477,1,1981,25,1,5,56,-1,1058,117,260,0.45,0,0,-1,117,260,0.45,27,40,0.675,62,212,274,40,32,46,59,169,261
2477,2,1982,26,1,5,82,62,2274,314,718,0.437,0,3,0,314,715,0.439,137,176,0.778,120,491,611,90,32,77,134,248,765
2477,3,1983,27,1,5,81,34,2307,389,816,0.477,0,3,0,389,813,0.478,156,200,0.78,154,442,596,132,41,42,186,251,934
2477,4,1984,28,1,5,81,1,1734,249,520,0.479,0,3,0,249,517,0.482,134,182,0.736,109,346,455,73,27,42,109,205,632
2477,5,1985,29,1,5,79,0,1505,285,582,0.49,0,1,0,285,581,0.491,61,80,0.763,78,288,366,81,35,18,91,173,631
2477,6,1986,30,1,5,27,4,522,51,134,0.381,0,0,-1,51,134,0.381,28,46,0.609,34,93,127,18,8,10,20,71,130
2477,6,1986,30,1,5,48,0,604,96,240,0.4,0,0,-1,96,240,0.4,30,47,0.638,40,105,145,28,3,11,32,86,222
2477,6,1986,30,1,5,75,4,1126,147,374,0.393,0,0,-1,147,374,0.393,58,93,0.624,74,198,272,46,11,21,52,157,352
2483,1,1982,21,1,4,82,82,2825,513,881,0.582,0,1,0,513,880,0.583,242,388,0.624,347,658,1005,107,84,84,235,285,1268
2483,2,1983,22,1,4,82,82,2961,536,912,0.588,0,4,0,536,908,0.59,324,523,0.62,365,662,1027,125,91,110,246,270,1396
2483,3,1984,23,1,4,81,81,3003,495,926,0.535,0,4,0,495,922,0.537,284,498,0.57,355,645,1000,130,81,125,237,298,1274
2483,4,1985,24,1,4,82,82,3182,577,1089,0.53,1,4,0.25,576,1085,0.531,336,538,0.625,323,682,1005,167,63,110,238,293,1491
2483,5,1986,25,1,4,82,82,3070,500,956,0.523,0,2,0,500,954,0.524,301,445,0.676,329,657,986,131,73,96,244,294,1301
2483,6,1987,26,1,4,82,82,2976,521,936,0.557,0,1,0,521,935,0.557,430,588,0.731,322,701,1023,129,78,91,280,315,1472
2483,7,1988,27,1,4,70,70,2637,466,832,0.56,1,1,1,465,831,0.56,346,518,0.668,298,536,834,109,68,44,189,266,1279
2483,8,1989,28,1,4,74,72,2446,373,702,0.531,0,3,0,373,699,0.534,213,320,0.666,249,447,696,78,61,36,142,223,959
2483,9,1990,29,1,4,82,82,2801,413,754,0.548,0,1,0,413,753,0.548,288,408,0.706,250,550,800,116,69,39,168,285,1114
2483,10,1991,30,1,4,80,80,2582,358,595,0.602,0,0,-1,358,595,0.602,217,308,0.705,227,524,751,97,47,47,137,247,933
2483,11,1992,31,1,4,80,80,2519,340,563,0.604,0,1,0,340,562,0.605,221,293,0.754,260,444,704,108,62,41,130,244,901
2483,12,1993,32,1,4,82,82,2498,270,528,0.511,0,1,0,270,527,0.512,138,214,0.645,232,458,690,75,81,61,101,270,678
2483,13,1994,33,1,4,81,81,2636,291,524,0.555,0,1,0,291,523,0.556,201,296,0.679,315,528,843,80,58,47,111,239,783
2483,14,1995,34,1,4,82,82,2422,309,604,0.512,1,2,0.5,308,602,0.512,138,205,0.673,251,418,669,78,67,69,119,254,757
2483,15,1996,35,1,4,70,10,1672,192,384,0.5,2,3,0.667,190,381,0.499,125,187,0.668,159,245,404,42,40,47,90,187,511
2483,16,1997,36,1,4,74,4,1496,175,326,0.537,0,1,0,175,325,0.538,115,179,0.642,166,231,397,53,40,38,79,204,465
2483,17,1998,37,1,4,41,6,738,75,149,0.503,0,0,-1,75,149,0.503,52,71,0.732,78,105,183,21,17,15,38,93,202
2488,1,1993,22,1,1,35,0,242,31,85,0.365,1,3,0.333,30,82,0.366,18,22,0.818,19,12,31,23,4,2,11,24,81
2489,1,1980,23,1,1,77,-1,1794,232,519,0.447,0,12,0,232,507,0.458,42,60,0.7,21,85,106,183,100,11,107,166,506
2492,1,2003,22,1,1,21,0,167,9,33,0.273,6,16,0.375,3,17,0.176,4,6,0.667,3,15,18,34,7,2,17,20,28
2492,2,2004,23,1,1,56,3,714,80,208,0.385,18,60,0.3,62,148,0.419,41,48,0.854,8,45,53,121,25,6,63,58,219
2493,1,1996,23,1,3,64,6,1470,241,546,0.441,3,10,0.3,238,536,0.444,200,298,0.671,92,125,217,70,56,11,88,147,685
2493,2,1997,24,1,2,72,67,2435,374,820,0.456,2,8,0.25,372,812,0.458,328,436,0.752,126,203,329,129,72,13,139,213,1078
2493,3,1998,25,1,3,4,4,145,24,61,0.393,0,0,-1,24,61,0.393,31,45,0.689,10,11,21,12,4,0,9,9,79
2493,4,1999,26,1,3,38,8,780,80,219,0.365,6,26,0.231,74,193,0.383,111,139,0.799,34,47,81,37,27,8,49,76,277
2493,5,2000,27,1,3,68,17,1378,165,386,0.427,25,72,0.347,140,314,0.446,134,169,0.793,55,101,156,93,44,16,66,165,489
2493,6,2001,28,1,3,81,11,1745,162,448,0.362,46,139,0.331,116,309,0.375,165,231,0.714,64,143,207,112,64,13,76,179,535
2493,7,2002,29,1,3,74,30,1747,144,385,0.374,24,86,0.279,120,299,0.401,160,219,0.731,58,163,221,109,77,8,95,179,472
2493,8,2003,30,1,3,82,79,2350,254,575,0.442,37,110,0.336,217,465,0.467,201,268,0.75,143,239,382,140,86,19,97,234,746
2493,9,2004,31,1,3,21,0,513,77,177,0.435,11,32,0.344,66,145,0.455,78,109,0.716,21,74,95,25,22,1,31,52,243
2493,9,2004,31,1,3,50,36,1373,154,421,0.366,24,95,0.253,130,326,0.399,137,174,0.787,44,147,191,95,48,8,57,128,469
2493,9,2004,31,1,3,71,36,1886,231,598,0.386,35,127,0.276,196,471,0.416,215,283,0.76,65,221,286,120,70,9,88,180,712
2493,10,2005,32,1,2,34,18,583,55,145,0.379,11,33,0.333,44,112,0.393,38,53,0.717,16,61,77,50,22,2,26,67,159
2493,10,2005,32,1,2,21,21,739,87,185,0.47,17,40,0.425,70,145,0.483,74,108,0.685,28,67,95,42,16,2,34,80,265
2493,10,2005,32,1,2,55,39,1322,142,330,0.43,28,73,0.384,114,257,0.444,112,161,0.696,44,128,172,92,38,4,60,147,424
2493,11,2006,33,1,3,28,11,352,29,75,0.387,5,18,0.278,24,57,0.421,28,38,0.737,10,40,50,15,7,2,15,55,91
2493,12,2007,34,1,3,21,0,121,19,47,0.404,8,19,0.421,11,28,0.393,8,14,0.571,3,14,17,7,3,0,7,12,54
2494,1,1985,24,1,3,21,0,119,29,63,0.46,1,4,0.25,28,59,0.475,2,5,0.4,15,12,27,9,5,2,8,17,61
2496,1,1982,23,1,5,82,75,2277,407,854,0.477,2,7,0.286,405,847,0.478,126,188,0.67,175,430,605,139,53,178,137,200,942
2496,2,1983,24,1,5,78,74,2513,580,1163,0.499,0,7,0,580,1156,0.502,155,220,0.705,151,432,583,262,54,171,229,230,1315
2496,3,1984,25,1,5,69,53,2279,411,860,0.478,0,4,0,411,856,0.48,207,295,0.702,154,400,554,215,60,108,207,193,1029
2496,4,1985,26,1,5,75,70,2557,575,1211,0.475,1,9,0.111,574,1202,0.478,224,341,0.657,154,480,634,252,54,134,265,218,1375
2496,5,1986,27,1,5,78,74,2770,627,1275,0.492,1,12,0.083,626,1263,0.496,294,403,0.73,172,538,710,174,50,184,210,244,1549
2496,6,1987,28,1,4,74,67,2526,451,939,0.48,0,9,0,451,930,0.485,199,269,0.74,143,400,543,174,59,93,145,255,1101
2496,7,1988,29,1,5,75,37,1966,311,732,0.425,0,6,0,311,726,0.428,126,171,0.737,116,353,469,98,37,146,119,244,748
2496,8,1989,30,1,5,30,20,903,78,197,0.396,0,2,0,78,195,0.4,43,68,0.632,48,149,197,36,15,54,41,80,199
2496,8,1989,30,1,5,46,46,1567,244,542,0.45,0,3,0,244,539,0.453,90,126,0.714,87,309,396,88,31,80,108,156,578
2496,8,1989,30,1,5,76,66,2470,322,739,0.436,0,5,0,322,734,0.439,133,194,0.686,135,458,593,124,46,134,149,236,777
2496,9,1990,31,1,5,81,19,2199,295,665,0.444,2,9,0.222,293,656,0.447,108,159,0.679,76,315,391,119,51,106,106,243,700
2496,10,1991,32,1,5,60,36,1832,332,655,0.507,0,4,0,332,651,0.51,83,130,0.638,86,271,357,95,30,88,113,197,747
2496,11,1992,33,1,5,75,26,2040,367,851,0.431,1,6,0.167,366,845,0.433,124,171,0.725,106,348,454,94,35,98,114,189,859
2496,12,1993,34,1,5,55,0,571,72,175,0.411,0,0,-1,72,175,0.411,14,21,0.667,44,102,146,19,21,28,22,78,158
2496,13,1994,35,1,5,70,3,774,103,233,0.442,0,1,0,103,232,0.444,27,42,0.643,56,126,182,28,18,43,39,108,233
2496,14,1995,36,1,5,56,3,743,82,180,0.456,0,0,-1,82,180,0.456,23,37,0.622,23,109,132,27,13,45,40,108,187
2496,15,1996,37,1,4,43,2,540,59,144,0.41,1,4,0.25,58,140,0.414,13,20,0.65,14,68,82,27,13,31,22,75,132
2496,15,1996,37,1,4,44,2,571,62,152,0.408,1,4,0.25,61,148,0.412,13,20,0.65,15,75,90,27,14,33,22,79,138
2496,16,1997,38,1,4,21,2,184,18,46,0.391,0,1,0,18,45,0.4,3,4,0.75,9,22,31,5,4,5,5,18,39
2496,17,1998,39,1,4,27,0,178,18,43,0.419,0,0,-1,18,43,0.419,1,8,0.125,6,23,29,4,6,9,5,34,37
2497,1,1987,24,1,4,80,80,2714,435,897,0.485,0,1,0,435,896,0.485,298,400,0.745,222,407,629,154,58,167,139,197,1168
2497,2,1988,25,1,4,77,50,2106,316,663,0.477,0,1,0,316,662,0.477,211,279,0.756,159,347,506,103,61,145,104,203,843
2497,3,1989,26,1,4,82,10,2125,356,700,0.509,1,4,0.25,355,696,0.51,235,314,0.748,173,304,477,108,77,134,102,188,948
2497,4,1990,27,1,4,82,29,2776,528,1070,0.493,0,0,-1,528,1070,0.493,325,440,0.739,220,443,663,168,86,167,143,214,1381
2497,5,1991,28,1,5,43,14,1293,199,430,0.463,0,1,0,199,429,0.464,107,164,0.652,111,179,290,100,36,69,63,126,505
2497,6,1992,29,1,5,80,12,2432,341,678,0.503,0,4,0,341,674,0.506,270,359,0.752,228,379,607,196,60,182,83,191,952
2497,7,1993,30,1,5,67,13,2055,263,560,0.47,0,0,-1,263,560,0.47,212,296,0.716,127,288,415,152,48,105,116,171,738
2497,8,1994,31,1,4,76,72,2660,394,825,0.478,0,0,-1,394,825,0.478,252,346,0.728,207,368,575,193,78,130,139,219,1040
2497,9,1995,32,1,4,74,73,2641,366,810,0.452,1,5,0.2,365,805,0.453,196,286,0.685,173,334,507,192,83,101,149,211,929
2497,10,1996,33,1,5,62,58,1652,180,397,0.453,0,1,0,180,396,0.455,95,130,0.731,129,243,372,62,46,90,62,170,455
2497,11,1997,34,1,5,68,66,2137,204,416,0.49,0,2,0,204,414,0.493,133,198,0.672,178,384,562,100,67,88,66,176,541
2497,12,1998,35,1,5,71,30,1333,95,202,0.47,0,0,-1,95,202,0.47,65,93,0.699,107,205,312,49,33,60,29,138,255
2497,13,1999,36,1,5,25,11,403,11,33,0.333,0,0,-1,11,33,0.333,7,10,0.7,36,47,83,15,13,18,13,49,29
2498,1,2010,26,1,1,54,6,742,81,206,0.393,30,93,0.323,51,113,0.451,32,45,0.711,16,67,83,34,12,5,18,73,224
2498,2,2011,27,1,3,26,1,391,41,126,0.325,13,45,0.289,28,81,0.346,9,12,0.75,7,41,48,22,9,3,16,34,104
2499,1,2003,21,1,1,75,54,1961,273,685,0.399,65,202,0.322,208,483,0.431,103,161,0.64,27,168,195,350,86,17,171,179,714
2500,1,1991,22,1,4,52,1,508,72,161,0.447,1,2,0.5,71,159,0.447,37,56,0.661,41,70,111,16,9,6,40,92,182
2500,2,1992,23,1,4,50,8,646,75,206,0.364,0,0,-1,75,206,0.364,56,88,0.636,62,83,145,12,20,20,44,110,206
2500,3,1993,24,1,4,12,2,139,21,46,0.457,0,0,-1,21,46,0.457,7,18,0.389,22,19,41,0,4,4,8,24,49
2500,4,1994,25,1,4,70,0,877,125,293,0.427,0,0,-1,125,293,0.427,72,119,0.605,109,154,263,26,17,36,35,140,322
2500,5,1995,26,1,4,75,6,982,149,323,0.461,0,5,0,149,318,0.469,65,122,0.533,179,246,425,35,26,33,59,160,363
2500,6,1996,27,1,4,80,6,1858,279,660,0.423,2,7,0.286,277,653,0.424,161,272,0.592,342,461,803,47,35,57,106,238,721
2500,7,1997,28,1,4,41,40,1432,221,540,0.409,0,4,0,221,536,0.412,108,183,0.59,242,311,553,51,24,36,82,158,550
2500,8,1998,29,1,5,65,65,2343,321,645,0.498,0,4,0,321,641,0.501,195,293,0.666,443,440,883,67,45,49,95,236,837
2500,9,1999,30,1,5,30,30,1020,97,218,0.445,0,2,0,97,216,0.449,48,85,0.565,147,213,360,33,24,60,46,126,242
2501,1,1997,23,1,4,33,0,177,20,51,0.392,0,0,-1,20,51,0.392,9,17,0.529,22,28,50,7,13,1,13,18,49
2501,2,1998,24,1,4,77,3,1305,151,288,0.524,0,1,0,151,287,0.526,108,166,0.651,170,209,379,48,51,10,60,144,410
2501,3,1999,25,1,4,50,10,1154,124,248,0.5,0,0,-1,124,248,0.5,107,159,0.673,158,191,349,23,63,7,41,108,355
2501,4,2000,26,1,4,82,1,2102,257,456,0.564,0,3,0,257,453,0.567,175,284,0.616,277,512,789,68,95,21,105,196,689
2501,5,2001,27,1,4,26,0,378,48,93,0.516,0,1,0,48,92,0.522,35,45,0.778,35,69,104,13,18,10,16,43,131
2501,5,2001,27,1,4,33,2,804,88,201,0.438,0,2,0,88,199,0.442,65,90,0.722,98,180,278,32,39,10,47,81,241
2501,5,2001,27,1,4,59,2,1182,136,294,0.463,0,3,0,136,291,0.467,100,135,0.741,133,249,382,45,57,20,63,124,372
2501,6,2002,28,1,4,68,32,1641,190,388,0.49,0,0,-1,190,388,0.49,138,204,0.676,165,221,386,75,78,25,68,153,518
2501,7,2003,29,1,4,71,63,2346,267,535,0.499,1,6,0.167,266,529,0.503,156,281,0.555,231,419,650,95,116,26,98,197,691
2501,8,2004,30,1,4,15,12,407,28,57,0.491,0,1,0,28,56,0.5,21,29,0.724,35,93,128,11,19,3,23,30,77
2501,8,2004,30,1,4,53,32,1230,130,279,0.466,0,7,0,130,272,0.478,85,126,0.675,142,205,347,61,71,5,51,104,345
2501,8,2004,30,1,4,68,44,1637,158,336,0.47,0,8,0,158,328,0.482,106,155,0.684,177,298,475,72,90,8,74,134,422
2501,9,2005,31,1,3,79,4,1211,122,243,0.502,0,5,0,122,238,0.513,115,172,0.669,115,168,283,41,55,10,65,155,359
2502,1,2012,21,1,5,43,5,635,77,152,0.507,0,0,-1,77,152,0.507,43,66,0.652,66,90,156,11,21,15,23,61,197
2503,1,1990,26,1,4,21,0,102,6,18,0.333,0,1,0,6,17,0.353,3,6,0.5,5,18,23,2,3,7,3,30,15
2505,1,2007,21,1,1,79,2,1315,208,526,0.395,46,163,0.282,162,363,0.446,72,85,0.847,29,134,163,260,29,2,142,96,534
2505,2,2008,22,1,1,53,7,854,111,293,0.379,54,142,0.38,57,151,0.377,37,47,0.787,14,87,101,140,25,3,75,52,313
2505,3,2010,24,1,1,62,1,872,104,271,0.384,24,81,0.296,80,190,0.421,37,55,0.673,13,80,93,161,32,1,74,43,269
2506,1,2007,22,1,5,26,1,333,54,88,0.614,0,1,0,54,87,0.621,23,63,0.365,51,64,115,2,5,16,15,51,131
2506,2,2008,23,1,5,22,0,117,12,26,0.462,0,0,-1,12,26,0.462,7,22,0.318,19,29,48,0,5,5,3,14,31
2506,2,2008,23,1,5,23,0,123,13,29,0.448,0,0,-1,13,29,0.448,8,26,0.308,20,29,49,0,5,5,4,17,34
2507,1,1991,21,1,4,75,0,527,93,179,0.52,0,3,0,93,176,0.528,34,50,0.68,56,75,131,31,11,31,41,81,220
2507,2,1992,22,1,3,60,6,565,113,218,0.518,0,4,0,113,214,0.528,26,43,0.605,64,65,129,40,20,41,22,99,252
2507,3,1993,23,1,3,57,0,844,150,282,0.532,0,3,0,150,279,0.538,48,68,0.706,102,126,228,38,21,45,28,87,348
2507,4,1994,24,1,3,68,1,982,191,391,0.488,0,4,0,191,387,0.494,45,64,0.703,93,112,205,52,24,49,45,99,427
2508,1,1995,23,1,3,41,23,503,60,133,0.451,0,8,0,60,125,0.48,17,38,0.447,42,56,98,49,20,4,41,87,137
2508,2,1996,24,1,3,17,0,122,20,46,0.435,0,1,0,20,45,0.444,9,12,0.75,11,12,23,4,4,2,13,17,49
2508,2,1996,24,1,3,31,0,184,27,68,0.397,0,1,0,27,67,0.403,14,20,0.7,20,20,40,8,6,2,18,26,68
2508,3,1997,25,1,3,65,26,1345,234,460,0.509,0,1,0,234,459,0.51,120,186,0.645,98,108,206,91,55,52,116,161,588
2508,4,1998,26,1,3,72,16,1314,165,368,0.448,1,2,0.5,164,366,0.448,122,182,0.67,67,112,179,89,34,24,82,133,453
2508,5,2000,28,1,3,75,23,1501,263,538,0.489,2,5,0.4,261,533,0.49,123,166,0.741,96,154,250,106,46,17,109,187,651
2508,6,2001,29,1,3,82,0,1211,162,364,0.445,1,13,0.077,161,351,0.459,85,133,0.639,86,157,243,79,29,16,85,136,410
2508,7,2002,30,1,3,68,19,1284,198,362,0.547,0,4,0,198,358,0.553,88,134,0.657,80,155,235,96,49,17,86,134,484
2508,8,2003,31,1,3,21,2,276,34,80,0.425,0,2,0,34,78,0.436,24,32,0.75,12,33,45,26,12,5,17,33,92
2510,1,1986,20,1,4,53,11,573,67,111,0.604,0,0,-1,67,111,0.604,17,40,0.425,47,99,146,14,19,23,19,68,151
2511,1,1980,25,1,1,82,-1,2582,687,1384,0.496,7,37,0.189,680,1347,0.505,333,423,0.787,149,263,412,512,167,24,256,295,1714
2511,2,1981,26,1,1,79,-1,2742,616,1335,0.461,16,68,0.235,600,1267,0.474,312,382,0.817,122,199,321,432,185,37,235,270,1560
2511,3,1982,27,1,2,82,69,2732,639,1383,0.462,9,54,0.167,630,1329,0.474,387,465,0.832,117,208,325,488,199,43,290,302,1674
2511,4,1983,28,1,1,72,68,2170,419,1068,0.392,15,74,0.203,404,994,0.406,256,333,0.769,93,234,327,569,120,26,335,248,1109
2511,5,1984,29,1,2,76,63,2230,418,939,0.445,25,81,0.309,393,858,0.458,263,318,0.827,67,200,267,449,162,26,219,274,1124
2511,6,1985,30,1,1,23,5,459,55,143,0.385,6,23,0.261,49,120,0.408,31,46,0.674,16,41,57,90,30,5,42,56,147
2511,7,1986,31,1,1,19,13,367,57,143,0.399,4,11,0.364,53,132,0.402,41,48,0.854,19,26,45,67,28,1,41,48,159
2511,7,1986,31,1,1,23,8,397,50,131,0.382,2,6,0.333,48,125,0.384,62,64,0.969,13,24,37,111,28,3,51,64,164
2511,7,1986,31,1,1,47,21,827,117,306,0.382,6,19,0.316,111,287,0.387,115,126,0.913,35,51,86,187,61,4,101,124,355
2511,8,1987,32,1,1,32,14,800,131,290,0.452,7,28,0.25,124,262,0.473,49,60,0.817,26,49,75,185,38,9,94,111,318
2512,1,1988,23,1,3,35,14,857,152,427,0.356,13,58,0.224,139,369,0.377,48,66,0.727,55,63,118,58,29,21,63,108,365
2512,2,1989,24,1,3,63,17,1303,260,594,0.438,30,104,0.288,230,490,0.469,92,122,0.754,70,109,179,103,81,29,114,181,642
2512,3,1990,25,1,3,5,5,133,21,57,0.368,0,5,0,21,52,0.404,18,21,0.857,8,7,15,10,9,1,9,7,60
2512,3,1990,25,1,3,32,12,542,91,239,0.381,6,27,0.222,85,212,0.401,30,41,0.732,17,43,60,38,22,10,32,79,218
2512,3,1990,25,1,3,47,17,743,131,338,0.388,6,37,0.162,125,301,0.415,52,68,0.765,28,55,83,53,32,14,45,102,320
2512,4,1991,26,1,3,22,0,354,61,127,0.48,14,26,0.538,47,101,0.465,35,41,0.854,17,42,59,46,20,11,36,64,171
2512,4,1991,26,1,3,51,46,1542,323,728,0.444,43,131,0.328,280,597,0.469,131,156,0.84,116,131,247,87,93,30,76,189,820
2512,4,1991,26,1,3,73,46,1896,384,855,0.449,57,157,0.363,327,698,0.468,166,197,0.843,133,173,306,133,113,41,112,253,991
2512,5,1992,27,1,3,81,80,2623,601,1277,0.471,56,156,0.359,545,1121,0.486,216,269,0.803,145,260,405,235,148,68,173,270,1474
2512,6,1993,28,1,3,79,79,2722,535,1167,0.458,33,122,0.27,502,1045,0.48,238,296,0.804,132,296,428,295,126,76,194,284,1341
2512,7,1994,29,1,3,82,68,2654,418,1014,0.412,64,230,0.278,354,784,0.452,165,225,0.733,98,294,392,300,117,66,163,288,1065
2512,8,1995,30,1,3,74,70,2198,388,846,0.459,85,266,0.32,303,580,0.522,132,174,0.759,94,235,329,231,114,67,124,264,993
2512,9,1996,31,1,3,52,5,817,94,254,0.37,20,89,0.225,74,165,0.448,33,39,0.846,25,97,122,74,34,21,51,137,241
2512,10,1997,32,1,3,11,0,167,27,67,0.403,9,33,0.273,18,34,0.529,8,10,0.8,4,20,24,8,8,4,10,28,71
2512,10,1997,32,1,3,13,0,200,29,76,0.382,9,34,0.265,20,42,0.476,9,12,0.75,5,26,31,10,8,4,12,33,76
2513,1,1983,25,1,2,44,0,346,56,135,0.415,0,3,0,56,132,0.424,35,53,0.66,15,23,38,37,20,4,38,42,147
2514,1,1983,21,1,1,74,33,1443,191,468,0.408,2,15,0.133,189,453,0.417,131,174,0.753,37,99,136,361,89,12,185,221,515
2514,2,1984,22,1,1,79,66,1924,309,671,0.461,15,47,0.319,294,624,0.471,171,209,0.818,54,140,194,464,84,5,169,268,804
2517,1,1982,22,1,4,59,22,1073,154,277,0.556,0,0,-1,154,277,0.556,49,89,0.551,91,217,308,38,45,76,64,156,357
2517,2,1983,23,1,4,75,28,1533,252,479,0.526,0,1,0,252,478,0.527,123,171,0.719,153,240,393,45,71,89,101,244,627
2517,3,1984,24,1,4,70,12,1375,193,405,0.477,0,1,0,193,404,0.478,86,133,0.647,117,209,326,60,62,103,96,203,472
2517,3,1984,24,1,4,77,12,1434,204,431,0.473,0,1,0,204,430,0.474,92,140,0.657,121,218,339,62,68,106,99,209,500
2517,4,1985,25,1,4,46,8,488,58,148,0.392,0,1,0,58,147,0.395,28,47,0.596,38,68,106,11,26,26,44,92,144
2518,1,1991,22,1,4,51,0,337,53,104,0.51,1,2,0.5,52,102,0.51,20,28,0.714,42,56,98,16,12,13,23,51,127
2518,2,1992,23,1,4,63,0,690,83,172,0.483,0,3,0,83,169,0.491,48,74,0.649,90,157,247,50,13,36,35,122,214
2518,3,1993,24,1,4,71,5,1369,166,356,0.466,0,7,0,166,349,0.476,90,126,0.714,168,283,451,68,55,66,73,230,422
2518,4,1994,25,1,5,38,11,638,114,236,0.483,1,5,0.2,113,231,0.489,60,98,0.612,69,112,181,39,16,21,44,112,289
2518,5,1995,26,1,4,77,43,1781,206,434,0.475,0,7,0,206,427,0.482,79,107,0.738,173,312,485,59,71,40,84,237,491
2518,6,1996,27,1,4,13,1,193,15,29,0.517,0,2,0,15,27,0.556,10,12,0.833,13,33,46,5,6,7,8,27,40
2518,7,1997,28,1,5,62,52,1317,162,318,0.509,0,2,0,162,316,0.513,38,55,0.691,155,242,397,41,44,41,50,206,362
2518,8,1998,29,1,5,58,7,801,93,213,0.437,0,5,0,93,208,0.447,51,63,0.81,87,124,211,29,17,21,30,132,237
2518,9,2000,31,1,5,68,46,1488,213,426,0.5,0,0,-1,213,426,0.5,94,129,0.729,177,271,448,28,40,66,65,230,520
2518,10,2001,32,1,5,66,31,1272,171,361,0.474,1,4,0.25,170,357,0.476,60,70,0.857,97,267,364,35,48,32,41,178,403
2518,11,2002,33,1,4,41,16,737,86,217,0.396,0,2,0,86,215,0.4,30,41,0.732,82,127,209,13,17,33,35,98,202
2518,12,2003,34,1,5,69,33,872,120,292,0.411,0,2,0,120,290,0.414,33,42,0.786,72,121,193,22,27,21,32,159,273
2518,13,2004,35,1,5,27,11,260,37,85,0.435,0,1,0,37,84,0.44,7,14,0.5,15,45,60,11,5,9,10,50,81
2518,13,2004,35,1,5,16,10,267,53,101,0.525,2,2,1,51,99,0.515,9,13,0.692,23,49,72,6,15,7,6,45,117
2518,13,2004,35,1,5,43,21,527,90,186,0.484,2,3,0.667,88,183,0.481,16,27,0.593,38,94,132,17,20,16,16,95,198
2518,14,2005,36,1,5,19,0,152,12,41,0.293,0,1,0,12,40,0.3,9,11,0.818,15,15,30,8,4,6,5,30,33
2519,1,1998,28,1,3,39,0,365,56,119,0.471,0,1,0,56,118,0.475,24,46,0.522,53,39,92,20,18,5,30,55,136
2520,1,1993,22,1,3,59,26,1673,358,823,0.435,61,191,0.319,297,632,0.47,224,302,0.742,115,150,265,178,66,29,179,209,1001
2520,2,1994,23,1,3,57,4,1356,226,580,0.39,38,132,0.288,188,448,0.42,148,233,0.635,71,164,235,132,52,23,145,200,638
2520,3,1995,24,1,3,77,77,2739,445,998,0.446,103,296,0.348,342,702,0.487,266,364,0.731,100,245,345,316,123,63,243,265,1259
2520,4,1996,25,1,3,28,28,788,124,268,0.463,56,123,0.455,68,145,0.469,33,60,0.55,37,75,112,65,32,16,48,87,337
2520,4,1996,25,1,3,45,45,1381,235,540,0.435,58,170,0.341,177,370,0.478,130,172,0.756,62,145,207,165,53,42,103,151,658
2520,4,1996,25,1,3,73,73,2169,359,808,0.444,114,293,0.389,245,515,0.476,163,232,0.703,99,220,319,230,85,58,151,238,995
2520,5,1997,26,1,3,73,73,2647,419,982,0.427,175,437,0.4,244,545,0.448,186,243,0.765,103,264,367,197,97,62,174,282,1199
2520,6,1998,27,1,3,31,1,594,85,225,0.378,31,90,0.344,54,135,0.4,59,65,0.908,23,59,82,53,19,12,40,61,260
2520,6,1998,27,1,3,28,16,876,125,319,0.392,49,129,0.38,76,190,0.4,49,60,0.817,27,91,118,69,40,23,52,100,348
2520,6,1998,27,1,3,59,17,1470,210,544,0.386,80,219,0.365,130,325,0.4,108,125,0.864,50,150,200,122,59,35,92,161,608
2520,7,1999,28,1,3,48,16,1044,147,347,0.424,63,144,0.438,84,203,0.414,89,107,0.832,36,107,143,80,37,28,63,101,446
2520,8,2000,29,1,3,76,66,1859,312,681,0.458,102,261,0.391,210,420,0.5,101,123,0.821,69,237,306,157,49,44,113,190,827
2520,9,2001,30,1,3,72,31,1583,202,513,0.394,98,248,0.395,104,265,0.392,97,126,0.77,31,214,245,97,30,28,73,153,599
2520,10,2002,31,1,3,48,25,1117,166,396,0.419,78,183,0.426,88,213,0.413,40,51,0.784,37,125,162,69,18,10,53,106,450
2520,11,2003,32,1,3,66,1,1161,134,341,0.393,64,171,0.374,70,170,0.412,31,50,0.62,53,154,207,59,42,26,35,141,363
2521,1,1980,22,1,3,57,-1,556,104,267,0.39,0,4,0,104,263,0.395,58,90,0.644,65,56,121,36,19,8,49,73,266
2521,2,1981,23,1,4,67,-1,1976,349,708,0.493,2,8,0.25,347,700,0.496,185,268,0.69,159,257,416,180,116,18,141,199,885
2521,3,1982,24,1,3,60,27,1521,349,628,0.556,2,9,0.222,347,619,0.561,131,173,0.757,100,127,227,142,77,16,114,153,831
2521,4,1983,25,1,4,68,6,1385,314,647,0.485,2,19,0.105,312,628,0.497,176,259,0.68,94,196,290,133,73,3,133,166,806
2521,5,1984,26,1,3,13,1,258,34,114,0.298,1,9,0.111,33,105,0.314,36,46,0.783,19,31,50,16,14,1,18,33,105
2521,6,1985,27,1,3,34,20,867,167,380,0.439,4,15,0.267,163,365,0.447,79,123,0.642,45,123,168,94,28,8,78,83,417
2522,1,2010,22,1,3,78,9,1764,261,651,0.401,31,100,0.31,230,551,0.417,103,144,0.715,46,302,348,223,43,10,124,126,656
2522,2,2011,23,1,2,10,0,206,29,73,0.397,4,12,0.333,25,61,0.41,5,10,0.5,3,33,36,31,5,0,25,21,67
2522,2,2011,23,1,2,21,0,290,43,115,0.374,6,22,0.273,37,93,0.398,14,21,0.667,4,47,51,38,9,0,33,25,106
2522,3,2012,24,1,2,12,0,181,20,57,0.351,8,19,0.421,12,38,0.316,6,12,0.5,2,26,28,10,4,1,10,16,54
2522,3,2012,24,1,2,18,0,369,65,141,0.461,8,27,0.296,57,114,0.5,21,34,0.618,11,63,74,55,16,6,33,19,159
2522,3,2012,24,1,2,30,0,550,85,198,0.429,16,46,0.348,69,152,0.454,27,46,0.587,13,89,102,65,20,7,43,35,213
2522,4,2013,25,1,3,24,0,318,48,97,0.495,5,15,0.333,43,82,0.524,9,21,0.429,4,40,44,38,11,2,22,13,110
2523,1,2007,23,1,4,81,31,1514,166,365,0.455,2,4,0.5,164,361,0.454,110,144,0.764,131,304,435,44,52,39,96,199,444
2523,2,2008,24,1,4,28,0,362,55,112,0.491,0,1,0,55,111,0.495,36,54,0.667,34,64,98,8,9,10,21,50,146
2523,2,2008,24,1,4,36,0,414,37,100,0.37,0,1,0,37,99,0.374,35,51,0.686,34,73,107,11,13,11,14,60,109
2523,2,2008,24,1,4,64,0,776,92,212,0.434,0,2,0,92,210,0.438,71,105,0.676,68,137,205,19,22,21,35,110,255
2523,3,2009,25,1,4,15,0,207,30,68,0.441,0,0,-1,30,68,0.441,14,21,0.667,24,51,75,4,10,8,8,28,74
2523,3,2009,25,1,4,30,0,305,40,89,0.449,0,2,0,40,87,0.46,32,42,0.762,25,53,78,8,12,10,26,36,112
2523,3,2009,25,1,4,45,0,512,70,157,0.446,0,2,0,70,155,0.452,46,63,0.73,49,104,153,12,22,18,34,64,186
2523,4,2010,26,1,4,54,0,597,63,121,0.521,0,1,0,63,120,0.525,75,98,0.765,47,99,146,21,13,21,30,85,201
2523,5,2011,27,1,4,17,6,198,21,39,0.538,0,0,-1,21,39,0.538,24,29,0.828,19,31,50,13,5,4,6,34,66
2523,5,2011,27,1,4,42,32,713,82,181,0.453,0,0,-1,82,181,0.453,34,46,0.739,74,149,223,19,18,22,37,92,198
2523,5,2011,27,1,4,59,38,911,103,220,0.468,0,0,-1,103,220,0.468,58,75,0.773,93,180,273,32,23,26,43,126,264
2523,6,2012,28,1,5,58,35,1276,96,201,0.478,0,0,-1,96,201,0.478,76,104,0.731,141,209,350,35,47,39,66,149,268
2528,1,2000,25,1,1,25,1,508,61,179,0.341,29,98,0.296,32,81,0.395,39,51,0.765,11,40,51,66,23,2,37,32,190
2529,1,1996,22,1,3,53,3,609,125,268,0.466,0,3,0,125,265,0.472,47,84,0.56,56,58,114,23,11,9,76,115,297
2529,2,1997,23,1,3,79,31,1992,371,745,0.498,0,3,0,371,742,0.5,173,251,0.689,139,187,326,124,60,49,157,263,915
2529,3,1998,24,1,3,79,75,2819,561,1134,0.495,0,9,0,561,1125,0.499,279,443,0.63,162,284,446,230,76,48,199,252,1401
2529,4,1999,25,1,3,50,50,1374,269,555,0.485,1,5,0.2,268,550,0.487,120,188,0.638,85,121,206,66,30,8,75,118,659
2529,5,2000,26,1,3,76,76,1707,311,622,0.5,0,0,-1,311,622,0.5,163,212,0.769,122,168,290,82,38,19,110,192,785
2529,6,2001,27,1,3,27,9,800,172,322,0.534,0,0,-1,172,322,0.534,67,107,0.626,53,115,168,28,35,8,45,87,411
2529,6,2001,27,1,3,42,31,886,153,325,0.471,0,2,0,153,323,0.474,84,130,0.646,57,96,153,33,15,13,65,98,390
2529,6,2001,27,1,3,69,40,1686,325,647,0.502,0,2,0,325,645,0.504,151,237,0.637,110,211,321,61,50,21,110,185,801
2529,7,2002,28,1,3,78,7,1701,411,806,0.51,1,5,0.2,410,801,0.512,240,298,0.805,117,202,319,94,49,26,137,226,1063
2529,8,2003,29,1,3,82,1,2061,374,826,0.453,2,11,0.182,372,815,0.456,237,300,0.79,147,211,358,104,44,27,126,238,987
2529,9,2004,30,1,4,79,0,1574,304,602,0.505,0,0,-1,304,602,0.505,144,197,0.731,88,168,256,57,30,20,113,204,752
2529,10,2005,31,1,4,24,4,471,79,167,0.473,0,0,-1,79,167,0.473,65,79,0.823,31,50,81,35,12,3,26,74,223
2529,10,2005,31,1,4,48,5,1056,194,417,0.465,0,2,0,194,415,0.467,130,165,0.788,73,105,178,43,26,12,60,144,518
2529,10,2005,31,1,4,72,9,1527,273,584,0.467,0,2,0,273,582,0.469,195,244,0.799,104,155,259,78,38,15,86,218,741
2529,11,2006,32,1,3,37,0,362,43,103,0.417,2,2,1,41,101,0.406,38,49,0.776,21,46,67,14,7,4,30,56,126
2529,12,2007,33,1,4,68,1,1337,236,463,0.51,0,2,0,236,461,0.512,148,207,0.715,63,158,221,39,29,15,97,183,620
2530,1,1980,28,1,2,30,-1,603,153,356,0.43,3,16,0.188,150,340,0.441,40,50,0.8,14,31,45,39,10,10,49,66,349
2530,1,1980,28,1,2,28,-1,771,206,461,0.447,8,19,0.421,198,442,0.448,76,88,0.864,24,30,54,87,26,9,43,71,496
2530,1,1980,28,1,2,58,-1,1374,359,817,0.439,11,35,0.314,348,782,0.445,116,138,0.841,38,61,99,126,36,19,92,137,845
2530,2,1981,29,1,2,9,-1,112,18,56,0.321,1,6,0.167,17,50,0.34,5,6,0.833,0,7,7,17,4,1,12,13,42
2532,1,1980,24,1,2,16,-1,143,7,25,0.28,0,0,-1,7,25,0.28,3,6,0.5,6,10,16,12,2,0,8,11,17
2540,1,1988,23,1,1,18,1,373,36,99,0.364,9,25,0.36,27,74,0.365,23,29,0.793,1,25,26,63,17,3,21,34,104
2540,1,1988,23,1,1,24,1,420,43,110,0.391,10,26,0.385,33,84,0.393,29,40,0.725,2,25,27,69,23,3,25,40,125
2546,1,1991,24,1,3,64,1,607,98,245,0.4,8,20,0.4,90,225,0.4,35,45,0.778,34,33,67,25,16,13,30,70,239
2546,2,1993,26,1,2,39,0,340,61,139,0.439,4,19,0.211,57,120,0.475,17,22,0.773,17,32,49,13,10,10,15,40,143
2547,1,1987,23,1,2,77,9,1612,259,602,0.43,13,52,0.25,246,550,0.447,149,201,0.741,70,86,156,155,93,19,128,169,680
2547,2,1988,24,1,2,61,22,1419,218,545,0.4,10,40,0.25,208,505,0.412,99,132,0.75,44,57,101,119,47,22,104,125,545
2547,3,1989,25,1,2,33,6,372,54,115,0.47,2,6,0.333,52,109,0.477,27,34,0.794,12,25,37,73,9,2,35,43,137
2547,4,1990,26,1,2,78,2,1856,220,491,0.448,0,13,0,220,478,0.46,87,112,0.777,62,133,195,208,89,18,127,154,527
2547,5,1991,27,1,2,25,0,563,53,138,0.384,1,9,0.111,52,129,0.403,29,41,0.707,24,51,75,46,19,5,42,66,136
2547,6,1992,28,1,2,81,72,2127,266,572,0.465,1,18,0.056,265,554,0.478,105,146,0.719,80,189,269,247,123,21,124,162,638
2547,7,1993,29,1,3,72,55,1471,180,336,0.536,1,6,0.167,179,330,0.542,79,107,0.738,49,125,174,183,66,9,89,135,440
2547,8,1994,30,1,2,50,36,1005,136,283,0.481,4,12,0.333,132,271,0.487,34,51,0.667,30,104,134,104,42,6,53,85,310
2547,9,1995,31,1,2,52,9,515,50,122,0.41,4,22,0.182,46,100,0.46,18,24,0.75,11,49,60,56,19,6,27,60,122
2547,10,1996,32,1,2,60,3,695,88,212,0.415,15,34,0.441,73,178,0.41,32,41,0.78,17,39,56,58,20,4,42,66,223
2547,11,1997,33,1,2,65,2,929,89,214,0.416,25,71,0.352,64,143,0.448,33,40,0.825,23,51,74,80,44,5,37,108,236
2547,12,1998,34,1,2,58,2,546,66,140,0.471,3,7,0.429,63,133,0.474,15,29,0.517,19,60,79,37,21,3,37,58,150
2549,1,1996,21,1,3,44,2,487,60,157,0.382,19,63,0.302,41,94,0.436,26,34,0.765,45,59,104,28,20,6,31,73,165
2549,2,1997,22,1,3,47,0,569,79,193,0.409,26,77,0.338,53,116,0.457,27,40,0.675,63,74,137,45,14,6,49,101,211
2555,1,1984,24,1,2,78,1,1071,160,318,0.503,2,5,0.4,158,313,0.505,28,46,0.609,14,57,71,71,17,0,32,82,350
2555,2,1985,25,1,2,41,22,1168,187,352,0.531,2,7,0.286,185,345,0.536,30,41,0.732,16,57,73,125,28,7,57,58,406
2555,3,1986,26,1,2,81,79,2760,467,881,0.53,5,16,0.313,462,865,0.534,104,135,0.77,51,119,170,306,81,14,114,118,1043
2555,4,1987,27,1,2,71,65,2049,398,792,0.503,4,12,0.333,394,780,0.505,100,127,0.787,30,94,124,211,39,16,88,107,900
2555,5,1988,28,1,2,82,82,2412,376,787,0.478,0,0,-1,376,787,0.478,71,89,0.798,39,131,170,302,50,18,82,117,823
2555,6,1989,29,1,3,31,2,416,50,117,0.427,2,4,0.5,48,113,0.425,16,22,0.727,6,20,26,32,10,0,12,12,118
2555,6,1989,29,1,3,33,11,704,80,169,0.473,1,2,0.5,79,167,0.473,12,19,0.632,20,34,54,79,13,2,20,31,173
2555,6,1989,29,1,3,64,13,1120,130,286,0.455,3,6,0.5,127,280,0.454,28,41,0.683,26,54,80,111,23,2,32,43,291
2555,7,1990,30,1,3,61,0,544,62,122,0.508,1,2,0.5,61,120,0.508,5,6,0.833,4,26,30,39,7,4,23,21,130
2555,8,1991,31,1,3,41,0,355,35,79,0.443,0,5,0,35,74,0.473,4,6,0.667,6,27,33,25,10,4,10,9,74
2555,9,1992,32,1,2,24,0,115,8,19,0.421,0,0,-1,8,19,0.421,1,2,0.5,1,8,9,11,2,0,3,4,17
2556,1,1980,27,1,2,80,-1,2623,535,1116,0.479,38,102,0.373,497,1014,0.49,184,214,0.86,48,175,223,362,101,28,186,208,1292
2556,2,1981,28,1,2,69,-1,1771,331,697,0.475,18,51,0.353,313,646,0.485,119,137,0.869,32,108,140,229,70,10,136,185,799
2556,3,1982,29,1,2,61,13,1829,404,806,0.501,36,93,0.387,368,713,0.516,123,156,0.788,51,119,170,253,57,9,118,187,967
2556,4,1983,30,1,2,57,12,1361,255,587,0.434,22,68,0.324,233,519,0.449,73,85,0.859,35,75,110,156,45,4,81,132,605
2557,1,1982,22,1,3,46,0,493,49,84,0.583,1,2,0.5,48,82,0.585,33,40,0.825,29,33,62,38,17,4,35,74,132
2561,1,1982,23,1,2,19,0,238,36,105,0.343,0,6,0,36,99,0.364,20,28,0.714,22,22,44,11,9,1,11,34,92
2561,1,1982,23,1,2,29,5,692,143,276,0.518,3,18,0.167,140,258,0.543,73,91,0.802,29,61,90,47,22,8,60,74,362
2561,1,1982,23,1,2,48,5,930,179,381,0.47,3,24,0.125,176,357,0.493,93,119,0.782,51,83,134,58,31,9,71,108,454
2561,2,1983,24,1,3,76,47,1822,343,740,0.464,15,50,0.3,328,690,0.475,124,161,0.77,96,140,236,134,55,36,111,188,825
2561,3,1984,25,1,2,81,81,2236,467,945,0.494,3,21,0.143,464,924,0.502,223,271,0.823,94,181,275,166,64,32,126,207,1160
2561,4,1985,26,1,2,80,79,2545,515,1061,0.485,7,33,0.212,508,1028,0.494,166,214,0.776,99,180,279,236,84,52,120,187,1203
2561,5,1986,27,1,2,78,34,1749,355,817,0.435,5,37,0.135,350,780,0.449,187,239,0.782,80,164,244,114,57,19,107,171,902
2561,6,1987,28,1,2,54,0,657,121,310,0.39,7,25,0.28,114,285,0.4,109,139,0.784,39,55,94,34,19,11,34,83,358
2563,1,1982,22,1,3,42,3,342,55,120,0.458,0,1,0,55,119,0.462,34,52,0.654,22,43,65,9,8,6,15,37,144
2564,1,2003,21,1,4,53,0,334,59,118,0.5,3,9,0.333,56,109,0.514,7,20,0.35,15,38,53,12,15,1,23,36,128
2564,2,2004,22,1,3,62,8,673,88,237,0.371,10,29,0.345,78,208,0.375,38,60,0.633,46,90,136,46,20,14,52,88,224
2564,3,2006,24,1,3,49,16,1013,129,254,0.508,22,60,0.367,107,194,0.552,49,76,0.645,44,146,190,47,32,13,61,96,329
2565,1,1993,22,1,1,41,1,174,23,66,0.348,3,14,0.214,20,52,0.385,19,26,0.731,6,8,14,40,14,1,16,26,68
2565,2,1994,23,1,1,40,0,352,49,133,0.368,27,78,0.346,22,55,0.4,20,35,0.571,13,16,29,71,24,2,34,40,145
2565,3,1995,24,1,1,62,3,495,37,117,0.316,22,74,0.297,15,43,0.349,28,38,0.737,10,34,44,134,41,0,55,87,124
2568,1,1981,23,1,1,64,-1,945,95,192,0.495,0,4,0,95,188,0.505,45,60,0.75,22,93,115,115,57,6,91,115,235
2570,1,1981,22,1,2,81,-1,949,165,373,0.442,1,5,0.2,164,368,0.446,49,64,0.766,33,64,97,75,36,12,54,95,380
2570,2,1982,23,1,2,7,0,145,30,68,0.441,0,1,0,30,67,0.448,23,32,0.719,5,8,13,16,7,2,9,21,83
2570,2,1982,23,1,2,76,74,2186,508,1001,0.507,7,24,0.292,501,977,0.513,198,254,0.78,97,137,234,206,135,33,144,199,1221
2570,2,1982,23,1,2,83,74,2331,538,1069,0.503,7,25,0.28,531,1044,0.509,221,286,0.773,102,145,247,222,142,35,153,220,1304
2570,3,1983,24,1,2,81,3,2426,584,1154,0.506,7,33,0.212,577,1121,0.515,298,377,0.79,84,164,248,254,137,59,174,203,1473
2570,4,1984,25,1,2,71,12,1838,389,816,0.477,2,8,0.25,387,808,0.479,247,302,0.818,62,113,175,175,83,28,115,174,1027
2570,5,1985,26,1,2,78,3,1998,530,1068,0.496,5,21,0.238,525,1047,0.501,264,330,0.8,69,129,198,143,117,28,139,216,1329
2570,6,1986,27,1,2,81,51,2417,510,1073,0.475,2,13,0.154,508,1060,0.479,242,289,0.837,94,132,226,197,92,37,145,215,1264
2570,7,1987,28,1,2,74,66,2126,494,1130,0.437,34,123,0.276,460,1007,0.457,240,290,0.828,68,94,162,196,100,16,168,201,1262
2570,8,1988,29,1,2,80,77,2534,562,1263,0.445,18,78,0.231,544,1185,0.459,296,341,0.868,64,126,190,273,109,26,186,210,1438
2570,9,1989,30,1,2,81,79,2259,410,936,0.438,31,89,0.348,379,847,0.447,195,237,0.823,51,143,194,206,89,18,136,195,1046
2570,10,1990,31,1,2,61,11,972,160,405,0.395,12,41,0.293,148,364,0.407,62,86,0.721,25,63,88,66,42,11,49,100,394
2570,11,1991,32,1,2,11,3,125,21,54,0.389,1,6,0.167,20,48,0.417,10,12,0.833,2,9,11,10,5,4,7,11,53
2570,11,1991,32,1,2,15,3,171,26,77,0.338,1,7,0.143,25,70,0.357,11,13,0.846,3,10,13,15,5,5,12,18,64
2573,1,2006,21,1,2,39,0,370,29,81,0.358,1,15,0.067,28,66,0.424,11,22,0.5,8,22,30,12,4,3,21,42,70
2573,2,2007,22,1,2,63,23,1137,110,251,0.438,19,59,0.322,91,192,0.474,44,73,0.603,38,137,175,55,30,10,43,120,283
2573,3,2008,23,1,2,15,0,176,21,42,0.5,5,9,0.556,16,33,0.485,5,9,0.556,5,17,22,13,2,4,11,22,52
2573,3,2008,23,1,2,41,10,1056,115,287,0.401,27,101,0.267,88,186,0.473,41,58,0.707,35,90,125,67,26,17,39,105,298
2573,3,2008,23,1,2,56,10,1232,136,329,0.413,32,110,0.291,104,219,0.475,46,67,0.687,40,107,147,80,28,21,50,127,350
2573,4,2009,24,1,3,65,53,1552,179,431,0.415,45,149,0.302,134,282,0.475,71,95,0.747,31,105,136,77,46,27,54,172,474
2573,5,2010,25,1,3,67,10,1392,162,399,0.406,58,173,0.335,104,226,0.46,53,77,0.688,38,152,190,71,30,11,58,134,435
2574,1,1983,21,1,3,77,1,1970,447,772,0.579,1,4,0.25,446,768,0.581,138,221,0.624,157,242,399,132,91,64,178,221,1033
2574,2,1984,22,1,4,82,53,2415,495,890,0.556,0,6,0,495,884,0.56,195,257,0.759,157,358,515,207,77,70,181,244,1185
2574,3,1985,23,1,3,80,76,2696,610,1066,0.572,0,7,0,610,1059,0.576,190,245,0.776,169,342,511,201,87,67,198,196,1410
2574,4,1986,24,1,3,75,73,2454,629,1086,0.579,0,13,0,629,1073,0.586,242,314,0.771,136,251,387,201,82,77,149,195,1500
2574,5,1987,25,1,3,82,82,2819,651,1207,0.539,0,13,0,651,1194,0.545,292,389,0.751,158,308,466,226,108,83,168,206,1594
2574,6,1988,26,1,3,75,72,2655,617,1161,0.531,2,16,0.125,615,1145,0.537,242,304,0.796,129,245,374,289,72,55,155,175,1478
2574,7,1989,27,1,3,81,81,2960,702,1282,0.548,2,23,0.087,700,1259,0.556,251,321,0.782,169,320,489,288,108,56,182,175,1657
2574,8,1990,28,1,3,80,80,2960,711,1298,0.548,15,49,0.306,696,1249,0.557,248,317,0.782,160,318,478,288,99,49,160,190,1685
2574,9,1991,29,1,3,78,74,3008,716,1455,0.492,26,90,0.289,690,1365,0.505,212,266,0.797,107,249,356,275,104,35,127,117,1670
2574,10,1992,30,1,3,54,54,2108,450,1007,0.447,9,43,0.209,441,964,0.457,166,204,0.814,98,207,305,252,76,23,127,89,1075
2574,11,1993,31,1,3,82,69,2359,510,1142,0.447,30,111,0.27,480,1031,0.466,171,211,0.81,73,174,247,278,92,27,137,87,1221
2574,12,1994,32,1,3,80,2,1597,340,838,0.406,32,111,0.288,308,727,0.424,100,135,0.741,48,133,181,154,45,18,97,80,812
2575,1,1982,22,1,3,75,12,1188,202,394,0.513,0,3,0,202,391,0.517,144,206,0.699,82,145,227,81,23,24,107,152,548
2575,2,1983,23,1,3,57,38,1627,361,622,0.58,0,3,0,361,619,0.583,217,340,0.638,122,176,298,97,38,44,157,177,939
2575,3,1984,24,1,3,75,74,2544,570,1086,0.525,1,2,0.5,569,1084,0.525,303,424,0.715,130,239,369,136,71,60,188,253,1444
2575,4,1985,25,1,3,77,76,2816,679,1225,0.554,0,5,0,679,1220,0.557,409,521,0.785,158,277,435,135,58,38,178,185,1767
2575,5,1986,26,1,3,70,59,2248,540,1090,0.495,4,23,0.174,536,1067,0.502,364,462,0.788,150,200,350,213,49,47,174,186,1448
2575,6,1987,27,1,3,75,53,2638,556,1067,0.521,1,8,0.125,555,1059,0.524,438,564,0.777,118,249,367,261,54,86,213,243,1551
2575,7,1988,28,1,3,19,12,622,110,247,0.445,0,2,0,110,245,0.449,92,130,0.708,31,60,91,71,13,20,48,73,312
2575,8,1989,29,1,3,74,0,1491,231,494,0.468,0,1,0,231,493,0.469,253,343,0.738,81,189,270,58,30,65,103,130,715
2575,9,1990,30,1,3,62,2,1421,306,550,0.556,0,5,0,306,545,0.561,176,240,0.733,49,136,185,96,39,46,73,160,788
2575,10,1991,31,1,3,53,50,1823,490,983,0.498,0,4,0,490,979,0.501,350,439,0.797,141,220,361,119,69,23,152,145,1330
2575,11,1992,32,1,3,82,61,2113,452,907,0.498,1,9,0.111,451,898,0.502,241,353,0.683,109,151,260,88,41,33,133,154,1146
2575,12,1993,33,1,3,50,47,1477,271,566,0.479,0,9,0,271,557,0.487,113,168,0.673,84,92,176,112,26,25,73,114,655
2575,12,1993,33,1,3,58,47,1555,289,599,0.482,0,9,0,289,590,0.49,120,177,0.678,87,98,185,115,27,27,79,122,698
2575,13,1994,34,1,3,74,1,1955,364,773,0.471,1,14,0.071,363,759,0.478,208,302,0.689,103,195,298,139,41,56,142,186,937
2576,1,2006,21,1,2,7,0,135,21,51,0.412,6,17,0.353,15,34,0.441,14,16,0.875,3,15,18,5,1,0,8,8,62
2576,2,2007,22,1,2,19,0,190,24,60,0.4,6,20,0.3,18,40,0.45,13,18,0.722,7,14,21,15,9,1,6,6,67
2577,1,1987,24,1,4,14,0,138,20,46,0.435,0,1,0,20,45,0.444,12,28,0.429,25,28,53,1,3,6,13,20,52
2580,1,2008,20,1,3,57,1,640,90,169,0.533,10,24,0.417,80,145,0.552,33,52,0.635,33,84,117,40,29,12,34,43,223
2580,2,2009,21,1,3,54,19,772,109,234,0.466,2,21,0.095,107,213,0.502,17,30,0.567,46,106,152,43,35,19,43,49,237
2580,3,2010,22,1,3,68,14,871,116,232,0.5,2,6,0.333,114,226,0.504,25,41,0.61,58,86,144,41,29,18,44,45,259
2580,4,2011,23,1,3,52,6,766,82,160,0.513,2,10,0.2,80,150,0.533,22,43,0.512,47,71,118,58,39,20,43,45,188
2581,1,1980,25,1,1,76,-1,1286,229,500,0.458,4,16,0.25,225,484,0.465,96,108,0.889,40,82,122,222,49,18,108,144,558
2581,2,1981,26,1,1,45,-1,997,140,303,0.462,2,7,0.286,138,296,0.466,53,66,0.803,26,62,88,153,42,7,74,114,335
2584,1,1997,21,1,5,77,51,1936,236,491,0.481,1,4,0.25,235,487,0.483,88,150,0.587,206,265,471,49,48,60,79,211,561
2584,2,1998,22,1,5,69,38,2067,241,542,0.445,0,2,0,241,540,0.446,141,214,0.659,180,426,606,55,55,87,81,237,623
2584,3,1999,23,1,5,48,15,1135,119,260,0.458,0,1,0,119,259,0.459,81,117,0.692,142,219,361,33,26,36,48,162,319
2584,4,2000,24,1,5,75,0,1205,180,361,0.499,1,3,0.333,179,358,0.5,87,135,0.644,117,188,305,21,29,40,66,203,448
2584,5,2001,25,1,5,71,46,1988,363,811,0.448,0,2,0,363,809,0.449,155,216,0.718,180,355,535,87,42,63,125,232,881
2584,6,2002,26,1,5,43,33,1251,223,486,0.459,0,2,0,223,484,0.461,70,123,0.569,130,275,405,44,30,23,72,126,516
2584,7,2003,27,1,5,70,49,1982,325,716,0.454,0,5,0,325,711,0.457,147,223,0.659,170,358,528,80,51,54,110,209,797
2584,8,2004,28,1,5,65,46,1674,257,586,0.439,0,5,0,257,581,0.442,96,131,0.733,144,301,445,71,45,58,77,192,610
2584,9,2005,29,1,5,80,77,2287,320,683,0.469,0,3,0,320,680,0.471,131,198,0.662,177,436,613,87,58,69,100,251,771
2584,10,2006,30,1,5,78,58,1689,194,406,0.478,0,2,0,194,404,0.48,66,117,0.564,142,253,395,48,52,46,67,201,454
2584,11,2007,31,1,5,67,31,1035,82,183,0.448,0,0,-1,82,183,0.448,9,32,0.281,85,131,216,40,28,28,39,204,173
2584,12,2008,32,1,5,13,1,148,5,17,0.294,0,0,-1,5,17,0.294,3,6,0.5,7,30,37,3,3,3,2,26,13
2584,12,2008,32,1,5,18,1,161,6,21,0.286,0,0,-1,6,21,0.286,3,6,0.5,8,30,38,4,3,3,4,31,15
2584,13,2009,33,1,5,17,2,125,10,27,0.37,0,0,-1,10,27,0.37,3,8,0.375,7,18,25,3,4,5,9,17,23
2588,1,2003,21,1,2,59,39,1381,168,428,0.393,21,78,0.269,147,350,0.42,49,62,0.79,36,126,162,130,57,33,81,145,406
2591,1,1995,22,1,5,79,49,2044,361,776,0.465,0,8,0,361,768,0.47,182,282,0.645,191,281,472,48,37,104,151,246,904
2591,2,1996,23,1,5,11,6,298,65,128,0.508,1,3,0.333,64,125,0.512,50,73,0.685,24,33,57,11,6,10,28,38,181
2591,2,1996,23,1,5,46,32,1136,183,384,0.477,0,0,-1,183,384,0.477,117,186,0.629,124,175,299,27,24,39,81,125,483
2591,2,1996,23,1,5,57,38,1434,248,512,0.484,1,3,0.333,247,509,0.485,167,259,0.645,148,208,356,38,30,49,109,163,664
2591,3,1997,24,1,5,60,28,1009,161,403,0.4,0,1,0,161,402,0.4,68,133,0.511,79,107,186,28,15,50,93,146,390
2594,1,2000,23,1,5,25,0,137,13,39,0.333,0,0,-1,13,39,0.333,28,36,0.778,13,22,35,5,2,1,9,18,54
2600,1,2006,20,1,5,17,0,144,23,38,0.605,0,0,-1,23,38,0.605,1,6,0.167,19,17,36,2,2,7,2,25,47
2602,1,2001,27,1,5,43,12,598,39,99,0.394,0,0,-1,39,99,0.394,25,33,0.758,37,85,122,31,7,19,38,95,103
2604,1,1980,26,1,2,33,-1,225,36,94,0.383,2,6,0.333,34,88,0.386,11,19,0.579,11,15,26,20,16,5,17,29,85
2605,1,1989,23,1,1,21,7,368,60,151,0.397,0,2,0,60,149,0.403,24,32,0.75,11,23,34,43,22,5,20,37,144
2606,1,1980,28,1,1,78,-1,2754,418,895,0.467,90,239,0.377,328,656,0.5,130,162,0.802,76,112,188,335,147,25,141,246,1056
2606,2,1981,29,1,1,80,-1,2312,310,591,0.525,44,115,0.383,266,476,0.559,146,185,0.789,58,93,151,440,118,23,111,212,810
2606,3,1982,30,1,1,41,40,1274,165,328,0.503,23,63,0.365,142,265,0.536,90,110,0.818,26,70,96,229,47,9,82,113,443
2607,1,2006,23,1,2,51,1,465,53,136,0.39,4,17,0.235,49,119,0.412,30,43,0.698,16,37,53,45,30,4,34,47,140
2607,2,2007,24,1,2,47,1,369,56,140,0.4,3,17,0.176,53,123,0.431,11,21,0.524,14,39,53,45,17,3,25,34,126
2610,1,1990,22,1,2,17,0,114,21,52,0.404,3,13,0.231,18,39,0.462,6,9,0.667,5,6,11,5,5,3,10,9,51
2611,1,2009,23,1,1,51,5,771,110,267,0.412,13,40,0.325,97,227,0.427,56,81,0.691,22,65,87,106,36,0,73,84,289
2612,1,1998,23,1,3,12,0,108,13,37,0.351,1,2,0.5,12,35,0.343,11,16,0.688,4,9,13,1,3,2,8,22,38
2612,2,1999,24,1,3,36,9,724,82,198,0.414,26,68,0.382,56,130,0.431,17,23,0.739,30,71,101,24,28,17,34,97,207
2615,1,1983,22,1,2,31,0,321,37,102,0.363,0,0,-1,37,102,0.363,21,32,0.656,19,17,36,41,20,2,30,54,95
2616,1,1983,22,1,2,73,44,1708,332,776,0.428,10,29,0.345,322,747,0.431,87,125,0.696,74,120,194,150,53,18,137,171,761
2616,2,1984,23,1,2,68,0,616,148,315,0.47,7,27,0.259,141,288,0.49,37,44,0.841,28,50,78,63,13,4,62,81,340
2616,3,1985,24,1,2,19,3,344,73,135,0.541,2,4,0.5,71,131,0.542,25,35,0.714,22,21,43,14,13,5,14,34,173
2616,3,1985,24,1,2,21,3,349,74,137,0.54,2,4,0.5,72,133,0.541,25,35,0.714,22,21,43,14,13,5,15,36,175
2616,4,1986,25,1,2,82,52,2158,475,958,0.496,4,25,0.16,471,933,0.505,211,265,0.796,96,139,235,115,71,34,136,241,1165
2616,5,1987,26,1,2,82,0,1650,370,808,0.458,0,10,0,370,798,0.464,182,234,0.778,68,107,175,105,68,13,117,190,922
2616,6,1988,27,1,2,47,4,958,248,546,0.454,1,9,0.111,247,537,0.46,97,121,0.802,41,40,81,61,32,4,80,95,594
2616,7,1989,28,1,3,66,41,1569,409,859,0.476,2,12,0.167,407,847,0.481,182,225,0.809,110,153,263,96,79,17,116,173,1002
2616,8,1990,29,1,3,82,49,2376,538,1122,0.48,3,14,0.214,535,1108,0.483,244,294,0.83,114,253,367,155,91,15,144,231,1323
2616,9,1991,30,1,2,82,0,1498,335,757,0.443,0,9,0,335,748,0.448,145,177,0.819,82,99,181,82,31,8,83,165,815
2616,10,1992,31,1,2,82,0,1602,364,805,0.452,1,4,0.25,363,801,0.453,151,197,0.766,91,92,183,113,66,9,114,148,880
2619,1,1981,24,1,2,26,-1,504,80,160,0.5,0,6,0,80,154,0.519,28,42,0.667,43,73,116,70,27,13,57,68,188
2619,2,1983,26,1,2,55,3,514,39,106,0.368,0,2,0,39,104,0.375,10,15,0.667,27,72,99,46,24,13,20,79,88
2623,1,1980,22,1,2,82,-1,3029,566,1172,0.483,28,105,0.267,538,1067,0.504,500,597,0.838,143,186,329,515,114,20,348,262,1660
2623,2,1981,23,1,2,82,-1,2820,543,1097,0.495,18,90,0.2,525,1007,0.521,445,550,0.809,124,163,287,426,122,20,259,258,1549
2623,3,1982,24,1,2,82,82,2838,560,1194,0.469,25,100,0.25,535,1094,0.489,363,449,0.808,115,197,312,476,87,16,277,243,1508
2623,4,1983,25,1,1,82,81,2856,749,1567,0.478,21,91,0.231,728,1476,0.493,434,542,0.801,91,209,300,484,143,17,321,281,1953
2623,5,1984,26,1,1,31,5,601,92,237,0.388,3,15,0.2,89,222,0.401,84,108,0.778,21,25,46,142,21,3,59,78,271
2623,5,1984,26,1,1,30,30,897,170,388,0.438,4,27,0.148,166,361,0.46,130,173,0.751,29,54,83,210,29,9,97,93,474
2623,5,1984,26,1,1,61,35,1498,262,625,0.419,7,42,0.167,255,583,0.437,214,281,0.762,50,79,129,352,50,12,156,171,745
2623,6,1985,27,1,2,82,80,2543,501,1029,0.487,5,38,0.132,496,991,0.501,334,387,0.863,106,164,270,656,95,18,307,250,1341
2623,7,1986,28,1,2,82,82,2919,546,1137,0.48,6,35,0.171,540,1102,0.49,405,490,0.827,73,231,304,788,112,20,327,231,1503
2623,8,1987,29,1,1,79,76,2872,577,1223,0.472,17,78,0.218,560,1145,0.489,429,495,0.867,86,180,266,692,78,16,289,208,1600
2623,9,1988,30,1,2,73,73,2653,619,1318,0.47,16,59,0.271,603,1259,0.479,320,385,0.831,72,160,232,463,59,16,234,173,1574
2623,10,1989,31,1,2,82,82,2517,497,1067,0.466,17,58,0.293,480,1009,0.476,285,335,0.851,86,156,242,387,108,16,194,236,1296
2623,11,1990,32,1,2,76,71,2350,517,1178,0.439,26,105,0.248,491,1073,0.458,378,443,0.853,75,146,221,407,60,12,226,194,1438
2623,12,1991,33,1,2,81,81,2955,583,1247,0.468,52,144,0.361,531,1103,0.481,292,343,0.851,69,160,229,378,85,35,252,231,1510
2624,1,1985,23,1,3,51,1,461,94,195,0.482,0,2,0,94,193,0.487,43,67,0.642,29,40,69,17,11,17,34,85,231
2624,2,1986,24,1,3,42,8,531,100,233,0.429,2,5,0.4,98,228,0.43,29,48,0.604,28,47,75,28,23,15,39,82,231
2626,1,1992,22,1,2,36,0,156,18,51,0.353,2,17,0.118,16,34,0.471,10,15,0.667,6,16,22,22,4,1,17,20,48
2627,1,1991,25,1,4,26,0,108,17,50,0.34,0,0,-1,17,50,0.34,12,21,0.571,14,17,31,10,4,1,13,24,46
2629,1,1983,22,1,3,49,2,521,74,170,0.435,1,7,0.143,73,163,0.448,45,78,0.577,28,44,72,36,19,4,48,93,194
2629,2,1984,23,1,3,46,0,291,31,72,0.431,0,1,0,31,71,0.437,15,31,0.484,9,22,31,27,10,3,19,44,77
2629,3,1985,24,1,3,10,1,115,12,23,0.522,0,1,0,12,22,0.545,5,11,0.455,4,4,8,1,3,2,12,16,29
2629,3,1985,24,1,3,18,3,183,20,38,0.526,0,1,0,20,37,0.541,11,19,0.579,10,7,17,4,5,3,14,22,51
2629,4,1986,25,1,4,49,0,385,54,110,0.491,0,1,0,54,109,0.495,55,88,0.625,27,43,70,15,11,3,19,55,163
2630,1,2005,24,1,4,9,2,112,11,18,0.611,0,0,-1,11,18,0.611,2,6,0.333,15,20,35,4,4,4,7,12,24
2630,1,2005,24,1,4,11,2,117,12,20,0.6,0,0,-1,12,20,0.6,2,6,0.333,17,20,37,4,4,4,7,13,26
2630,2,2006,25,1,4,15,0,124,7,13,0.538,0,0,-1,7,13,0.538,8,14,0.571,8,23,31,1,0,3,7,32,22
2630,2,2006,25,1,4,22,0,150,10,19,0.526,0,0,-1,10,19,0.526,8,14,0.571,12,27,39,1,0,3,7,35,28
2631,1,1982,20,1,1,72,72,2433,453,1068,0.424,17,59,0.288,436,1009,0.432,302,429,0.704,57,152,209,565,150,17,299,253,1225
2631,2,1983,21,1,1,81,81,3093,725,1537,0.472,36,125,0.288,689,1412,0.488,368,518,0.71,105,223,328,634,199,29,326,318,1854
2631,3,1984,22,1,1,82,82,3007,669,1448,0.462,22,65,0.338,647,1383,0.468,388,529,0.733,103,224,327,914,204,33,307,324,1748
2631,4,1985,23,1,1,81,81,3089,646,1410,0.458,29,113,0.257,617,1297,0.476,399,493,0.809,114,247,361,1123,187,25,302,288,1720
2631,5,1986,24,1,1,77,77,2790,609,1248,0.488,26,84,0.31,583,1164,0.501,365,462,0.79,83,194,277,830,171,20,289,245,1609
2631,6,1987,25,1,1,81,81,3013,626,1353,0.463,19,98,0.194,607,1255,0.484,400,521,0.768,82,237,319,813,153,20,343,251,1671
2631,7,1988,26,1,1,81,81,2927,621,1341,0.463,30,97,0.309,591,1244,0.475,305,394,0.774,64,214,278,678,141,17,273,217,1577
2631,8,1989,27,1,1,80,76,2924,569,1227,0.464,33,121,0.273,536,1106,0.485,287,351,0.818,49,224,273,663,133,20,298,209,1458
2631,9,1990,28,1,1,81,81,2993,579,1322,0.438,42,136,0.309,537,1186,0.453,292,377,0.775,74,234,308,765,139,19,322,206,1492
2631,10,1991,29,1,1,48,46,1657,289,665,0.435,19,65,0.292,270,600,0.45,179,229,0.782,35,125,160,446,75,10,185,118,776
2631,11,1992,30,1,1,78,78,2918,564,1264,0.446,25,86,0.291,539,1178,0.458,292,378,0.772,68,179,247,560,118,15,252,194,1445
2631,12,1993,31,1,1,79,79,2922,526,1258,0.418,61,198,0.308,465,1060,0.439,278,377,0.737,71,161,232,671,123,18,284,222,1391
2631,13,1994,32,1,1,58,56,1750,318,763,0.417,39,126,0.31,279,637,0.438,181,258,0.702,46,113,159,399,68,6,202,126,856
2633,1,2000,22,1,4,72,29,1797,212,531,0.399,32,122,0.262,180,409,0.44,138,209,0.66,147,290,437,113,54,22,112,167,594
2633,2,2001,23,1,4,74,21,1820,206,465,0.443,25,92,0.272,181,373,0.485,91,126,0.722,122,295,417,77,40,43,116,178,528
2633,3,2002,24,1,4,72,71,2484,396,829,0.478,0,16,0,396,813,0.487,223,336,0.664,158,358,516,137,85,66,143,195,1015
2633,4,2003,25,1,4,20,14,586,82,190,0.432,0,0,-1,82,190,0.432,33,45,0.733,45,92,137,39,16,6,40,49,197
2633,4,2003,25,1,4,46,28,1392,178,369,0.482,0,0,-1,178,369,0.482,114,152,0.75,140,252,392,73,46,22,76,120,470
2633,4,2003,25,1,4,66,42,1978,260,559,0.465,0,0,-1,260,559,0.465,147,197,0.746,185,344,529,112,62,28,116,169,667
2633,5,2004,26,1,4,74,72,2699,381,813,0.469,1,5,0.2,380,808,0.47,243,323,0.752,261,489,750,111,82,33,172,219,1006
2633,6,2005,27,1,4,26,15,823,150,305,0.492,0,1,0,150,304,0.493,78,108,0.722,78,149,227,75,27,11,48,76,378
2633,6,2005,27,1,4,47,43,1344,217,476,0.456,1,4,0.25,216,472,0.458,95,119,0.798,106,202,308,77,40,6,83,151,530
2633,6,2005,27,1,4,73,58,2167,367,781,0.47,1,5,0.2,366,776,0.472,173,227,0.762,184,351,535,152,67,17,131,227,908
2633,7,2006,28,1,4,82,55,2293,305,604,0.505,0,1,0,305,603,0.506,138,204,0.676,199,419,618,168,72,39,135,196,748
2633,8,2007,29,1,4,62,53,1412,146,303,0.482,0,1,0,146,302,0.483,39,76,0.513,134,243,377,76,43,16,90,141,331
2633,9,2008,30,1,4,23,3,281,16,38,0.421,0,0,-1,16,38,0.421,0,5,0,18,43,61,13,6,1,21,38,32
2633,10,2010,32,1,4,26,2,313,17,35,0.486,0,0,-1,17,35,0.486,7,12,0.583,35,51,86,15,10,10,17,42,41
2634,1,1996,23,1,4,74,42,1655,274,547,0.501,0,2,0,274,545,0.503,118,178,0.663,122,317,439,46,47,36,98,271,666
2634,2,1997,24,1,4,18,9,374,39,105,0.371,0,1,0,39,104,0.375,35,46,0.761,31,76,107,9,12,9,25,67,113
2634,3,1999,26,1,4,50,44,1182,170,368,0.462,0,1,0,170,367,0.463,66,108,0.611,82,204,286,55,45,17,73,159,406
2634,4,2000,27,1,4,80,21,1971,270,535,0.505,1,3,0.333,269,532,0.506,100,128,0.781,144,361,505,82,51,42,105,278,641
2634,5,2001,28,1,4,77,29,2125,314,614,0.511,1,3,0.333,313,611,0.512,171,210,0.814,172,343,515,63,61,69,99,287,800
2634,6,2002,29,1,5,82,82,2771,463,938,0.494,1,6,0.167,462,932,0.496,216,265,0.815,214,533,747,87,71,79,153,341,1143
2634,7,2003,30,1,5,81,81,2577,497,1028,0.483,2,3,0.667,495,1025,0.483,138,184,0.75,160,477,637,162,81,97,138,344,1134
2634,8,2004,31,1,4,80,75,2548,392,829,0.473,0,3,0,392,826,0.475,106,127,0.835,145,517,662,149,56,80,132,298,890
2634,9,2005,32,1,4,80,80,2855,424,901,0.471,2,4,0.5,422,897,0.47,66,84,0.786,170,661,831,160,70,79,99,310,916
2634,10,2006,33,1,5,53,50,1411,190,391,0.486,0,0,-1,190,391,0.486,75,92,0.815,102,313,415,57,23,54,57,193,455
2634,11,2007,34,1,5,67,13,1208,126,259,0.486,0,1,0,126,258,0.488,56,71,0.789,86,293,379,24,24,29,35,156,308
2634,12,2008,35,1,4,28,9,524,56,125,0.448,0,1,0,56,124,0.452,14,24,0.583,36,102,138,14,21,14,18,57,126
2634,12,2008,35,1,5,42,39,1060,139,271,0.513,0,0,-1,139,271,0.513,39,56,0.696,94,275,369,53,35,43,28,131,317
2634,12,2008,35,1,5,70,48,1584,195,396,0.492,0,1,0,195,395,0.494,53,80,0.663,130,377,507,67,56,57,46,188,443
2634,13,2009,36,1,4,79,10,1404,153,304,0.503,0,2,0,153,302,0.507,37,45,0.822,134,271,405,66,34,58,42,170,343
2634,14,2010,37,1,5,70,9,1049,99,208,0.476,0,0,-1,99,208,0.476,12,15,0.8,84,207,291,47,26,46,48,159,210
2634,15,2011,38,1,4,52,37,1178,95,186,0.511,1,1,1,94,185,0.508,20,32,0.625,75,226,301,60,32,42,42,164,211
2634,16,2012,39,1,5,53,3,803,73,157,0.465,0,0,-1,73,157,0.465,14,20,0.7,39,149,188,46,24,31,31,123,160
2634,17,2013,40,1,4,39,17,392,45,83,0.542,1,1,1,44,82,0.537,6,13,0.462,24,65,89,21,10,16,8,52,97
2638,1,2012,21,1,5,24,0,119,24,61,0.393,4,13,0.308,20,48,0.417,5,7,0.714,4,20,24,3,3,3,6,10,57
2639,1,1983,22,1,4,44,2,520,43,137,0.314,0,0,-1,43,137,0.314,36,46,0.783,41,79,120,34,12,7,31,92,122
2640,1,1985,22,1,3,59,0,535,79,212,0.373,0,8,0,79,204,0.387,39,51,0.765,37,39,76,52,31,10,35,79,197
2640,2,1986,23,1,2,61,20,1281,195,399,0.489,0,2,0,195,397,0.491,127,157,0.809,58,83,141,132,51,10,90,151,517
2640,3,1987,24,1,3,24,2,331,42,105,0.4,0,3,0,42,102,0.412,27,33,0.818,20,11,31,18,11,5,16,53,111
2640,4,1988,25,1,3,37,7,566,74,159,0.465,0,2,0,74,157,0.471,43,60,0.717,40,36,76,51,21,1,21,75,191
2640,5,1989,26,1,4,23,0,222,20,59,0.339,0,2,0,20,57,0.351,22,26,0.846,9,19,28,13,13,1,19,33,62
2642,1,1998,20,1,3,77,48,1779,306,684,0.447,62,171,0.363,244,513,0.476,171,231,0.74,107,181,288,90,54,17,118,185,845
2642,2,1999,21,1,3,17,0,188,27,67,0.403,5,19,0.263,22,48,0.458,19,24,0.792,7,26,33,15,3,3,15,21,78
2642,2,1999,21,1,3,33,26,624,105,212,0.495,16,49,0.327,89,163,0.546,54,88,0.614,42,51,93,31,23,9,31,86,280
2642,2,1999,21,1,3,50,26,812,132,279,0.473,21,68,0.309,111,211,0.526,73,112,0.652,49,77,126,46,26,12,46,107,358
2642,3,2000,22,1,3,80,1,2093,347,753,0.461,63,182,0.346,284,571,0.497,188,243,0.774,100,232,332,113,59,31,129,227,945
2642,4,2001,23,1,4,76,16,2086,326,758,0.43,107,260,0.412,219,498,0.44,195,253,0.771,79,234,313,138,78,45,114,194,954
2642,5,2002,24,1,3,74,22,1987,316,753,0.42,95,291,0.326,221,462,0.478,142,179,0.793,64,236,300,105,65,32,127,200,869
2642,6,2003,25,1,3,80,70,2358,412,930,0.443,97,265,0.366,315,665,0.474,145,186,0.78,97,292,389,102,70,49,133,257,1066
2642,7,2004,26,1,3,24,23,746,137,303,0.452,26,64,0.406,111,239,0.464,78,96,0.813,26,89,115,34,24,5,43,69,378
2642,7,2004,26,1,3,42,42,1343,226,510,0.443,47,130,0.362,179,380,0.471,93,122,0.762,38,167,205,90,40,15,73,127,592
2642,7,2004,26,1,3,66,65,2089,363,813,0.446,73,194,0.376,290,619,0.468,171,218,0.784,64,256,320,124,64,20,116,196,970
2642,8,2005,27,1,3,71,68,1940,315,718,0.439,85,208,0.409,230,510,0.451,136,173,0.786,45,192,237,110,41,17,113,222,851
2642,9,2006,28,1,4,26,10,634,107,246,0.435,45,105,0.429,62,141,0.44,28,42,0.667,22,105,127,18,16,6,32,77,287
2642,9,2006,28,1,4,29,10,666,113,262,0.431,46,111,0.414,67,151,0.444,28,42,0.667,22,109,131,20,16,7,33,78,300
2642,10,2007,29,1,4,76,24,2054,299,723,0.414,136,356,0.382,163,367,0.444,102,144,0.708,63,315,378,171,55,28,106,228,836
2642,11,2008,30,1,4,63,51,1940,291,705,0.413,83,271,0.306,208,434,0.479,115,153,0.752,62,261,323,171,40,29,98,192,780
2642,12,2009,31,1,4,10,5,220,34,90,0.378,6,20,0.3,28,70,0.4,21,34,0.618,14,32,46,10,3,1,14,26,95
2642,12,2009,31,1,4,18,0,254,36,90,0.4,19,43,0.442,17,47,0.362,14,20,0.7,8,34,42,12,6,0,10,27,105
2642,12,2009,31,1,4,36,1,773,119,258,0.461,53,126,0.421,66,132,0.5,54,67,0.806,20,93,113,46,22,10,46,91,345
2642,12,2009,31,1,4,64,6,1247,189,438,0.432,78,189,0.413,111,249,0.446,89,121,0.736,42,159,201,68,31,11,70,144,545
2642,13,2010,32,1,3,18,1,285,49,106,0.462,16,43,0.372,33,63,0.524,21,24,0.875,13,28,41,14,10,2,14,31,135
2643,1,1980,25,1,2,39,-1,1239,289,617,0.468,7,19,0.368,282,598,0.472,254,335,0.758,56,118,174,124,39,38,116,106,839
2643,2,1981,26,1,2,77,-1,2620,734,1451,0.506,10,39,0.256,724,1412,0.513,489,615,0.795,107,180,287,231,53,60,250,231,1967
2643,3,1982,27,1,2,61,5,1246,313,644,0.486,4,14,0.286,309,630,0.49,276,339,0.814,57,91,148,117,34,29,142,149,906
2643,4,1983,28,1,2,75,64,2155,445,925,0.481,2,10,0.2,443,915,0.484,298,380,0.784,96,174,270,222,47,33,163,142,1190
2643,5,1984,29,1,2,19,0,349,89,165,0.539,0,1,0,89,164,0.543,62,73,0.849,18,26,44,13,10,13,27,30,240
2644,1,1987,23,1,3,59,0,762,142,261,0.544,0,1,0,142,260,0.546,48,74,0.649,69,102,171,60,15,30,61,148,332
2644,2,1989,25,1,3,79,58,2273,349,716,0.487,0,4,0,349,712,0.49,156,224,0.696,241,331,572,176,56,105,189,260,854
2644,3,1990,26,1,3,79,45,2142,375,727,0.516,2,4,0.5,373,723,0.516,115,185,0.622,238,313,551,166,54,89,156,237,867
2644,4,1991,27,1,3,73,46,1481,205,411,0.499,0,4,0,205,407,0.504,89,124,0.718,120,192,312,111,32,48,117,161,499
2645,1,1995,24,1,1,38,2,246,45,114,0.395,18,58,0.31,27,56,0.482,8,12,0.667,7,16,23,43,10,2,27,46,116
2645,2,1996,25,1,1,33,0,246,48,103,0.466,25,64,0.391,23,39,0.59,19,27,0.704,4,20,24,31,12,0,24,35,140
2645,3,1997,26,1,1,65,6,1047,162,405,0.4,97,244,0.398,65,161,0.404,24,38,0.632,18,78,96,179,55,2,86,125,445
2645,3,1997,26,1,1,67,6,1055,162,406,0.399,97,244,0.398,65,162,0.401,24,38,0.632,18,78,96,180,55,2,87,126,445
2645,4,1998,27,1,1,17,0,121,13,29,0.448,4,14,0.286,9,15,0.6,3,5,0.6,0,10,10,24,6,1,11,16,33
2645,4,1998,27,1,1,30,0,167,23,56,0.411,9,30,0.3,14,26,0.538,4,8,0.5,1,14,15,27,10,1,16,22,59
2650,1,1983,21,1,5,71,3,987,147,287,0.512,0,1,0,147,286,0.514,89,137,0.65,133,242,375,33,40,61,96,186,383
2650,2,1984,22,1,5,80,38,1915,333,637,0.523,0,0,-1,333,637,0.523,160,223,0.717,260,449,709,86,71,145,168,327,826
2650,3,1985,23,1,5,82,77,2458,369,695,0.531,0,0,-1,369,695,0.531,227,315,0.721,274,580,854,130,98,128,202,328,965
2650,4,1986,24,1,5,80,64,2377,411,794,0.518,0,1,0,411,793,0.518,202,276,0.732,252,518,770,168,71,109,184,295,1024
2650,5,1987,25,1,5,82,53,2166,362,752,0.481,0,5,0,362,747,0.485,188,255,0.737,237,450,687,122,69,126,143,290,912
2650,6,1988,26,1,5,69,9,1257,215,456,0.471,2,5,0.4,213,451,0.472,118,164,0.72,138,289,427,68,54,73,109,217,550
2650,7,1989,27,1,5,33,29,1053,169,314,0.538,0,0,-1,169,314,0.538,75,93,0.806,104,222,326,37,33,39,62,132,413
2650,7,1989,27,1,5,43,42,1276,247,536,0.461,0,1,0,247,535,0.462,152,188,0.809,120,272,392,44,46,55,117,153,646
2650,7,1989,27,1,5,76,71,2329,416,850,0.489,0,1,0,416,849,0.49,227,281,0.808,224,494,718,81,79,94,179,285,1059
2650,8,1990,28,1,5,82,60,2126,223,471,0.473,1,5,0.2,222,466,0.476,107,134,0.799,175,455,630,106,65,71,150,313,554
2650,9,1991,29,1,5,82,77,1946,276,565,0.488,1,5,0.2,275,560,0.491,72,104,0.692,154,409,563,147,63,63,168,265,625
2650,10,1992,30,1,5,80,49,1299,168,359,0.468,0,2,0,168,357,0.471,58,71,0.817,98,283,381,102,52,34,98,207,394
2650,11,1993,31,1,5,63,0,730,104,213,0.488,0,1,0,104,212,0.491,29,39,0.744,55,123,178,34,29,24,47,137,237
2650,12,1994,32,1,5,30,1,282,27,77,0.351,0,0,-1,27,77,0.351,16,30,0.533,26,49,75,16,10,8,23,59,70
2650,13,1995,33,1,5,38,3,453,49,118,0.415,0,0,-1,49,118,0.415,14,16,0.875,28,61,89,18,18,10,33,76,112
2650,14,1996,34,1,5,44,11,773,33,83,0.398,0,0,-1,33,83,0.398,19,24,0.792,62,137,199,26,19,20,37,125,85
2650,15,1997,35,1,5,17,0,105,3,16,0.188,0,0,-1,3,16,0.188,1,2,0.5,5,21,26,0,3,6,7,26,7
2650,15,1997,35,1,5,26,0,140,3,19,0.158,0,0,-1,3,19,0.158,4,6,0.667,7,27,34,2,3,6,9,33,10
2652,1,1984,22,1,3,82,10,1731,309,662,0.467,9,39,0.231,300,623,0.482,115,149,0.772,120,192,312,122,70,37,73,192,742
2652,2,1985,23,1,3,16,0,227,41,105,0.39,0,7,0,41,98,0.418,24,34,0.706,21,21,42,20,15,5,15,42,106
2652,2,1985,23,1,3,33,27,715,148,354,0.418,6,23,0.261,142,331,0.429,45,53,0.849,36,80,116,58,41,20,42,77,347
2652,2,1985,23,1,3,49,27,942,189,459,0.412,6,30,0.2,183,429,0.427,69,87,0.793,57,101,158,78,56,25,57,119,453
2652,3,1986,24,1,3,23,8,432,70,194,0.361,2,12,0.167,68,182,0.374,37,43,0.86,27,36,63,24,15,17,30,49,179
2656,1,2008,24,1,4,79,31,2158,374,871,0.429,43,130,0.331,331,741,0.447,214,288,0.743,98,260,358,98,46,43,128,195,1005
2656,2,2009,25,1,3,71,67,2654,469,1051,0.446,20,79,0.253,449,972,0.462,236,313,0.754,122,246,368,103,59,62,130,227,1194
2656,3,2010,26,1,3,24,16,674,100,216,0.463,6,17,0.353,94,199,0.472,50,72,0.694,31,71,102,29,20,13,36,62,256
2656,3,2010,26,1,3,51,30,1405,220,460,0.478,5,14,0.357,215,446,0.482,103,139,0.741,85,107,192,61,25,22,66,144,548
2656,3,2010,26,1,3,75,46,2079,320,676,0.473,11,31,0.355,309,645,0.479,153,211,0.725,116,178,294,90,45,35,102,206,804
2656,4,2011,27,1,4,22,0,314,51,104,0.49,0,1,0,51,103,0.495,29,35,0.829,10,47,57,11,7,3,20,40,131
2656,4,2011,27,1,3,49,23,1069,154,327,0.471,4,25,0.16,150,302,0.497,81,107,0.757,46,110,156,51,28,9,44,103,393
2656,4,2011,27,1,3,71,23,1383,205,431,0.476,4,26,0.154,201,405,0.496,110,142,0.775,56,157,213,62,35,12,64,143,524
2660,1,1983,22,1,5,37,4,482,69,158,0.437,0,0,-1,69,158,0.437,14,22,0.636,37,84,121,16,8,28,18,68,152
2660,1,1983,22,1,5,52,4,526,76,181,0.42,0,1,0,76,180,0.422,16,28,0.571,41,89,130,18,8,30,22,76,168
2660,2,1984,23,1,5,72,1,730,108,254,0.425,0,2,0,108,252,0.429,41,63,0.651,75,109,184,24,12,60,51,176,257
2664,1,1985,22,1,4,82,23,1918,411,685,0.6,0,2,0,411,683,0.602,230,371,0.62,187,369,556,111,34,37,187,256,1052
2664,2,1986,23,1,4,75,18,1675,289,492,0.587,0,0,-1,289,492,0.587,164,248,0.661,137,283,420,84,35,34,123,233,742
2664,3,1987,24,1,4,82,82,2956,567,1050,0.54,0,3,0,567,1047,0.542,413,543,0.761,259,560,819,201,46,60,189,292,1547
2664,4,1988,25,1,4,82,82,3072,622,1226,0.507,0,6,0,622,1220,0.51,460,609,0.755,279,558,837,266,62,56,228,264,1704
2664,5,1989,26,1,4,82,82,3135,521,961,0.542,0,2,0,521,959,0.543,328,450,0.729,272,515,787,202,82,37,225,259,1370
2664,6,1990,27,1,4,82,82,2947,547,998,0.548,0,10,0,547,988,0.554,307,446,0.688,258,476,734,261,66,24,229,270,1401
2664,7,1991,28,1,4,82,82,3039,549,988,0.556,3,7,0.429,546,981,0.557,334,480,0.696,287,559,846,197,73,20,217,278,1435
2664,8,1992,29,1,4,82,82,3056,558,943,0.592,0,7,0,558,936,0.596,304,463,0.657,285,577,862,250,52,37,237,307,1420
2664,9,1993,30,1,4,72,69,2357,385,690,0.558,0,2,0,385,688,0.56,153,256,0.598,219,370,589,181,43,19,151,234,923
2664,10,1994,31,1,4,82,82,2909,449,801,0.561,0,2,0,449,799,0.562,251,382,0.657,271,599,870,189,66,28,185,253,1149
2664,11,1995,32,1,4,34,0,908,179,315,0.568,0,4,0,179,311,0.576,100,154,0.649,89,147,236,54,19,15,56,122,458
2664,11,1995,32,1,4,36,35,1188,206,366,0.563,0,3,0,206,363,0.567,67,127,0.528,113,209,322,58,22,13,76,102,479
2664,11,1995,32,1,4,70,35,2096,385,681,0.565,0,7,0,385,674,0.571,167,281,0.594,202,356,558,112,41,28,132,224,937
2664,12,1996,33,1,4,82,82,2841,452,853,0.53,0,4,0,452,849,0.532,257,362,0.71,211,477,688,158,53,39,195,300,1161
2664,13,1997,34,1,5,79,79,2661,419,787,0.532,0,2,0,419,785,0.534,198,303,0.653,226,396,622,133,59,17,145,298,1036
2664,14,1998,35,1,4,27,20,623,89,194,0.459,0,1,0,89,193,0.461,46,70,0.657,51,115,166,61,18,7,37,80,224
2664,14,1998,35,1,4,47,46,1574,205,430,0.477,0,4,0,205,426,0.481,118,170,0.694,100,271,371,161,30,23,115,158,528
2664,14,1998,35,1,4,74,66,2197,294,624,0.471,0,5,0,294,619,0.475,164,240,0.683,151,386,537,222,48,30,152,238,752
2664,15,1999,36,1,4,49,38,1539,240,440,0.545,0,2,0,240,438,0.548,74,106,0.698,96,238,334,101,42,19,88,196,554
2664,16,2000,37,1,4,51,1,777,125,243,0.514,0,3,0,125,240,0.521,29,48,0.604,56,110,166,33,26,9,59,136,279
2664,17,2001,38,1,4,49,4,647,59,131,0.45,0,0,-1,59,131,0.45,20,24,0.833,50,95,145,29,12,7,32,108,138
2665,1,1986,21,1,4,81,60,2277,516,1002,0.515,0,2,0,516,1000,0.516,160,234,0.684,191,393,584,79,32,44,188,290,1192
2665,2,1987,22,1,4,81,15,2159,458,892,0.513,0,2,0,458,890,0.515,258,364,0.709,217,258,475,117,50,26,139,293,1174
2665,3,1988,23,1,4,79,57,2378,511,998,0.512,0,2,0,511,996,0.513,246,314,0.783,168,323,491,103,54,34,145,274,1268
2665,4,1989,24,1,4,31,30,1108,247,472,0.523,0,0,-1,247,472,0.523,119,160,0.744,88,211,299,53,20,20,65,109,613
2665,4,1989,24,1,4,48,5,1326,285,564,0.505,0,4,0,285,560,0.509,198,250,0.792,99,211,310,75,35,32,107,181,768
2665,4,1989,24,1,4,79,35,2434,532,1036,0.514,0,4,0,532,1032,0.516,317,410,0.773,187,422,609,128,55,52,172,290,1381
2665,5,1990,25,1,4,79,79,2937,726,1383,0.525,0,6,0,726,1377,0.527,306,391,0.783,185,410,595,108,54,54,153,251,1758
2665,6,1991,26,1,4,33,31,1116,262,542,0.483,0,1,0,262,541,0.484,136,170,0.8,75,178,253,66,23,28,82,99,660
2665,7,1992,27,1,4,72,71,2521,522,1043,0.5,0,2,0,522,1041,0.501,151,198,0.763,135,334,469,106,55,79,124,248,1195
2665,8,1993,28,1,4,76,75,2283,544,1068,0.509,0,2,0,544,1066,0.51,175,231,0.758,127,373,500,108,52,47,117,277,1263
2665,9,1994,29,1,4,79,77,2557,552,1102,0.501,0,0,-1,552,1102,0.501,215,266,0.808,159,401,560,139,37,52,124,290,1319
2665,10,1995,30,1,4,65,13,1276,278,574,0.484,0,0,-1,278,574,0.484,94,122,0.77,83,164,247,45,29,27,64,190,650
2665,11,1996,31,1,4,63,6,1152,279,564,0.495,0,0,-1,279,564,0.495,114,149,0.765,55,159,214,58,15,36,63,188,672
2665,12,1997,32,1,4,53,15,778,158,371,0.426,0,0,-1,158,371,0.426,30,48,0.625,35,85,120,20,8,21,36,111,346
2666,1,1984,22,1,1,45,0,464,62,148,0.419,1,8,0.125,61,140,0.436,23,28,0.821,17,23,40,41,13,2,33,65,148
2666,2,1985,23,1,1,82,0,1304,188,416,0.452,4,22,0.182,184,394,0.467,66,90,0.733,21,78,99,175,80,16,99,171,446
2666,3,1986,24,1,2,70,27,1754,310,684,0.453,1,24,0.042,309,660,0.468,75,90,0.833,21,100,121,193,93,5,102,157,696
2666,4,1987,25,1,1,28,8,668,108,261,0.414,7,16,0.438,101,245,0.412,42,53,0.792,18,39,57,82,32,4,47,76,265
2666,4,1987,25,1,1,40,0,778,131,273,0.48,0,16,0,131,257,0.51,53,66,0.803,8,43,51,177,42,9,42,88,315
2666,4,1987,25,1,1,68,8,1446,239,534,0.448,7,32,0.219,232,502,0.462,95,119,0.798,26,82,108,259,74,13,89,164,580
2666,5,1988,26,1,1,26,0,354,84,162,0.519,1,7,0.143,83,155,0.535,25,30,0.833,11,22,33,53,33,5,19,29,194
2666,5,1988,26,1,1,45,0,701,132,263,0.502,2,20,0.1,130,243,0.535,32,41,0.78,12,43,55,107,27,3,44,71,298
2666,5,1988,26,1,1,71,0,1055,216,425,0.508,3,27,0.111,213,398,0.535,57,71,0.803,23,65,88,160,60,8,63,100,492
2666,6,1989,27,1,1,63,0,1220,235,476,0.494,11,30,0.367,224,446,0.502,63,77,0.818,31,86,117,238,83,4,77,155,544
2666,7,1990,28,1,1,65,18,1481,303,599,0.506,8,32,0.25,295,567,0.52,130,157,0.828,43,72,115,216,65,8,77,164,744
2666,8,1991,29,1,1,80,57,2066,433,835,0.519,10,35,0.286,423,800,0.529,137,173,0.792,25,74,99,273,113,8,138,191,1013
2666,9,1992,30,1,1,82,82,3070,509,1041,0.489,20,62,0.323,489,979,0.499,202,243,0.831,43,210,253,593,168,16,182,231,1240
2666,10,1993,31,1,1,82,82,2893,522,1028,0.508,14,53,0.264,508,975,0.521,177,215,0.823,47,226,273,564,142,11,173,248,1235
2666,11,1994,32,1,1,81,20,2278,411,852,0.482,5,33,0.152,406,819,0.496,138,155,0.89,28,125,153,344,110,19,106,186,965
2666,12,1995,33,1,1,59,2,1384,217,437,0.497,36,95,0.379,181,342,0.529,88,111,0.793,21,103,124,248,54,12,70,139,558
2666,13,1996,34,1,1,82,8,1687,241,526,0.458,60,169,0.355,181,357,0.507,54,71,0.761,20,75,95,269,68,11,74,178,596
2666,14,1997,35,1,2,21,0,334,28,74,0.378,8,20,0.4,20,54,0.37,6,8,0.75,5,19,24,40,15,3,13,29,70
2668,1,1989,23,1,3,14,0,117,17,37,0.459,0,3,0,17,34,0.5,6,12,0.5,7,14,21,7,2,4,2,20,40
2668,2,1990,24,1,4,70,21,1347,218,442,0.493,5,18,0.278,213,424,0.502,175,241,0.726,122,241,363,58,23,25,79,191,616
2668,3,1991,25,1,4,62,32,1371,183,433,0.423,7,21,0.333,176,412,0.427,127,172,0.738,87,188,275,76,35,38,80,195,500
2668,4,1992,26,1,4,35,0,310,33,86,0.384,2,8,0.25,31,78,0.397,22,40,0.55,14,41,55,21,10,6,20,73,90
2668,5,1993,27,1,4,72,61,1838,226,454,0.498,9,28,0.321,217,426,0.509,122,168,0.726,133,279,412,91,33,21,124,192,583
2668,6,1994,28,1,3,49,6,640,74,177,0.418,6,16,0.375,68,161,0.422,33,45,0.733,36,72,108,30,13,15,39,61,187
2669,1,1980,31,1,4,62,-1,1834,370,778,0.476,22,79,0.278,348,699,0.498,118,147,0.803,132,226,358,109,32,10,98,161,880
2669,2,1981,32,1,4,52,-1,1264,263,563,0.467,12,51,0.235,251,512,0.49,65,82,0.793,78,130,208,81,19,6,58,121,603
2670,1,1981,23,1,2,75,-1,1768,399,806,0.495,9,29,0.31,390,777,0.502,161,226,0.712,32,111,143,273,59,10,219,234,968
2670,2,1982,24,1,2,77,1,1909,511,979,0.522,25,59,0.424,486,920,0.528,227,306,0.742,43,91,134,283,64,17,214,269,1274
2670,3,1983,25,1,2,81,81,2474,626,1250,0.501,22,76,0.289,604,1174,0.514,324,411,0.788,42,183,225,365,80,17,271,255,1598
2670,4,1984,26,1,2,78,72,2556,593,1125,0.527,12,38,0.316,581,1087,0.534,390,465,0.839,57,136,193,373,70,23,297,251,1588
2670,5,1985,27,1,2,70,65,2237,450,914,0.492,39,105,0.371,411,809,0.508,306,355,0.862,35,142,177,363,65,24,224,211,1245
2670,6,1987,29,1,2,52,12,1058,197,437,0.451,22,67,0.328,175,370,0.473,133,167,0.796,16,69,85,188,18,8,112,78,549
2670,7,1988,30,1,2,29,15,522,72,171,0.421,9,27,0.333,63,144,0.438,58,72,0.806,8,39,47,108,11,6,50,35,211
2675,1,1980,23,1,4,23,-1,124,23,64,0.359,1,7,0.143,22,57,0.386,8,10,0.8,12,22,34,12,4,5,16,20,55
2678,1,2002,25,1,2,65,13,1075,135,341,0.396,37,126,0.294,98,215,0.456,82,105,0.781,47,75,122,40,25,9,49,64,389
2678,2,2003,26,1,2,17,0,109,16,36,0.444,7,13,0.538,9,23,0.391,14,20,0.7,3,9,12,3,4,2,8,9,53
2679,1,1996,25,1,5,34,1,305,32,72,0.444,0,1,0,32,71,0.451,18,26,0.692,22,29,51,5,4,11,16,50,82
2681,1,1983,23,1,3,55,0,516,105,234,0.449,9,25,0.36,96,209,0.459,28,38,0.737,30,35,65,31,19,5,33,81,247
2686,1,1999,21,1,5,49,43,786,108,201,0.537,0,1,0,108,200,0.54,43,80,0.538,80,102,182,38,44,44,42,140,259
2686,2,2000,22,1,4,44,16,447,58,122,0.475,0,4,0,58,118,0.492,41,68,0.603,50,65,115,20,25,25,27,79,157
2686,3,2001,23,1,5,70,7,1212,161,324,0.497,0,2,0,161,322,0.5,80,141,0.567,124,176,300,63,49,76,98,204,402
2686,4,2002,24,1,4,61,1,678,87,204,0.426,1,1,1,86,203,0.424,53,84,0.631,67,120,187,37,24,37,45,127,228
2686,5,2003,25,1,5,69,0,851,105,237,0.443,1,3,0.333,104,234,0.444,57,88,0.648,108,154,262,50,45,37,53,153,268
2686,6,2004,26,1,5,71,0,942,145,287,0.505,2,5,0.4,143,282,0.507,70,128,0.547,106,156,262,43,39,37,62,161,362
2686,7,2005,27,1,5,74,6,1327,177,399,0.444,0,8,0,177,391,0.453,55,102,0.539,136,196,332,61,54,50,73,215,409
2687,1,1996,21,1,4,69,10,1219,220,429,0.513,0,9,0,220,420,0.524,78,141,0.553,84,154,238,50,25,11,92,116,518
2687,2,1997,22,1,4,82,28,1918,361,674,0.536,0,11,0,361,663,0.544,160,229,0.699,156,272,428,87,48,35,129,186,882
2687,3,1998,23,1,4,13,7,355,64,146,0.438,0,3,0,64,143,0.448,31,49,0.633,43,61,104,14,8,8,22,46,159
2687,3,1998,23,1,4,41,13,1005,177,359,0.493,4,9,0.444,173,350,0.494,113,163,0.693,80,154,234,58,27,19,72,115,471
2687,3,1998,23,1,4,54,20,1360,241,505,0.477,4,12,0.333,237,493,0.481,144,212,0.679,123,215,338,72,35,27,94,161,630
2687,4,1999,24,1,4,45,23,1362,287,602,0.477,0,5,0,287,597,0.481,145,235,0.617,127,224,351,77,29,23,66,122,719
2687,5,2000,25,1,3,11,11,301,70,142,0.493,0,2,0,70,140,0.5,11,21,0.524,20,32,52,22,8,3,25,28,151
2687,6,2001,26,1,4,33,4,319,57,130,0.438,0,1,0,57,129,0.442,19,36,0.528,39,53,92,10,13,8,22,52,133
2687,7,2002,27,1,4,64,10,1140,193,381,0.507,0,2,0,193,379,0.509,92,144,0.639,104,166,270,60,21,27,58,160,478
2687,8,2003,28,1,3,80,22,1222,208,389,0.535,0,2,0,208,387,0.537,60,101,0.594,106,185,291,77,32,23,59,142,476
2687,9,2004,29,1,5,68,2,1025,155,328,0.473,0,6,0,155,322,0.481,69,91,0.758,83,133,216,49,12,17,54,129,379
2689,1,1982,22,1,3,82,82,3077,636,1281,0.496,5,22,0.227,631,1259,0.501,495,621,0.797,219,224,443,270,89,16,280,241,1772
2689,2,1983,23,1,3,58,58,2252,565,1156,0.489,14,37,0.378,551,1119,0.492,392,464,0.845,126,138,264,237,67,20,187,157,1536
2689,3,1984,24,1,3,76,75,2493,595,1296,0.459,2,17,0.118,593,1279,0.464,426,523,0.815,119,187,306,228,65,17,190,190,1618
2689,4,1985,25,1,3,55,43,1675,396,831,0.477,2,5,0.4,394,826,0.477,255,288,0.885,66,152,218,135,49,14,118,118,1049
2689,5,1986,26,1,3,81,81,2626,615,1236,0.498,12,25,0.48,603,1211,0.498,380,444,0.856,116,232,348,265,93,10,183,167,1622
2689,6,1987,27,1,3,79,76,1865,291,621,0.469,19,52,0.365,272,569,0.478,197,226,0.872,54,188,242,243,85,11,167,147,798
2689,7,1988,28,1,3,49,21,976,139,303,0.459,31,74,0.419,108,229,0.472,59,68,0.868,30,87,117,105,34,4,68,68,368
2689,8,1989,29,1,3,71,65,2302,568,1215,0.467,30,84,0.357,538,1131,0.476,440,508,0.866,79,188,267,224,88,16,236,196,1606
2689,9,1990,30,1,3,79,73,2404,442,1029,0.43,38,104,0.365,404,925,0.437,310,351,0.883,82,240,322,224,75,16,176,220,1232
2689,10,1991,31,1,3,77,1,1289,187,412,0.454,15,45,0.333,172,367,0.469,152,167,0.91,46,130,176,159,33,13,92,130,541
2692,1,2001,21,1,5,57,39,947,101,215,0.47,0,0,-1,101,215,0.47,54,91,0.593,83,159,242,19,10,55,66,137,256
2692,2,2002,22,1,5,67,47,1582,190,400,0.475,0,1,0,190,399,0.476,111,159,0.698,130,244,374,23,23,69,78,193,491
2692,3,2003,23,1,5,33,27,543,61,135,0.452,0,0,-1,61,135,0.452,39,58,0.672,45,77,122,13,6,17,26,80,161
2692,4,2004,24,1,5,40,28,533,67,133,0.504,0,0,-1,67,133,0.504,36,61,0.59,37,91,128,18,9,22,23,79,170
2692,5,2005,25,1,5,31,1,278,32,64,0.5,0,0,-1,32,64,0.5,14,18,0.778,21,35,56,10,3,16,12,42,78
2692,6,2006,26,1,5,51,19,732,100,165,0.606,0,0,-1,100,165,0.606,57,87,0.655,78,134,212,13,14,32,39,107,257
2692,7,2007,27,1,5,13,0,132,9,22,0.409,0,0,-1,9,22,0.409,12,15,0.8,18,22,40,3,1,1,3,17,30
2692,7,2007,27,1,5,23,7,258,20,50,0.4,0,0,-1,20,50,0.4,14,24,0.583,24,40,64,2,7,11,21,34,54
2692,7,2007,27,1,5,36,7,390,29,72,0.403,0,0,-1,29,72,0.403,26,39,0.667,42,62,104,5,8,12,24,51,84
2695,1,2003,19,1,3,81,16,1320,115,393,0.293,37,152,0.243,78,241,0.324,48,65,0.738,64,117,181,91,31,29,84,136,315
2695,2,2004,20,1,4,39,0,307,40,122,0.328,3,11,0.273,37,111,0.333,23,29,0.793,24,39,63,10,6,8,17,50,106
2695,3,2005,21,1,4,23,0,158,15,51,0.294,0,7,0,15,44,0.341,4,7,0.571,11,18,29,4,8,8,14,24,34
2695,3,2005,21,1,4,35,0,220,22,74,0.297,2,17,0.118,20,57,0.351,4,7,0.571,12,29,41,10,8,11,19,33,50
2697,1,2009,24,1,2,30,1,282,52,121,0.43,8,23,0.348,44,98,0.449,26,33,0.788,19,12,31,12,5,1,14,14,138
2698,1,1995,25,1,3,62,13,982,96,210,0.457,0,1,0,96,209,0.459,51,83,0.614,44,126,170,68,46,11,56,129,243
2701,1,1982,22,1,3,80,62,1996,282,639,0.441,0,4,0,282,635,0.444,97,138,0.703,143,158,301,189,75,2,116,182,661
2701,2,1983,23,1,3,59,16,879,96,238,0.403,2,3,0.667,94,235,0.4,20,30,0.667,68,84,152,88,47,0,59,75,214
2701,3,1984,24,1,3,47,1,536,54,150,0.36,1,9,0.111,53,141,0.376,28,34,0.824,42,51,93,59,26,0,29,40,137
2701,4,1985,25,1,3,81,2,1491,181,388,0.466,1,6,0.167,180,382,0.471,51,65,0.785,88,128,216,158,96,7,70,152,414
2701,5,1986,26,1,2,73,0,1324,165,379,0.435,0,9,0,165,370,0.446,39,53,0.736,64,137,201,165,70,6,80,150,369
2701,6,1987,27,1,3,70,4,936,112,252,0.444,1,8,0.125,111,244,0.455,23,31,0.742,34,81,115,102,30,4,31,97,248
2701,7,1989,29,1,3,78,12,1746,151,353,0.428,2,7,0.286,149,346,0.431,33,56,0.589,109,178,287,144,90,8,60,209,337
2703,1,1983,23,1,2,78,59,1830,299,647,0.462,14,30,0.467,285,617,0.462,43,64,0.672,75,141,216,195,56,6,70,235,655
2703,2,1984,24,1,2,63,21,1228,225,450,0.5,6,16,0.375,219,434,0.505,25,33,0.758,43,87,130,138,63,8,54,124,481
2703,3,1985,25,1,2,77,46,1819,293,606,0.483,29,72,0.403,264,534,0.494,38,48,0.792,74,114,188,199,75,15,64,195,653
2703,4,1986,26,1,2,77,23,1788,349,740,0.472,41,91,0.451,308,649,0.475,79,100,0.79,70,99,169,192,65,8,70,167,818
2703,5,1987,27,1,2,70,15,1691,325,691,0.47,68,161,0.422,257,530,0.485,77,101,0.762,49,86,135,166,116,13,78,169,795
2703,6,1988,28,1,2,71,4,1248,193,455,0.424,69,167,0.413,124,288,0.431,51,71,0.718,32,87,119,117,53,6,47,158,506
2703,7,1989,29,1,2,81,24,1824,263,579,0.454,118,296,0.399,145,283,0.512,43,55,0.782,55,121,176,132,88,6,59,163,687
2703,8,1990,30,1,2,81,2,1725,253,606,0.417,95,245,0.388,158,361,0.438,66,86,0.767,57,117,174,173,74,8,73,159,667
2703,9,1991,31,1,2,65,13,1194,191,434,0.44,64,153,0.418,127,281,0.452,17,27,0.63,33,72,105,111,44,9,46,120,463
2703,10,1992,32,1,2,24,0,415,60,129,0.465,19,48,0.396,41,81,0.506,16,20,0.8,8,29,37,27,21,3,14,39,155
2703,11,1993,33,1,2,69,0,909,143,295,0.485,52,131,0.397,91,164,0.555,18,22,0.818,16,55,71,82,24,6,18,65,356
2705,1,1990,25,1,1,11,0,115,11,38,0.289,0,2,0,11,36,0.306,4,4,1,4,4,8,23,8,0,12,6,26
2705,2,1991,26,1,1,70,1,1407,168,383,0.439,12,33,0.364,156,350,0.446,64,87,0.736,36,116,152,311,63,0,95,124,412
2705,3,1992,27,1,1,70,3,871,111,261,0.425,1,16,0.063,110,245,0.449,61,77,0.792,17,73,90,177,57,2,84,59,284
2711,1,1995,23,1,1,55,8,809,72,189,0.381,16,51,0.314,56,138,0.406,35,50,0.7,13,49,62,174,36,2,97,58,195
2713,1,1980,23,1,3,82,-1,2670,430,925,0.465,2,12,0.167,428,913,0.469,143,187,0.765,228,399,627,129,107,220,175,237,1005
2713,2,1981,24,1,3,82,-1,2549,476,895,0.532,0,8,0,476,887,0.537,148,250,0.592,198,369,567,136,112,180,163,215,1100
2713,3,1982,25,1,4,82,0,1989,336,643,0.523,1,4,0.25,335,639,0.524,142,192,0.74,154,339,493,126,77,160,121,182,815
2713,4,1983,26,1,3,82,56,2543,421,880,0.478,2,15,0.133,419,865,0.484,146,196,0.745,180,360,540,157,103,160,120,221,990
2713,5,1984,27,1,3,82,7,1602,313,691,0.453,2,13,0.154,311,678,0.459,94,132,0.712,104,181,285,76,63,59,78,151,722
2713,6,1985,28,1,3,82,53,2004,422,855,0.494,0,8,0,422,847,0.498,106,148,0.716,148,275,423,63,49,90,76,192,950
2713,7,1986,29,1,3,71,52,1651,295,649,0.455,0,3,0,295,646,0.457,84,112,0.75,109,204,313,94,64,108,94,159,674
2713,8,1987,30,1,3,82,48,1930,329,664,0.495,1,3,0.333,328,661,0.496,101,140,0.721,116,212,328,73,55,78,78,151,760
2713,9,1988,31,1,3,74,28,1185,184,407,0.452,1,7,0.143,183,400,0.458,41,64,0.641,87,155,242,56,43,47,43,85,410
2713,10,1989,32,1,3,70,11,1057,169,360,0.469,1,9,0.111,168,351,0.479,47,62,0.758,74,135,209,40,24,39,51,90,386
2714,1,1992,24,1,3,42,0,345,43,98,0.439,0,0,-1,43,98,0.439,31,59,0.525,38,40,78,12,6,4,32,40,117
2715,1,1980,29,1,1,67,-1,1594,183,394,0.464,4,7,0.571,179,387,0.463,197,252,0.782,52,104,156,273,77,1,131,149,567
2717,1,1981,23,1,3,24,-1,123,37,98,0.378,1,2,0.5,36,96,0.375,9,19,0.474,10,20,30,7,7,4,16,23,84
2722,1,1980,28,1,3,82,-1,2399,212,458,0.463,7,20,0.35,205,438,0.468,130,155,0.839,103,326,429,247,100,76,158,307,561
2722,2,1981,29,1,3,78,-1,1426,100,245,0.408,2,8,0.25,98,237,0.414,98,117,0.838,48,154,202,129,38,50,108,214,300
2722,3,1982,30,1,3,41,0,452,41,82,0.5,0,2,0,41,80,0.513,62,76,0.816,17,31,48,32,12,13,29,63,144
2723,1,1994,22,1,1,81,80,2700,413,1049,0.394,123,364,0.338,290,685,0.423,150,192,0.781,47,191,238,466,85,8,145,154,1099
2723,2,1995,23,1,1,80,80,2944,465,1107,0.42,183,511,0.358,282,596,0.473,235,300,0.783,27,196,223,660,97,6,220,157,1348
2723,3,1996,24,1,1,74,74,2513,396,950,0.417,144,403,0.357,252,547,0.461,163,204,0.799,29,152,181,509,70,10,156,115,1099
2723,4,1997,25,1,1,79,79,2937,432,1075,0.402,177,468,0.378,255,607,0.42,165,200,0.825,44,182,226,672,75,10,212,110,1206
2723,5,1998,26,1,1,64,46,2053,311,743,0.419,123,316,0.389,188,427,0.44,136,172,0.791,31,163,194,442,64,6,104,120,881
2723,6,1999,27,1,1,50,50,1802,306,769,0.398,72,234,0.308,234,535,0.437,142,175,0.811,14,99,113,368,40,3,121,90,826
2723,7,2000,28,1,1,79,79,2950,473,1213,0.39,133,401,0.332,340,812,0.419,196,240,0.817,34,277,311,714,68,11,221,148,1275
2723,8,2001,29,1,1,71,70,2688,460,1112,0.414,135,358,0.377,325,754,0.431,204,249,0.819,44,197,241,600,61,18,165,109,1259
2723,9,2002,30,1,2,27,2,757,129,314,0.411,34,98,0.347,95,216,0.44,65,77,0.844,9,76,85,113,14,4,40,35,357
2723,9,2002,30,1,1,45,44,1739,372,912,0.408,85,252,0.337,287,660,0.435,136,174,0.782,19,150,169,365,30,7,116,69,965
2723,9,2002,30,1,1,72,46,2496,501,1226,0.409,119,350,0.34,382,876,0.436,201,251,0.801,28,226,254,478,44,11,156,104,1322
2723,10,2003,31,1,2,73,1,2026,342,831,0.412,118,312,0.378,224,519,0.432,110,144,0.764,35,173,208,312,42,4,123,86,912
2723,11,2004,32,1,1,39,29,1255,187,479,0.39,46,150,0.307,141,329,0.429,70,99,0.707,16,88,104,206,20,2,78,57,490
2723,12,2005,33,1,2,53,34,1619,214,561,0.381,100,257,0.389,114,304,0.375,58,74,0.784,20,141,161,227,44,0,92,70,586
2723,13,2006,34,1,1,65,2,986,136,343,0.397,55,154,0.357,81,189,0.429,28,41,0.683,6,85,91,123,16,3,57,60,355
2724,1,1998,22,1,4,62,62,2325,446,1047,0.426,69,224,0.308,377,823,0.458,258,305,0.846,142,266,408,106,64,25,164,216,1219
2724,2,1999,23,1,4,42,42,1576,322,752,0.428,16,53,0.302,306,699,0.438,256,298,0.859,114,244,358,65,43,53,133,134,916
2724,3,2000,24,1,4,80,80,2782,559,1257,0.445,84,228,0.368,475,1029,0.462,333,393,0.847,200,476,676,158,64,60,245,258,1535
2724,4,2001,25,1,3,49,47,1733,308,708,0.435,65,170,0.382,243,538,0.452,150,186,0.806,78,269,347,82,40,20,103,150,831
2724,5,2002,26,1,3,81,81,2465,471,1089,0.433,101,293,0.345,370,796,0.465,156,195,0.8,137,472,609,164,63,42,146,221,1199
2724,6,2003,27,1,4,74,73,2337,459,952,0.482,65,176,0.369,394,776,0.508,193,240,0.804,159,365,524,93,63,30,150,251,1176
2724,7,2004,28,1,3,25,15,766,137,290,0.472,33,72,0.458,104,218,0.477,86,91,0.945,51,107,158,37,16,15,50,64,393
2724,7,2004,28,1,3,47,47,1574,273,613,0.445,60,161,0.373,213,452,0.471,163,199,0.819,98,245,343,83,52,18,119,151,769
2724,7,2004,28,1,3,72,62,2340,410,903,0.454,93,233,0.399,317,670,0.473,249,290,0.859,149,352,501,120,68,33,169,215,1162
2724,8,2005,29,1,4,29,3,684,129,279,0.462,24,64,0.375,105,215,0.488,72,92,0.783,34,95,129,34,15,10,34,88,354
2724,8,2005,29,1,3,33,13,818,128,285,0.449,30,78,0.385,98,207,0.473,56,65,0.862,55,110,165,41,21,11,47,82,342
2724,8,2005,29,1,3,62,16,1502,257,564,0.456,54,142,0.38,203,422,0.481,128,157,0.815,89,205,294,75,36,21,81,170,696
2724,9,2006,30,1,3,53,0,1090,164,387,0.424,50,136,0.368,114,251,0.454,94,113,0.832,54,138,192,37,31,11,71,121,472
2729,1,2001,27,1,1,22,0,411,46,110,0.418,0,6,0,46,104,0.442,30,50,0.6,15,22,37,66,23,3,37,44,122
2731,1,1986,22,1,5,11,0,202,23,72,0.319,0,0,-1,23,72,0.319,8,23,0.348,21,39,60,16,2,5,20,34,54
2731,2,1987,23,1,5,57,14,640,65,158,0.411,0,2,0,65,156,0.417,38,59,0.644,67,113,180,43,19,23,48,94,168
2733,1,1981,22,1,3,51,-1,1376,229,537,0.426,0,7,0,229,530,0.432,130,159,0.818,86,184,270,94,29,24,86,116,588
2733,2,1982,23,1,4,82,78,2775,706,1260,0.56,1,13,0.077,705,1247,0.565,347,405,0.857,149,312,461,247,52,29,189,217,1760
2733,3,1983,24,1,4,82,79,2909,841,1537,0.547,15,51,0.294,826,1486,0.556,489,559,0.875,124,313,437,203,66,38,177,198,2186
2733,4,1984,25,1,4,78,71,2734,895,1603,0.558,11,30,0.367,884,1573,0.562,494,580,0.852,84,289,373,238,53,50,156,187,2295
2733,5,1985,26,1,3,72,69,2502,618,1158,0.534,11,33,0.333,607,1125,0.54,369,412,0.896,74,154,228,106,37,22,116,116,1616
2733,6,1986,27,1,3,79,76,2791,719,1332,0.54,1,8,0.125,718,1324,0.542,523,602,0.869,92,124,216,187,54,17,177,161,1962
2733,7,1987,28,1,3,79,79,3029,808,1545,0.523,39,81,0.481,769,1464,0.525,467,527,0.886,86,165,251,220,52,17,139,137,2122
2733,8,1988,29,1,3,37,7,1038,283,557,0.508,22,58,0.379,261,499,0.523,159,181,0.878,36,73,109,71,21,7,48,68,747
2733,9,1989,30,1,4,18,1,432,103,217,0.475,16,38,0.421,87,179,0.486,29,33,0.879,11,24,35,34,7,4,18,40,251
2733,9,1989,30,1,4,27,0,502,97,209,0.464,3,10,0.3,94,199,0.472,51,56,0.911,15,21,36,35,12,7,23,38,248
2733,9,1989,30,1,4,45,1,934,200,426,0.469,19,48,0.396,181,378,0.479,80,89,0.899,26,45,71,69,19,11,41,78,499
2733,10,1990,31,1,3,22,13,563,102,231,0.442,10,19,0.526,92,212,0.434,44,48,0.917,15,38,53,41,15,3,26,28,258
2733,11,1991,32,1,3,75,72,2420,458,927,0.494,51,141,0.362,407,786,0.518,259,288,0.899,78,102,180,110,42,10,108,122,1226
2733,12,1992,33,1,3,67,0,956,188,383,0.491,26,66,0.394,162,317,0.511,65,81,0.802,31,57,88,57,15,8,27,87,467
2733,13,1993,34,1,3,41,3,494,92,203,0.453,12,37,0.324,80,166,0.482,58,66,0.879,12,36,48,25,13,7,20,45,254
2738,1,1996,22,1,4,33,0,266,27,80,0.338,0,1,0,27,79,0.342,10,18,0.556,33,47,80,8,6,15,18,68,64
2738,2,1997,23,1,4,35,6,298,31,72,0.431,0,0,-1,31,72,0.431,19,30,0.633,35,60,95,7,8,15,29,43,81
2738,3,1998,24,1,4,15,2,161,19,33,0.576,0,0,-1,19,33,0.576,6,9,0.667,19,30,49,2,5,4,9,34,44
2738,3,1998,24,1,4,22,0,322,46,114,0.404,0,1,0,46,113,0.407,22,34,0.647,34,68,102,18,10,6,31,48,114
2738,3,1998,24,1,4,40,2,489,66,148,0.446,0,1,0,66,147,0.449,30,47,0.638,53,99,152,20,15,10,40,83,162
2738,4,1999,25,1,4,10,0,103,13,24,0.542,0,0,-1,13,24,0.542,8,10,0.8,13,21,34,1,2,8,11,22,34
2739,1,1991,22,1,4,73,0,1178,175,359,0.487,0,2,0,175,357,0.49,49,74,0.662,124,225,349,40,20,23,49,135,399
2739,2,1992,23,1,4,79,38,1687,271,551,0.492,4,5,0.8,267,546,0.489,55,69,0.797,160,352,512,71,37,31,66,165,601
2739,3,1993,24,1,4,79,4,1653,313,616,0.508,1,4,0.25,312,612,0.51,116,155,0.748,164,328,492,54,55,39,83,172,743
2739,4,1994,25,1,4,75,56,2118,373,695,0.537,0,5,0,373,690,0.541,131,182,0.72,218,438,656,74,76,22,96,221,877
2739,5,1995,26,1,4,80,79,2966,609,1185,0.514,7,33,0.212,602,1152,0.523,176,248,0.71,261,511,772,139,104,29,166,243,1401
2739,6,1996,27,1,4,80,78,2966,571,1087,0.525,7,19,0.368,564,1068,0.528,149,205,0.727,204,604,808,112,87,40,158,241,1298
2739,7,1997,28,1,4,82,82,2838,542,1084,0.5,2,12,0.167,540,1072,0.504,134,191,0.702,222,595,817,110,85,25,137,241,1220
2739,8,1998,29,1,4,10,6,265,36,84,0.429,0,2,0,36,82,0.439,3,8,0.375,16,49,65,7,4,2,13,33,75
2739,9,1999,30,1,4,37,10,481,59,155,0.381,0,1,0,59,154,0.383,9,14,0.643,36,110,146,11,15,6,17,54,127
2739,10,2000,31,1,4,43,0,292,32,89,0.36,0,3,0,32,86,0.372,11,16,0.688,26,65,91,11,6,4,11,45,75
2739,11,2001,32,1,4,14,0,157,25,48,0.521,0,0,-1,25,48,0.521,4,4,1,16,34,50,7,6,2,8,13,54
2739,11,2001,32,1,4,37,1,392,55,121,0.455,0,0,-1,55,121,0.455,4,6,0.667,35,88,123,16,15,5,18,61,114
2739,11,2001,32,1,4,51,1,549,80,169,0.473,0,0,-1,80,169,0.473,8,10,0.8,51,122,173,23,21,7,26,74,168
2740,1,1982,22,1,4,71,22,1207,149,296,0.503,0,0,-1,149,296,0.503,51,72,0.708,106,148,254,52,42,22,55,215,349
2740,2,1983,23,1,4,48,0,527,87,171,0.509,0,1,0,87,170,0.512,21,31,0.677,44,52,96,32,18,9,40,95,195
2740,3,1984,24,1,4,43,0,327,50,100,0.5,0,1,0,50,99,0.505,17,25,0.68,27,34,61,20,22,11,21,75,117
2740,4,1985,25,1,4,54,0,366,51,108,0.472,0,0,-1,51,108,0.472,21,25,0.84,28,35,63,17,15,7,20,85,123
2740,5,1986,26,1,4,61,5,749,90,167,0.539,1,2,0.5,89,165,0.539,25,43,0.581,65,95,160,29,29,17,30,141,206
2741,1,1998,22,1,1,45,0,419,44,122,0.361,3,8,0.375,41,114,0.36,48,68,0.706,4,34,38,84,9,1,56,63,139
2741,2,2000,24,1,1,78,0,884,109,262,0.416,14,34,0.412,95,228,0.417,57,76,0.75,11,54,65,121,32,0,77,92,289
2741,3,2001,25,1,1,82,0,1620,170,393,0.433,30,78,0.385,140,315,0.444,128,164,0.78,18,132,150,323,48,3,129,145,498
2741,4,2002,26,1,1,82,16,1856,206,438,0.47,24,54,0.444,182,384,0.474,104,126,0.825,18,150,168,349,65,2,112,183,540
2741,5,2003,27,1,1,80,48,1686,184,411,0.448,8,34,0.235,176,377,0.467,97,125,0.776,26,92,118,232,64,2,97,169,473
2741,6,2004,28,1,1,71,6,1271,107,277,0.386,3,20,0.15,104,257,0.405,53,68,0.779,12,104,116,195,44,2,84,126,270
2741,7,2005,29,1,2,71,34,1410,146,325,0.449,5,15,0.333,141,310,0.455,76,91,0.835,17,90,107,135,41,1,62,138,373
2741,8,2006,30,1,2,80,6,1234,107,245,0.437,1,6,0.167,106,239,0.444,59,81,0.728,16,75,91,123,42,1,52,140,274
2741,9,2007,31,1,1,64,4,760,71,167,0.425,1,2,0.5,70,165,0.424,49,65,0.754,8,60,68,131,24,2,40,74,192
2741,10,2008,32,1,1,74,9,1139,121,283,0.428,3,10,0.3,118,273,0.432,61,80,0.763,13,61,74,159,23,1,54,97,306
2741,11,2009,33,1,1,30,0,292,24,75,0.32,1,1,1,23,74,0.311,16,18,0.889,4,18,22,55,6,0,15,26,65
2742,1,1982,22,1,4,81,62,2626,719,1448,0.497,1,4,0.25,718,1444,0.497,293,409,0.716,182,383,565,176,89,22,194,308,1732
2742,2,1983,23,1,4,81,73,2726,622,1272,0.489,0,3,0,622,1269,0.49,269,343,0.784,217,375,592,212,70,45,188,295,1513
2742,3,1984,24,1,3,61,5,1421,252,579,0.435,0,1,0,252,578,0.436,168,215,0.781,81,166,247,114,30,10,113,159,672
2742,4,1985,25,1,4,79,47,2543,545,1138,0.479,0,4,0,545,1134,0.481,351,420,0.836,185,519,704,169,48,22,170,226,1441
2742,5,1986,26,1,4,80,3,1994,442,919,0.481,0,3,0,442,916,0.483,222,274,0.81,107,261,368,180,66,21,145,193,1106
2742,6,1987,27,1,3,51,17,1386,274,613,0.447,0,3,0,274,610,0.449,130,169,0.769,69,141,210,85,40,17,77,127,678
2742,7,1988,28,1,3,73,8,1755,446,958,0.466,1,4,0.25,445,954,0.466,231,287,0.805,80,229,309,143,46,26,137,198,1124
2742,8,1989,29,1,3,24,3,551,91,219,0.416,0,1,0,91,218,0.417,35,51,0.686,36,56,92,22,5,3,37,52,217
2742,8,1989,29,1,3,29,4,646,104,257,0.405,1,3,0.333,103,254,0.406,40,60,0.667,38,72,110,27,6,4,42,63,249
2742,9,1990,30,1,3,24,1,200,41,78,0.526,0,1,0,41,77,0.532,8,12,0.667,7,19,26,10,8,3,19,29,90
2742,9,1990,30,1,3,17,5,259,45,105,0.429,1,1,1,44,104,0.423,33,37,0.892,13,23,36,8,10,2,14,23,124
2742,9,1990,30,1,3,41,6,459,86,183,0.47,1,2,0.5,85,181,0.47,41,49,0.837,20,42,62,18,18,5,33,52,214
2743,1,2007,22,1,3,13,0,103,7,15,0.467,3,7,0.429,4,8,0.5,5,7,0.714,2,9,11,5,2,1,6,10,22
2744,1,1986,22,1,2,57,0,432,59,162,0.364,1,4,0.25,58,158,0.367,65,70,0.929,11,37,48,69,17,4,49,59,184
2744,2,1987,23,1,1,46,5,374,60,136,0.441,0,0,-1,60,136,0.441,51,55,0.927,5,22,27,59,13,1,33,33,171
2744,3,1988,24,1,1,43,0,548,72,152,0.474,5,13,0.385,67,139,0.482,46,60,0.767,17,32,49,137,21,4,52,63,195
2744,3,1988,24,1,1,29,27,953,138,309,0.447,3,8,0.375,135,301,0.449,99,107,0.925,18,85,103,244,34,12,84,82,378
2744,3,1988,24,1,1,72,27,1501,210,461,0.456,8,21,0.381,202,440,0.459,145,167,0.868,35,117,152,381,55,16,136,145,573
2744,4,1989,25,1,1,70,56,1703,274,566,0.484,2,17,0.118,272,549,0.495,106,129,0.822,34,156,190,335,53,10,142,124,656
2744,5,1990,26,1,1,63,45,1657,258,564,0.457,1,14,0.071,257,550,0.467,188,214,0.879,37,157,194,354,65,20,132,108,705
2744,6,1991,27,1,1,49,17,975,152,353,0.431,3,19,0.158,149,334,0.446,99,120,0.825,17,90,107,197,30,5,91,74,406
2744,7,1992,28,1,1,39,18,885,150,349,0.43,1,13,0.077,149,336,0.443,110,130,0.846,19,82,101,148,35,4,72,55,411
2749,1,2001,23,1,5,16,2,143,11,25,0.44,0,0,-1,11,25,0.44,8,14,0.571,12,22,34,5,5,6,12,38,30
2749,2,2002,24,1,5,59,34,900,107,193,0.554,0,0,-1,107,193,0.554,82,109,0.752,103,147,250,18,11,23,48,139,296
2749,3,2003,25,1,5,65,1,947,92,163,0.564,0,0,-1,92,163,0.564,64,96,0.667,97,128,225,36,18,29,48,172,248
2749,4,2004,26,1,5,66,43,1606,152,300,0.507,0,0,-1,152,300,0.507,134,181,0.74,123,220,343,57,42,25,77,258,438
2749,5,2005,27,1,5,38,1,360,27,59,0.458,0,0,-1,27,59,0.458,26,38,0.684,30,62,92,17,4,11,20,60,80
2749,6,2006,28,1,5,51,2,818,114,261,0.437,1,3,0.333,113,258,0.438,41,60,0.683,62,121,183,39,26,23,33,157,270
2749,7,2007,29,1,5,73,9,1043,121,255,0.475,0,0,-1,121,255,0.475,77,113,0.681,84,172,256,44,30,24,56,199,319
2749,8,2008,30,1,5,44,0,386,37,80,0.463,0,0,-1,37,80,0.463,24,29,0.828,30,67,97,13,9,21,29,83,98
2749,9,2009,31,1,5,38,1,240,12,45,0.267,0,0,-1,12,45,0.267,11,14,0.786,21,38,59,8,3,4,17,60,35
2750,1,1982,23,1,3,77,1,1075,143,262,0.546,0,1,0,143,261,0.548,89,148,0.601,71,127,198,56,28,21,68,150,375
2750,2,1983,24,1,3,82,73,2054,226,429,0.527,0,1,0,226,428,0.528,115,209,0.55,177,248,425,120,53,49,102,254,567
2750,3,1984,25,1,3,80,72,2174,258,495,0.521,0,1,0,258,494,0.522,153,236,0.648,150,245,395,132,51,54,121,263,669
2750,4,1985,26,1,3,76,70,2163,186,402,0.463,1,4,0.25,185,398,0.465,67,127,0.528,154,282,436,152,76,57,119,256,440
2750,5,1986,27,1,3,80,19,1569,131,284,0.461,0,4,0,131,280,0.468,39,75,0.52,115,166,281,68,63,31,58,218,301
2750,6,1987,28,1,3,58,6,817,59,138,0.428,1,5,0.2,58,133,0.436,21,45,0.467,51,95,146,30,35,25,26,127,140
2750,7,1988,29,1,3,57,5,772,53,121,0.438,0,3,0,53,118,0.449,15,35,0.429,45,72,117,36,27,33,25,100,121
2754,1,2005,23,1,5,36,17,648,76,183,0.415,0,3,0,76,180,0.422,44,68,0.647,59,103,162,33,22,17,57,94,196
2754,1,2005,23,1,5,46,18,705,82,199,0.412,0,3,0,82,196,0.418,48,75,0.64,64,111,175,40,25,19,64,105,212
2754,2,2006,24,1,4,41,2,406,26,66,0.394,0,0,-1,26,66,0.394,21,44,0.477,33,53,86,11,12,11,21,78,73
2756,1,2009,24,1,1,72,0,890,123,324,0.38,11,62,0.177,112,262,0.427,44,60,0.733,27,48,75,153,30,2,60,77,301
2757,1,1989,26,1,2,9,0,144,26,63,0.413,1,5,0.2,25,58,0.431,4,6,0.667,4,9,13,20,7,0,13,18,57
2757,1,1989,26,1,2,23,0,473,73,149,0.49,2,10,0.2,71,139,0.511,14,20,0.7,6,30,36,97,19,3,42,62,162
2757,1,1989,26,1,2,32,0,617,99,212,0.467,3,15,0.2,96,197,0.487,18,26,0.692,10,39,49,117,26,3,55,80,219
2757,2,1990,27,1,2,14,0,131,12,39,0.308,2,5,0.4,10,34,0.294,4,6,0.667,3,10,13,28,2,1,12,19,30
2757,2,1990,27,1,2,23,0,252,51,104,0.49,2,9,0.222,49,95,0.516,24,31,0.774,6,22,28,26,25,0,15,34,128
2757,2,1990,27,1,2,40,0,387,64,146,0.438,4,15,0.267,60,131,0.458,28,37,0.757,9,32,41,54,27,1,27,53,160
2757,3,1991,28,1,2,48,1,514,104,231,0.45,7,29,0.241,97,202,0.48,55,64,0.859,20,35,55,86,28,5,39,77,270
2758,1,2011,22,1,1,42,0,438,61,144,0.424,3,8,0.375,58,136,0.426,33,56,0.589,30,31,61,69,13,8,25,29,158
2758,2,2012,23,1,1,16,8,357,33,94,0.351,0,1,0,33,93,0.355,11,19,0.579,17,46,63,59,16,3,19,30,77
2758,2,2012,23,1,1,18,8,370,35,99,0.354,0,1,0,35,98,0.357,11,19,0.579,19,48,67,61,17,3,19,31,81
2759,1,1980,33,1,5,82,-1,2973,327,637,0.513,1,2,0.5,326,635,0.513,139,209,0.665,334,760,1094,366,65,61,153,249,794
2759,2,1981,34,1,5,63,-1,2032,225,429,0.524,2,4,0.5,223,425,0.525,55,86,0.64,207,466,673,170,52,36,97,171,507
2763,1,1997,26,1,5,23,0,154,12,33,0.364,0,0,-1,12,33,0.364,13,18,0.722,6,19,25,10,2,13,12,17,37
2765,1,2004,20,1,5,10,2,130,11,23,0.478,0,0,-1,11,23,0.478,7,12,0.583,23,29,52,7,2,4,6,16,29
2765,2,2005,21,1,4,23,0,329,28,62,0.452,0,0,-1,28,62,0.452,23,39,0.59,36,86,122,8,4,17,17,53,79
2765,3,2007,23,1,5,22,3,125,9,14,0.643,0,1,0,9,13,0.692,6,14,0.429,15,33,48,5,2,7,10,17,24
2766,1,1984,23,1,5,82,82,2693,716,1369,0.523,1,4,0.25,715,1365,0.524,287,434,0.661,293,620,913,163,70,197,294,339,1720
2766,2,1985,24,1,4,82,82,3086,753,1499,0.502,0,6,0,753,1493,0.504,303,448,0.676,227,626,853,224,81,168,326,306,1809
2766,3,1986,25,1,4,79,76,2864,624,1280,0.488,2,15,0.133,622,1265,0.492,241,376,0.641,258,621,879,283,99,129,285,308,1491
2766,4,1987,26,1,4,43,32,1326,277,566,0.489,0,3,0,277,563,0.492,118,189,0.624,88,284,372,120,40,58,126,169,672
2766,5,1988,27,1,4,19,19,705,119,271,0.439,2,6,0.333,117,265,0.442,63,85,0.741,58,114,172,37,17,33,62,63,303
2766,5,1988,27,1,5,29,25,958,180,411,0.438,0,5,0,180,406,0.443,86,111,0.775,82,208,290,85,24,55,109,101,446
2766,5,1988,27,1,5,48,44,1663,299,682,0.438,2,11,0.182,297,671,0.443,149,196,0.76,140,322,462,122,41,88,171,164,749
2766,6,1989,28,1,5,61,36,1086,164,365,0.449,3,8,0.375,161,357,0.451,62,95,0.653,105,202,307,77,31,65,90,170,393
2766,7,1990,29,1,5,26,7,417,48,129,0.372,1,4,0.25,47,125,0.376,12,23,0.522,11,73,84,28,14,22,34,66,109
2766,8,1991,30,1,5,25,4,348,34,93,0.366,1,5,0.2,33,88,0.375,5,19,0.263,41,70,111,17,11,17,27,54,74
2766,9,1992,31,1,5,10,0,108,9,29,0.31,0,2,0,9,27,0.333,4,6,0.667,11,19,30,4,3,8,10,14,22
2767,1,2011,22,1,4,37,10,701,110,241,0.456,0,3,0,110,238,0.462,68,110,0.618,75,83,158,17,15,18,53,88,288
2767,2,2012,23,1,5,54,0,825,105,231,0.455,0,0,-1,105,231,0.455,82,117,0.701,63,117,180,20,20,20,56,113,292
2767,3,2013,24,1,5,18,1,196,22,60,0.367,0,1,0,22,59,0.373,14,24,0.583,10,18,28,8,3,3,6,30,58
2771,1,1983,22,1,3,26,0,393,76,157,0.484,0,2,0,76,155,0.49,31,43,0.721,31,63,94,19,18,6,28,57,183
2771,2,1984,23,1,3,50,0,586,97,203,0.478,0,0,-1,97,203,0.478,29,42,0.69,40,63,103,44,23,12,44,101,223
2771,3,1985,24,1,3,21,11,418,85,175,0.486,0,0,-1,85,175,0.486,45,59,0.763,38,51,89,29,23,4,34,59,215
2771,4,1986,25,1,3,82,5,1644,347,676,0.513,3,15,0.2,344,661,0.52,208,257,0.809,104,169,273,150,76,31,143,236,905
2771,5,1987,26,1,3,82,4,1655,357,722,0.494,2,17,0.118,355,705,0.504,143,183,0.781,101,170,271,126,61,23,105,210,859
2771,6,1988,27,1,3,24,11,417,71,132,0.538,0,0,-1,71,132,0.538,20,23,0.87,10,37,47,26,13,5,23,58,162
2771,6,1988,27,1,3,35,5,466,82,171,0.48,0,1,0,82,170,0.482,39,53,0.736,28,34,62,30,18,4,27,73,203
2771,6,1988,27,1,3,59,16,883,153,303,0.505,0,1,0,153,302,0.507,59,76,0.776,38,71,109,56,31,9,50,131,365
2771,7,1989,28,1,3,82,82,2102,332,733,0.453,3,10,0.3,329,723,0.455,97,135,0.719,98,209,307,133,89,32,104,230,764
2771,8,1990,29,1,3,82,13,1531,225,479,0.47,5,14,0.357,220,465,0.473,55,75,0.733,78,152,230,89,43,23,79,220,510
2771,9,1991,30,1,3,80,7,1357,206,494,0.417,4,20,0.2,202,474,0.426,47,57,0.825,73,112,185,106,37,26,65,198,463
2771,10,1992,31,1,3,21,20,552,81,139,0.583,1,3,0.333,80,136,0.588,31,41,0.756,27,61,88,42,22,9,16,75,194
2771,10,1992,31,1,3,31,20,633,92,161,0.571,1,3,0.333,91,158,0.576,36,47,0.766,27,69,96,53,24,10,22,83,221
2771,11,1993,32,1,3,53,51,1189,197,396,0.497,1,4,0.25,196,392,0.5,59,78,0.756,52,118,170,75,39,30,57,150,454
2772,1,1985,24,1,4,33,0,298,41,87,0.471,0,0,-1,41,87,0.471,14,34,0.412,28,47,75,7,7,4,21,50,96
2773,1,1990,24,1,4,31,0,182,13,40,0.325,0,0,-1,13,40,0.325,2,4,0.5,17,22,39,9,4,4,15,27,28
2773,2,1992,26,1,3,12,0,117,20,45,0.444,0,0,-1,20,45,0.444,7,9,0.778,9,17,26,9,5,3,5,15,47
2773,3,1993,27,1,4,9,0,120,10,25,0.4,0,0,-1,10,25,0.4,4,8,0.5,12,17,29,6,8,1,11,16,24
2775,1,2006,25,1,2,16,0,113,16,33,0.485,2,3,0.667,14,30,0.467,7,10,0.7,4,19,23,3,5,0,8,20,41
2776,1,2003,23,1,2,75,4,1025,64,207,0.309,13,44,0.295,51,163,0.313,53,78,0.679,64,120,184,65,45,12,39,91,194
2778,1,2002,20,1,1,36,4,560,73,199,0.367,7,27,0.259,66,172,0.384,36,46,0.783,17,35,52,108,31,1,53,43,189
2778,2,2003,21,1,1,22,6,420,51,165,0.309,5,28,0.179,46,137,0.336,16,23,0.696,12,23,35,53,18,2,36,30,123
2778,2,2003,21,1,1,39,6,502,55,183,0.301,5,28,0.179,50,155,0.323,17,25,0.68,16,27,43,68,20,2,43,36,132
2781,1,2003,26,1,2,27,0,256,29,93,0.312,4,26,0.154,25,67,0.373,21,29,0.724,9,16,25,22,14,1,21,33,83
2783,1,2002,23,1,4,28,0,290,23,67,0.343,3,10,0.3,20,57,0.351,11,15,0.733,12,39,51,21,9,2,24,39,60
2783,2,2003,24,1,4,59,7,724,68,169,0.402,14,39,0.359,54,130,0.415,30,36,0.833,40,101,141,46,16,18,46,77,180
2783,3,2004,25,1,4,69,2,928,86,218,0.394,10,41,0.244,76,177,0.429,58,70,0.829,42,131,173,65,21,14,42,113,240
2783,4,2005,26,1,4,54,14,1167,132,332,0.398,22,68,0.324,110,264,0.417,53,69,0.768,83,161,244,88,34,18,66,111,339
2783,5,2006,27,1,4,71,1,938,74,193,0.383,31,87,0.356,43,106,0.406,26,36,0.722,27,87,114,51,21,19,50,127,205
2783,6,2007,28,1,4,54,17,1027,77,191,0.403,44,110,0.4,33,81,0.407,18,23,0.783,24,81,105,59,23,18,44,130,216
2783,7,2008,29,1,4,48,9,512,29,94,0.309,15,46,0.326,14,48,0.292,15,20,0.75,22,57,79,40,9,8,26,63,88
2783,8,2009,30,1,5,39,8,504,48,114,0.421,24,61,0.393,24,53,0.453,16,18,0.889,7,43,50,18,7,10,12,73,136
2783,9,2010,31,1,4,52,3,472,29,85,0.341,16,49,0.327,13,36,0.361,4,6,0.667,9,39,48,27,9,4,17,59,78
2783,10,2012,33,1,4,28,0,122,14,30,0.467,1,7,0.143,13,23,0.565,3,6,0.5,8,13,21,15,5,6,9,9,32
2792,1,1982,22,1,5,82,20,1623,252,524,0.481,0,1,0,252,523,0.482,140,185,0.757,131,296,427,146,46,72,151,292,644
2792,2,1983,23,1,5,32,0,646,111,235,0.472,0,0,-1,111,235,0.472,71,100,0.71,63,123,186,40,15,30,58,109,293
2792,2,1983,23,1,5,50,50,1638,231,514,0.449,0,1,0,231,513,0.45,157,195,0.805,137,312,449,165,39,68,195,216,619
2792,2,1983,23,1,5,82,50,2284,342,749,0.457,0,1,0,342,748,0.457,228,295,0.773,200,435,635,205,54,98,253,325,912
2792,3,1984,24,1,5,82,15,1420,183,371,0.493,0,2,0,183,369,0.496,215,272,0.79,145,288,433,91,32,60,119,308,581
2792,4,1985,25,1,5,56,0,542,60,129,0.465,0,0,-1,60,129,0.465,79,97,0.814,48,96,144,38,20,25,44,98,199
2792,5,1986,26,1,5,80,13,1654,221,440,0.502,0,1,0,221,439,0.503,216,278,0.777,154,285,439,79,42,63,105,298,658
2792,6,1987,27,1,5,76,41,1556,210,405,0.519,0,0,-1,210,405,0.519,229,294,0.779,120,260,380,85,20,74,95,266,649
2792,7,1988,28,1,4,81,74,2166,361,668,0.54,0,2,0,361,666,0.542,407,487,0.836,200,462,662,106,62,92,155,323,1129
2792,8,1989,29,1,5,76,64,1918,317,607,0.522,3,9,0.333,314,598,0.525,332,402,0.826,142,358,500,105,42,81,160,320,969
2792,9,1990,30,1,5,53,22,1194,163,330,0.494,0,4,0,163,326,0.5,225,264,0.852,117,225,342,61,41,45,72,200,551
2792,10,1991,31,1,5,82,38,2228,298,597,0.499,0,5,0,298,592,0.503,274,328,0.835,174,361,535,98,55,61,106,264,870
2792,11,1992,32,1,5,43,4,726,83,199,0.417,0,0,-1,83,199,0.417,74,96,0.771,58,110,168,34,19,19,41,98,240
2792,12,1993,33,1,5,70,7,1124,105,263,0.399,0,3,0,105,260,0.404,112,137,0.818,72,177,249,78,36,36,65,148,322
2792,13,1994,34,1,5,13,0,133,14,38,0.368,0,0,-1,14,38,0.368,8,10,0.8,15,19,34,8,5,2,9,18,36
2792,13,1994,34,1,5,23,6,230,14,46,0.304,0,0,-1,14,46,0.304,21,22,0.955,16,29,45,5,5,8,14,27,49
2792,13,1994,34,1,5,36,6,363,28,84,0.333,0,0,-1,28,84,0.333,29,32,0.906,31,48,79,13,10,10,23,45,85
2792,14,1995,35,1,5,69,27,823,126,248,0.508,1,1,1,125,247,0.506,50,69,0.725,57,151,208,89,20,37,64,170,303
2792,15,1996,36,1,5,32,6,399,32,94,0.34,0,0,-1,32,94,0.34,37,46,0.804,29,60,89,9,11,16,23,60,101
2792,16,1997,37,1,4,45,6,540,47,120,0.392,0,1,0,47,119,0.395,39,52,0.75,41,84,125,14,15,16,27,74,133
2792,17,1998,38,1,5,74,33,1272,155,371,0.418,0,0,-1,155,371,0.418,96,119,0.807,97,145,242,44,34,33,61,182,406
2792,18,1999,39,1,5,19,1,143,11,29,0.379,0,0,-1,11,29,0.379,6,8,0.75,3,11,14,4,1,2,8,23,28
2794,1,1991,23,1,5,39,0,227,20,39,0.513,0,0,-1,20,39,0.513,19,21,0.905,21,24,45,9,6,2,4,20,59
2794,2,1993,25,1,5,29,5,166,25,48,0.521,0,0,-1,25,48,0.521,16,24,0.667,15,21,36,5,6,1,5,37,66
2794,3,1994,26,1,5,35,1,152,28,46,0.609,0,0,-1,28,46,0.609,19,20,0.95,11,15,26,6,7,0,8,25,75
2794,4,1995,27,1,5,18,0,102,12,23,0.522,0,0,-1,12,23,0.522,15,18,0.833,8,15,23,4,2,2,3,9,39
2794,5,1996,28,1,5,35,2,181,24,45,0.533,1,5,0.2,23,40,0.575,9,19,0.474,15,18,33,2,6,2,8,25,58
2796,1,1985,30,1,5,39,0,268,21,51,0.412,0,0,-1,21,51,0.412,10,20,0.5,18,58,76,11,8,11,15,48,52
2798,1,2006,23,1,5,20,0,149,16,26,0.615,0,0,-1,16,26,0.615,4,13,0.308,8,21,29,7,1,3,5,21,36
2798,2,2007,24,1,5,11,0,118,7,23,0.304,0,0,-1,7,23,0.304,5,7,0.714,10,15,25,1,2,4,4,25,19
2807,1,1984,22,1,2,74,49,1637,334,690,0.484,8,34,0.235,326,656,0.497,112,139,0.806,50,114,164,177,81,19,116,174,788
2807,2,1985,23,1,2,81,65,2305,541,1003,0.539,26,60,0.433,515,943,0.546,187,228,0.82,57,153,210,244,100,17,138,197,1295
2807,3,1986,24,1,2,76,62,2190,507,989,0.513,22,61,0.361,485,928,0.523,138,176,0.784,55,134,189,164,85,15,110,167,1174
2807,4,1987,25,1,2,82,82,2729,554,1134,0.489,65,149,0.436,489,985,0.496,224,251,0.892,63,223,286,281,125,18,144,163,1397
2807,5,1988,26,1,2,81,81,3048,710,1348,0.527,62,179,0.346,648,1169,0.554,272,317,0.858,76,257,333,335,155,27,161,204,1754
2807,6,1989,27,1,2,74,73,2605,588,1198,0.491,77,193,0.399,511,1005,0.508,195,226,0.863,72,230,302,231,114,27,157,181,1448
2807,7,1990,28,1,2,77,77,2593,472,1005,0.47,93,220,0.423,379,785,0.483,160,209,0.766,51,191,242,274,77,31,122,180,1197
2807,8,1991,29,1,2,82,82,2630,501,1051,0.477,71,219,0.324,430,832,0.517,118,148,0.797,54,192,246,177,95,21,85,146,1191
2807,9,1992,30,1,2,82,82,2679,460,1005,0.458,54,157,0.344,406,848,0.479,244,291,0.838,74,236,310,226,105,28,119,140,1218
2807,10,1993,31,1,2,58,53,1677,296,659,0.449,44,135,0.326,252,524,0.481,156,184,0.848,27,107,134,157,55,13,70,98,792
2807,11,1994,32,1,2,67,2,1197,256,548,0.467,27,74,0.365,229,474,0.483,157,195,0.805,19,91,110,133,62,9,103,80,696
2807,12,1995,33,1,1,80,1,1528,265,583,0.455,79,203,0.389,186,380,0.489,193,227,0.85,18,133,151,108,61,13,119,123,802
2807,13,1996,34,1,2,80,0,1894,271,676,0.401,74,221,0.335,197,455,0.433,203,243,0.835,40,152,192,123,63,22,100,126,819
2807,14,1997,35,1,2,79,8,1440,163,379,0.43,73,188,0.388,90,191,0.471,127,151,0.841,21,97,118,99,46,16,53,72,526
2808,1,1980,24,1,3,79,-1,1303,127,301,0.422,1,3,0.333,126,298,0.423,95,122,0.779,89,139,228,98,47,53,92,101,350
2808,2,1981,25,1,3,82,-1,1423,173,348,0.497,1,6,0.167,172,342,0.503,97,127,0.764,101,167,268,114,60,70,77,124,444
2808,3,1982,26,1,3,81,38,1740,189,380,0.497,0,2,0,189,378,0.5,108,148,0.73,97,197,294,149,59,70,98,169,486
2808,4,1983,27,1,3,81,9,1139,124,259,0.479,0,2,0,124,257,0.482,81,110,0.736,60,164,224,97,48,31,64,133,329
2808,5,1984,28,1,3,65,5,735,55,124,0.444,1,2,0.5,54,122,0.443,56,72,0.778,29,71,100,48,19,20,42,85,167
2808,6,1985,29,1,3,77,18,1238,111,259,0.429,1,5,0.2,110,254,0.433,53,74,0.716,46,115,161,127,39,25,60,125,276
2809,1,1980,31,1,2,69,-1,1860,276,688,0.401,2,11,0.182,274,677,0.405,85,118,0.72,51,115,166,250,47,23,163,197,639
2810,1,1986,23,1,3,64,12,969,142,315,0.451,3,7,0.429,139,308,0.451,110,152,0.724,70,128,198,88,23,10,84,166,397
2810,2,1987,24,1,3,81,5,1711,265,561,0.472,33,69,0.478,232,492,0.472,193,260,0.742,87,216,303,161,50,16,110,224,756
2810,3,1988,25,1,3,82,4,1587,246,539,0.456,5,32,0.156,241,507,0.475,201,266,0.756,102,177,279,159,42,32,108,189,698
2810,4,1989,26,1,4,37,1,845,112,263,0.426,2,16,0.125,110,247,0.445,127,161,0.789,56,110,166,86,24,9,56,118,353
2810,4,1989,26,1,4,32,12,1005,162,315,0.514,5,19,0.263,157,296,0.53,146,189,0.772,70,159,229,93,29,10,77,102,475
2810,4,1989,26,1,4,69,13,1850,274,578,0.474,7,35,0.2,267,543,0.492,273,350,0.78,126,269,395,179,53,19,133,220,828
2810,5,1990,27,1,4,78,18,2573,424,822,0.516,17,48,0.354,407,774,0.526,402,490,0.82,149,471,620,247,59,16,180,271,1267
2810,6,1991,28,1,4,82,3,2632,432,831,0.52,15,40,0.375,417,791,0.527,441,539,0.818,178,482,660,301,58,22,175,262,1320
2810,7,1992,29,1,4,80,4,2605,496,925,0.536,23,71,0.324,473,854,0.554,365,441,0.828,202,568,770,312,62,37,191,286,1380
2810,8,1993,30,1,4,82,60,3098,517,1085,0.476,8,52,0.154,509,1033,0.493,525,653,0.804,210,570,780,493,79,27,243,305,1567
2810,9,1994,31,1,3,81,80,2728,445,903,0.493,22,68,0.324,423,835,0.507,300,390,0.769,144,310,454,275,73,9,173,273,1212
2810,10,1995,32,1,3,82,82,2886,521,997,0.523,93,181,0.514,428,816,0.525,437,521,0.839,135,373,508,310,93,35,176,252,1572
2810,11,1996,33,1,3,63,60,2200,360,740,0.486,73,179,0.408,287,561,0.512,287,370,0.776,73,255,328,276,56,8,146,179,1080
2810,12,1997,34,1,3,61,60,2192,356,724,0.492,57,161,0.354,299,563,0.531,253,316,0.801,87,307,394,266,63,16,150,151,1022
2810,13,1998,35,1,3,78,78,2742,437,898,0.487,61,147,0.415,376,751,0.501,297,352,0.844,135,419,554,341,60,19,168,205,1232
2810,14,1999,36,1,3,50,39,1765,259,549,0.472,34,86,0.395,225,463,0.486,200,243,0.823,77,293,370,184,41,26,103,152,752
2810,15,2000,37,1,3,77,6,1662,187,433,0.432,21,52,0.404,166,381,0.436,179,215,0.833,79,253,332,197,37,17,100,182,574
2810,16,2001,38,1,3,26,0,397,39,95,0.411,3,8,0.375,36,87,0.414,23,27,0.852,17,61,78,44,7,3,28,43,104
2811,1,1991,22,1,2,82,73,2336,503,1183,0.425,125,334,0.374,378,849,0.445,153,204,0.75,62,173,235,134,62,25,127,203,1284
2811,2,1992,23,1,3,18,15,608,133,331,0.402,29,89,0.326,104,242,0.43,64,71,0.901,14,52,66,35,20,9,31,49,359
2811,3,1993,24,1,3,54,43,1759,329,763,0.431,108,268,0.403,221,495,0.446,92,117,0.786,38,148,186,136,57,18,104,131,858
2811,4,1994,25,1,3,82,37,2283,384,949,0.405,155,388,0.399,229,561,0.408,123,159,0.774,54,164,218,216,81,32,93,161,1046
2811,5,1995,26,1,3,62,10,1499,283,645,0.439,150,352,0.426,133,293,0.454,86,114,0.754,25,121,146,131,45,14,57,119,802
2811,6,1996,27,1,3,82,82,3041,491,1117,0.44,267,628,0.425,224,489,0.458,182,222,0.82,63,246,309,243,90,29,122,169,1431
2811,7,1997,28,1,3,66,62,2166,298,749,0.398,147,373,0.394,151,376,0.402,80,101,0.792,40,163,203,139,74,19,81,138,823
2811,8,1998,29,1,3,29,3,493,71,162,0.438,31,69,0.449,40,93,0.43,8,12,0.667,8,42,50,24,10,7,12,31,181
2811,8,1998,29,1,3,52,42,1797,258,666,0.387,94,273,0.344,164,393,0.417,97,118,0.822,39,158,197,129,43,32,92,121,707
2811,8,1998,29,1,3,81,45,2290,329,828,0.397,125,342,0.365,204,486,0.42,105,130,0.808,47,200,247,153,53,39,104,152,888
2811,9,1999,30,1,3,15,0,206,17,56,0.304,8,29,0.276,9,27,0.333,1,4,0.25,3,17,20,8,3,1,5,17,43
2811,9,1999,30,1,3,21,9,532,70,157,0.446,29,68,0.426,41,89,0.461,22,27,0.815,5,33,38,32,12,2,14,32,191
2811,9,1999,30,1,3,36,9,738,87,213,0.408,37,97,0.381,50,116,0.431,23,31,0.742,8,50,58,40,15,3,19,49,234
2811,10,2000,31,1,3,66,0,1263,125,333,0.375,71,189,0.376,54,144,0.375,48,57,0.842,16,90,106,69,28,9,30,104,369
2816,1,1986,23,1,3,78,0,1168,142,301,0.472,1,11,0.091,141,290,0.486,78,126,0.619,97,145,242,85,78,66,96,171,363
2816,2,1987,24,1,3,69,5,753,123,247,0.498,4,13,0.308,119,234,0.509,94,134,0.701,97,101,198,57,55,54,56,124,344
2816,3,1988,25,1,3,29,0,447,54,116,0.466,3,8,0.375,51,108,0.472,27,39,0.692,29,52,81,49,47,22,41,78,138
2816,3,1988,25,1,3,33,0,455,55,118,0.466,3,8,0.375,52,110,0.473,27,39,0.692,30,54,84,50,49,23,43,81,140
2819,1,1993,22,1,3,58,2,672,136,319,0.426,7,31,0.226,129,288,0.448,51,74,0.689,60,52,112,47,36,7,58,74,330
2819,2,1994,23,1,3,43,5,623,111,274,0.405,4,16,0.25,107,258,0.415,59,87,0.678,43,75,118,48,31,8,51,84,285
2819,3,1995,24,1,2,60,41,1604,291,669,0.435,22,73,0.301,269,596,0.451,174,223,0.78,77,137,214,107,72,25,83,173,778
2819,4,1996,25,1,3,62,48,1601,272,655,0.415,21,100,0.21,251,555,0.452,147,184,0.799,76,164,240,116,84,28,113,150,712
2819,5,1997,26,1,2,80,79,2456,373,942,0.396,79,222,0.356,294,720,0.408,254,290,0.876,59,179,238,165,124,45,154,185,1079
2819,6,1998,27,1,3,77,10,1641,216,505,0.428,9,41,0.22,207,464,0.446,150,182,0.824,48,171,219,100,65,20,79,156,591
2819,7,1999,28,1,3,31,7,731,95,231,0.411,6,23,0.261,89,208,0.428,55,61,0.902,23,69,92,36,30,5,33,68,251
2819,8,2000,29,1,3,82,61,2392,371,780,0.476,10,35,0.286,361,745,0.485,177,218,0.812,119,233,352,197,76,19,110,197,929
2825,1,1989,23,1,5,78,62,1962,333,744,0.448,1,4,0.25,332,740,0.449,181,354,0.511,204,345,549,55,46,96,200,258,848
2825,2,1990,24,1,5,74,72,2409,486,968,0.502,0,1,0,486,967,0.503,256,431,0.594,253,513,766,78,78,124,236,258,1228
2825,3,1991,25,1,5,64,59,2171,395,822,0.481,2,6,0.333,393,816,0.482,258,417,0.619,207,502,709,95,51,86,205,213,1050
2825,4,1992,26,1,5,79,78,2800,463,947,0.489,0,3,0,463,944,0.49,370,505,0.733,307,627,934,109,40,121,216,278,1296
2825,5,1993,27,1,5,72,64,2456,417,868,0.48,1,8,0.125,416,860,0.484,397,540,0.735,259,587,846,100,38,83,203,260,1232
2825,6,1994,28,1,5,72,60,2410,392,803,0.488,0,2,0,392,801,0.489,304,422,0.72,244,496,740,136,59,100,195,279,1088
2825,7,1995,29,1,5,36,35,1035,162,314,0.516,0,0,-1,162,314,0.516,111,160,0.694,77,189,266,45,20,37,104,122,435
2825,8,1996,30,1,5,64,60,1813,285,568,0.502,2,3,0.667,283,565,0.501,204,282,0.723,166,333,499,71,40,69,180,219,776
2825,9,1997,31,1,5,74,68,2615,460,907,0.507,0,3,0,460,904,0.509,357,500,0.714,274,427,701,92,49,107,218,275,1277
2825,10,1998,32,1,5,9,2,152,13,41,0.317,0,0,-1,13,41,0.317,16,27,0.593,16,20,36,8,3,4,12,27,42
2825,10,1998,32,1,5,47,47,1484,237,538,0.441,0,2,0,237,536,0.442,230,305,0.754,130,227,357,69,25,39,134,137,704
2825,10,1998,32,1,5,56,49,1636,250,579,0.432,0,2,0,250,577,0.433,246,332,0.741,146,247,393,77,28,43,146,164,746
2826,1,2012,20,1,1,28,0,237,25,72,0.347,2,15,0.133,23,57,0.404,11,14,0.786,2,13,15,30,7,0,29,17,63
2828,1,2007,20,1,5,28,3,169,18,49,0.367,0,0,-1,18,49,0.367,17,29,0.586,16,29,45,0,3,12,11,33,53
2830,1,2002,25,1,3,9,0,142,22,44,0.5,0,0,-1,22,44,0.5,14,20,0.7,7,13,20,8,3,2,2,18,58
2830,2,2003,26,1,3,45,4,448,41,107,0.383,0,0,-1,41,107,0.383,12,21,0.571,34,39,73,23,14,5,25,62,94
2830,3,2004,27,1,3,57,2,583,81,178,0.455,6,21,0.286,75,157,0.478,32,46,0.696,43,49,92,19,19,20,23,66,200
2830,4,2005,28,1,3,16,0,128,17,42,0.405,2,8,0.25,15,34,0.441,13,24,0.542,18,20,38,12,2,3,8,16,49
2831,1,2005,19,1,5,19,0,104,10,23,0.435,0,0,-1,10,23,0.435,6,11,0.545,6,12,18,2,1,5,12,21,26
2831,2,2006,20,1,5,27,4,212,18,31,0.581,0,0,-1,18,31,0.581,8,17,0.471,14,35,49,1,3,8,14,41,44
2836,1,1998,21,1,1,20,0,146,19,58,0.328,0,2,0,19,56,0.339,23,30,0.767,2,5,7,36,7,1,21,27,61
2839,1,1989,24,1,5,65,4,944,121,248,0.488,0,2,0,121,246,0.492,115,167,0.689,96,136,232,22,14,13,46,94,357
2839,2,1991,26,1,5,57,0,510,51,116,0.44,0,0,-1,51,116,0.44,48,79,0.608,58,76,134,11,14,20,27,75,150
2848,1,1981,23,1,3,55,-1,586,100,219,0.457,0,1,0,100,218,0.459,35,58,0.603,59,79,138,27,18,5,61,128,235
2849,1,1980,24,1,4,76,-1,2243,425,802,0.53,1,5,0.2,424,797,0.532,184,241,0.763,199,383,582,145,92,79,169,292,1035
2849,2,1981,25,1,4,14,-1,440,73,174,0.42,0,0,-1,73,174,0.42,36,55,0.655,31,47,78,35,22,3,41,48,182
2849,3,1982,26,1,4,81,81,2667,508,1046,0.486,0,8,0,508,1038,0.489,188,240,0.783,161,348,509,252,99,43,199,317,1204
2849,4,1983,27,1,4,82,79,2572,437,915,0.478,1,6,0.167,436,909,0.48,141,187,0.754,158,337,495,237,75,72,172,310,1016
2849,5,1984,28,1,4,79,78,2101,371,779,0.476,1,5,0.2,370,774,0.478,107,140,0.764,140,241,381,179,76,55,165,279,850
2849,6,1985,29,1,4,57,14,1244,158,363,0.435,0,5,0,158,358,0.441,51,77,0.662,82,185,267,96,44,18,74,187,367
2849,7,1986,30,1,4,44,1,682,92,188,0.489,0,2,0,92,186,0.495,14,16,0.875,38,105,143,61,21,4,48,128,198
2851,1,1983,23,1,1,64,37,1624,171,421,0.406,1,13,0.077,170,408,0.417,52,80,0.65,43,106,149,311,96,14,104,112,395
2852,1,1999,24,1,2,18,5,185,15,39,0.385,2,7,0.286,13,32,0.406,8,13,0.615,6,16,22,16,3,0,7,12,40
2860,1,1980,22,1,3,62,-1,1636,461,916,0.503,0,6,0,461,910,0.507,134,165,0.812,119,197,316,123,63,9,122,186,1056
2860,2,1981,23,1,3,79,-1,2309,549,1157,0.475,3,17,0.176,546,1140,0.479,168,205,0.82,151,240,391,249,78,19,143,244,1269
2860,3,1982,24,1,3,76,8,1782,456,935,0.488,6,28,0.214,450,907,0.496,177,221,0.801,123,143,266,209,65,10,122,220,1095
2860,4,1983,25,1,3,67,57,2397,589,1209,0.487,4,15,0.267,585,1194,0.49,255,308,0.828,145,209,354,228,94,14,194,242,1437
2860,5,1984,26,1,3,79,76,2945,714,1509,0.473,22,72,0.306,692,1437,0.482,353,445,0.793,184,254,438,246,103,11,228,252,1803
2860,6,1985,27,1,3,78,77,3081,819,1780,0.46,47,150,0.313,772,1630,0.474,501,613,0.817,157,241,398,234,116,27,241,255,2186
2860,7,1986,28,1,3,64,63,2427,633,1313,0.482,15,49,0.306,618,1264,0.489,351,406,0.865,126,203,329,237,92,22,184,229,1632
2860,8,1987,29,1,3,34,15,950,240,501,0.479,4,17,0.235,236,484,0.488,137,160,0.856,55,82,137,86,45,7,68,103,621
2860,9,1988,30,1,2,81,11,1949,474,986,0.481,5,21,0.238,469,965,0.486,206,240,0.858,71,151,222,162,58,14,118,197,1159
2860,10,1989,31,1,3,65,16,1157,198,480,0.413,9,33,0.273,189,447,0.423,77,89,0.865,65,114,179,107,44,13,70,116,482
2860,11,1990,32,1,3,82,24,2213,432,950,0.455,10,35,0.286,422,915,0.461,198,237,0.835,101,147,248,145,66,20,119,202,1072
2863,1,1981,24,1,1,47,-1,450,34,95,0.358,0,5,0,34,90,0.378,25,32,0.781,11,32,43,70,23,1,28,38,93
2863,2,1982,25,1,1,51,0,800,91,194,0.469,1,9,0.111,90,185,0.486,29,38,0.763,14,41,55,117,33,1,42,63,212
2863,3,1983,26,1,1,78,58,2435,316,661,0.478,3,18,0.167,313,643,0.487,92,107,0.86,33,122,155,433,104,2,138,185,727
2863,4,1984,27,1,1,80,80,2497,397,746,0.532,6,20,0.3,391,726,0.539,117,135,0.867,44,127,171,457,90,8,144,179,917
2863,5,1985,28,1,1,70,25,1808,325,624,0.521,9,37,0.243,316,587,0.538,112,128,0.875,24,90,114,264,47,4,102,116,771
2863,6,1986,29,1,1,82,7,1596,235,412,0.57,6,16,0.375,229,396,0.578,61,66,0.924,27,77,104,188,50,0,73,118,537
2863,7,1987,30,1,1,78,15,1566,202,398,0.508,7,26,0.269,195,372,0.524,37,42,0.881,22,69,91,187,40,1,61,124,448
2863,8,1988,31,1,1,28,0,324,49,90,0.544,8,14,0.571,41,76,0.539,9,11,0.818,4,11,15,33,7,0,8,30,115
2863,8,1988,31,1,1,24,1,370,44,82,0.537,2,8,0.25,42,74,0.568,8,12,0.667,5,16,21,60,14,0,14,30,98
2863,8,1988,31,1,1,52,1,694,93,172,0.541,10,22,0.455,83,150,0.553,17,23,0.739,9,27,36,93,21,0,22,60,213
2863,9,1989,32,1,1,25,1,390,46,104,0.442,3,12,0.25,43,92,0.467,7,8,0.875,9,20,29,59,15,0,25,17,102
2863,10,1990,33,1,1,34,8,469,50,119,0.42,3,12,0.25,47,107,0.439,15,18,0.833,3,16,19,92,16,2,22,39,118
2863,10,1990,33,1,1,35,8,496,50,125,0.4,3,12,0.25,47,113,0.416,18,22,0.818,3,16,19,94,16,2,22,40,121
2867,1,1980,24,1,5,82,-1,2793,470,989,0.475,0,1,0,470,988,0.476,235,292,0.805,198,710,908,279,68,77,202,232,1175
2867,2,1981,25,1,5,82,-1,2920,595,1311,0.454,0,5,0,595,1306,0.456,340,413,0.823,184,668,852,248,78,93,201,282,1530
2867,3,1982,26,1,5,82,82,3049,581,1212,0.479,2,13,0.154,579,1199,0.483,447,523,0.855,223,815,1038,277,102,107,213,268,1611
2867,4,1983,27,1,5,75,71,2564,484,1043,0.464,0,8,0,484,1035,0.468,400,478,0.837,213,645,858,233,87,65,190,263,1368
2867,5,1984,28,1,5,82,82,2993,576,1155,0.499,0,2,0,576,1153,0.5,411,480,0.856,225,686,911,327,95,92,236,301,1563
2867,6,1985,29,1,5,68,68,2402,461,943,0.489,2,10,0.2,459,933,0.492,335,393,0.852,164,559,723,285,83,91,160,239,1259
2867,7,1986,30,1,5,80,78,2790,508,1100,0.462,0,13,0,508,1087,0.467,355,411,0.864,146,602,748,301,92,73,214,293,1371
2867,8,1987,31,1,5,82,82,2536,390,842,0.463,0,2,0,390,840,0.464,265,313,0.847,208,614,822,203,88,90,160,328,1045
2867,9,1988,32,1,5,82,82,2923,514,1058,0.486,3,14,0.214,511,1044,0.489,321,348,0.922,195,514,709,279,93,80,157,316,1352
2867,10,1989,33,1,5,80,80,2587,360,835,0.431,82,216,0.38,278,619,0.449,266,294,0.905,141,482,623,289,85,61,145,300,1068
2867,11,1990,34,1,5,71,70,2250,344,827,0.416,68,199,0.342,276,628,0.439,230,260,0.885,109,383,492,229,76,48,139,244,986
2867,12,1991,35,1,5,77,44,1940,295,691,0.427,46,135,0.341,249,556,0.448,166,197,0.843,108,333,441,143,65,64,130,218,802
2868,1,1980,30,1,1,77,-1,2293,513,999,0.514,0,4,0,513,995,0.516,339,382,0.887,45,122,167,347,61,14,192,206,1365
2868,2,1981,31,1,1,75,-1,2055,476,997,0.477,0,2,0,476,995,0.478,374,440,0.85,44,187,231,285,51,12,159,129,1326
2868,3,1982,32,1,2,67,34,1447,251,573,0.438,0,5,0,251,568,0.442,246,286,0.86,26,83,109,222,40,6,107,109,748
2869,1,1980,36,1,4,82,-1,1595,113,299,0.378,0,0,-1,113,299,0.378,89,136,0.654,204,232,436,66,25,5,83,120,315
2870,1,2011,24,1,5,21,0,101,17,31,0.548,0,0,-1,17,31,0.548,11,22,0.5,16,12,28,3,1,4,10,20,45
2873,1,2006,22,1,4,43,2,414,58,120,0.483,0,0,-1,58,120,0.483,30,34,0.882,38,50,88,7,13,1,24,70,146
2875,1,2007,21,1,4,43,4,534,55,132,0.417,0,0,-1,55,132,0.417,16,33,0.485,44,63,107,12,8,23,22,75,126
2878,1,1991,22,1,3,79,79,2978,549,1301,0.422,3,11,0.273,546,1290,0.423,320,435,0.736,193,504,697,315,113,85,230,249,1421
2878,2,1992,23,1,3,78,78,2895,527,1162,0.454,1,5,0.2,526,1157,0.455,281,365,0.77,149,485,634,337,135,132,218,205,1336
2878,3,1993,24,1,3,69,68,2502,468,1055,0.444,1,11,0.091,467,1044,0.447,298,364,0.819,156,339,495,312,95,38,196,197,1235
2878,4,1994,25,1,3,75,74,2702,436,996,0.438,6,17,0.353,430,979,0.439,251,323,0.777,168,394,562,305,104,50,183,189,1129
2878,5,1995,26,1,3,58,3,1064,131,312,0.42,6,16,0.375,125,296,0.422,59,84,0.702,61,135,196,89,28,23,70,118,327
2878,6,1996,27,1,3,54,5,810,86,217,0.396,19,51,0.373,67,166,0.404,55,75,0.733,41,104,145,83,31,20,51,85,246
2878,7,1997,28,1,3,41,0,521,45,136,0.331,7,30,0.233,38,106,0.358,42,48,0.875,30,74,104,57,8,13,34,63,139
2885,1,2009,23,1,1,13,1,122,12,37,0.324,4,10,0.4,8,27,0.296,6,6,1,5,11,16,12,6,0,5,14,34
2885,1,2009,23,1,1,24,1,181,19,48,0.396,6,15,0.4,13,33,0.394,12,15,0.8,5,14,19,17,5,0,18,31,56
2885,1,2009,23,1,1,37,2,303,31,85,0.365,10,25,0.4,21,60,0.35,18,21,0.857,10,25,35,29,11,0,23,45,90
2887,1,1985,22,1,3,43,0,304,39,94,0.415,0,2,0,39,92,0.424,13,25,0.52,24,36,60,26,7,6,19,50,91
2889,1,1987,22,1,1,13,0,205,18,62,0.29,3,14,0.214,15,48,0.313,10,12,0.833,6,20,26,45,5,1,21,18,49
2889,2,1988,23,1,1,51,2,760,86,209,0.411,6,20,0.3,80,189,0.423,45,54,0.833,11,55,66,180,22,3,76,97,223
2889,3,1989,24,1,1,80,13,1571,198,442,0.448,20,75,0.267,178,367,0.485,130,144,0.903,21,128,149,390,64,2,177,151,546
2889,4,1990,25,1,1,70,32,1460,190,464,0.409,52,132,0.394,138,332,0.416,104,119,0.874,23,136,159,334,36,4,90,126,536
2889,5,1991,26,1,1,79,66,2714,462,1039,0.445,93,228,0.408,369,811,0.455,340,377,0.902,57,213,270,660,89,4,252,192,1357
2889,6,1992,27,1,1,75,63,2377,359,868,0.414,91,250,0.364,268,618,0.434,248,277,0.895,36,166,202,544,74,5,233,188,1057
2889,7,1993,28,1,1,78,78,3086,416,891,0.467,80,235,0.34,336,656,0.512,289,324,0.892,52,238,290,735,86,2,267,244,1201
2889,8,1994,29,1,1,82,46,2303,276,644,0.429,68,165,0.412,208,479,0.434,195,222,0.878,42,147,189,503,47,2,193,171,815
2889,9,1995,30,1,1,62,62,2077,265,583,0.455,96,228,0.421,169,355,0.476,179,202,0.886,26,133,159,452,70,6,172,135,805
2889,10,1996,31,1,1,10,9,236,20,57,0.351,15,34,0.441,5,23,0.217,8,10,0.8,1,15,16,38,7,0,16,21,63
2890,1,1983,22,1,2,63,1,515,89,238,0.374,9,41,0.22,80,197,0.406,38,59,0.644,34,34,68,52,36,7,42,93,225
2895,1,1999,22,1,4,21,0,258,33,71,0.465,0,0,-1,33,71,0.465,20,33,0.606,20,33,53,1,10,13,19,20,86
2895,2,2000,23,1,4,33,9,775,68,134,0.507,0,0,-1,68,134,0.507,43,65,0.662,63,138,201,11,16,44,37,75,179
2895,3,2001,24,1,4,39,23,584,64,161,0.398,0,0,-1,64,161,0.398,32,59,0.542,55,113,168,18,14,11,32,61,160
2895,4,2002,25,1,4,65,8,1107,88,162,0.543,0,0,-1,88,162,0.543,48,79,0.608,93,188,281,17,24,61,42,130,224
2895,5,2003,26,1,4,77,9,1381,182,331,0.55,0,0,-1,182,331,0.55,97,161,0.602,136,230,366,19,47,53,62,176,461
2895,6,2004,27,1,5,56,54,1577,255,513,0.497,0,0,-1,255,513,0.497,79,138,0.572,119,292,411,49,30,61,78,165,589
2895,7,2005,28,1,4,24,0,246,22,57,0.386,0,1,0,22,56,0.393,5,17,0.294,23,39,62,5,5,6,13,29,49
2895,7,2005,28,1,5,25,23,695,82,148,0.554,0,0,-1,82,148,0.554,20,53,0.377,84,134,218,38,26,43,27,73,184
2895,7,2005,28,1,5,49,23,941,104,205,0.507,0,1,0,104,204,0.51,25,70,0.357,107,173,280,43,31,49,40,102,233
2895,8,2006,29,1,4,38,0,429,38,69,0.551,0,0,-1,38,69,0.551,12,27,0.444,30,71,101,17,11,20,18,54,88
2895,8,2006,29,1,5,27,5,515,44,91,0.484,0,0,-1,44,91,0.484,15,29,0.517,46,81,127,13,14,23,27,65,103
2895,8,2006,29,1,4,65,5,944,82,160,0.513,0,0,-1,82,160,0.513,27,56,0.482,76,152,228,30,25,43,45,119,191
2895,9,2007,30,1,4,67,44,1523,124,253,0.49,0,0,-1,124,253,0.49,46,79,0.582,106,279,385,58,18,64,75,195,294
2895,10,2008,31,1,5,66,0,844,92,198,0.465,2,3,0.667,90,195,0.462,33,63,0.524,63,175,238,15,21,77,39,112,219
2895,11,2009,32,1,4,51,21,843,92,205,0.449,0,2,0,92,203,0.453,30,47,0.638,72,131,203,27,17,52,43,94,214
2895,12,2010,33,1,4,16,1,123,10,25,0.4,0,0,-1,10,25,0.4,6,8,0.75,9,18,27,0,3,4,7,20,26
2896,1,2003,22,1,2,36,0,274,39,103,0.379,7,25,0.28,32,78,0.41,7,10,0.7,8,23,31,14,14,3,20,31,92
2896,2,2004,23,1,2,22,0,165,21,60,0.35,4,12,0.333,17,48,0.354,7,14,0.5,10,15,25,14,7,1,11,20,53
2899,1,1985,22,1,2,31,0,151,30,58,0.517,0,2,0,30,56,0.536,13,21,0.619,5,7,12,16,3,0,11,18,73
2904,1,1980,33,1,2,8,-1,135,33,72,0.458,1,5,0.2,32,67,0.478,7,8,0.875,2,12,14,7,3,2,9,21,74
2904,1,1980,33,1,3,70,-1,1988,352,819,0.43,22,76,0.289,330,743,0.444,93,107,0.869,92,153,245,93,59,15,72,188,819
2904,1,1980,33,1,3,78,-1,2123,385,891,0.432,23,81,0.284,362,810,0.447,100,115,0.87,94,165,259,100,62,17,81,209,893
2907,1,1989,23,1,4,71,56,2161,435,878,0.495,0,3,0,435,875,0.497,285,393,0.725,173,292,465,103,68,89,146,273,1155
2907,2,1990,24,1,4,78,76,2732,595,1145,0.52,1,12,0.083,594,1133,0.524,454,572,0.794,177,347,524,114,86,119,162,294,1645
2907,3,1991,25,1,3,74,74,2703,548,1168,0.469,0,7,0,548,1161,0.472,384,484,0.793,216,392,608,134,81,145,165,267,1480
2907,4,1992,26,1,3,49,25,1310,251,539,0.466,0,6,0,251,533,0.471,212,270,0.785,95,206,301,56,41,98,69,159,714
2907,5,1993,27,1,3,81,68,2172,358,764,0.469,0,2,0,358,762,0.47,287,367,0.782,170,262,432,142,48,96,155,254,1003
2907,6,1994,28,1,3,43,21,1105,176,397,0.443,8,16,0.5,168,381,0.441,87,121,0.719,66,99,165,50,26,45,64,144,447
2907,7,1995,29,1,3,76,58,2150,352,747,0.471,7,31,0.226,345,716,0.482,255,322,0.792,144,180,324,120,49,95,147,286,966
2907,8,1996,30,1,4,32,30,826,130,284,0.458,0,0,-1,130,284,0.458,46,60,0.767,74,128,202,36,32,29,45,100,306
2907,8,1996,30,1,4,41,4,890,114,294,0.388,2,15,0.133,112,279,0.401,73,103,0.709,59,101,160,29,18,51,61,124,303
2907,8,1996,30,1,4,73,34,1716,244,578,0.422,2,15,0.133,242,563,0.43,119,163,0.73,133,229,362,65,50,80,106,224,609
2907,9,1997,31,1,4,19,7,329,34,84,0.405,0,1,0,34,83,0.41,20,26,0.769,18,47,65,14,13,22,22,44,88
2908,1,1993,22,1,2,80,6,1266,125,289,0.433,2,14,0.143,123,275,0.447,95,120,0.792,32,64,96,196,48,16,68,96,347
2908,2,1994,23,1,1,80,16,1617,184,423,0.435,10,39,0.256,174,384,0.453,95,141,0.674,15,107,122,285,38,18,101,131,473
2908,3,1995,24,1,2,64,17,1073,116,264,0.439,47,108,0.435,69,156,0.442,41,63,0.651,14,59,73,146,32,22,50,119,320
2909,1,2007,23,1,4,82,5,1537,246,463,0.531,0,6,0,246,457,0.538,116,186,0.624,149,267,416,49,51,18,74,223,608
2909,2,2008,24,1,4,77,11,1547,297,528,0.563,0,9,0,297,519,0.572,133,200,0.665,123,230,353,60,36,17,89,217,727
2909,3,2009,25,1,4,74,31,1460,289,514,0.562,0,1,0,289,513,0.563,168,248,0.677,98,186,284,79,31,19,105,184,746
2909,4,2010,26,1,4,75,2,1232,226,397,0.569,1,5,0.2,225,392,0.574,132,208,0.635,97,190,287,84,33,25,88,194,585
2909,5,2011,27,1,4,48,0,586,104,188,0.553,0,5,0,104,183,0.568,50,68,0.735,43,74,117,31,16,7,33,84,258
2909,6,2012,28,1,4,47,0,464,59,117,0.504,0,1,0,59,116,0.509,38,53,0.717,33,77,110,19,16,5,24,55,156
2911,1,1983,21,1,3,27,0,154,21,51,0.412,0,2,0,21,49,0.429,17,25,0.68,10,28,38,2,0,4,11,40,59
2911,2,1984,22,1,2,61,20,1297,238,436,0.546,1,6,0.167,237,430,0.551,123,163,0.755,54,116,170,82,33,22,78,165,600
2911,3,1985,23,1,2,80,80,2762,682,1271,0.537,3,19,0.158,679,1252,0.542,400,504,0.794,174,253,427,216,77,52,230,317,1767
2911,4,1986,24,1,2,11,9,339,100,181,0.552,1,2,0.5,99,179,0.553,58,84,0.69,20,21,41,31,9,13,33,35,259
2911,5,1987,25,1,2,52,42,1658,338,757,0.446,9,33,0.273,329,724,0.454,178,228,0.781,60,122,182,204,46,23,126,184,863
2911,6,1988,26,1,2,35,18,899,174,364,0.478,8,23,0.348,166,341,0.487,87,113,0.77,35,68,103,89,21,17,48,108,443
2911,7,1989,27,1,2,29,20,600,111,276,0.402,3,15,0.2,108,261,0.414,64,95,0.674,30,51,81,60,19,8,44,64,289
2911,7,1989,27,1,2,36,18,695,105,220,0.477,4,16,0.25,101,204,0.495,65,93,0.699,31,55,86,68,24,15,44,100,279
2911,7,1989,27,1,2,65,38,1295,216,496,0.435,7,31,0.226,209,465,0.449,129,188,0.686,61,106,167,128,43,23,88,164,568
2911,8,1990,28,1,3,75,7,1405,261,514,0.508,16,36,0.444,245,478,0.513,130,186,0.699,62,110,172,109,35,20,85,198,668
2915,1,2005,21,1,2,38,0,433,44,113,0.389,6,22,0.273,38,91,0.418,33,48,0.688,19,33,52,39,23,5,25,50,127
2915,2,2006,22,1,2,23,0,127,15,27,0.556,2,4,0.5,13,23,0.565,6,12,0.5,3,11,14,9,8,0,4,20,38
2920,1,1992,22,1,4,76,32,1707,291,702,0.415,0,11,0,291,691,0.421,89,121,0.736,129,262,391,129,62,34,97,259,671
2920,2,1993,23,1,4,61,42,1524,289,666,0.434,0,4,0,289,662,0.437,56,74,0.757,96,232,328,104,48,52,115,280,634
2920,3,1994,24,1,4,79,42,1684,295,678,0.435,2,9,0.222,293,669,0.438,106,127,0.835,114,235,349,119,82,38,93,287,698
2920,4,1995,25,1,4,63,0,826,131,314,0.417,1,12,0.083,130,302,0.43,57,75,0.76,43,101,144,44,29,26,37,132,320
2921,1,1982,23,1,4,72,3,858,86,169,0.509,0,0,-1,86,169,0.509,39,85,0.459,72,110,182,46,22,51,47,185,211
2922,1,1996,20,1,4,82,82,2821,469,1024,0.458,10,28,0.357,459,996,0.461,303,392,0.773,300,417,717,79,85,134,138,224,1251
2922,2,1997,21,1,4,80,80,3086,587,1293,0.454,12,46,0.261,575,1247,0.461,307,377,0.814,261,418,679,125,74,86,192,244,1493
2922,3,1998,22,1,4,30,6,699,121,270,0.448,0,1,0,121,269,0.45,67,85,0.788,58,75,133,27,18,13,52,94,309
2922,3,1998,22,1,4,49,49,1645,343,800,0.429,0,7,0,343,793,0.433,160,208,0.769,141,197,338,67,44,38,106,169,846
2922,3,1998,22,1,4,79,55,2344,464,1070,0.434,0,8,0,464,1062,0.437,227,293,0.775,199,272,471,94,62,51,158,263,1155
2922,4,1999,23,1,5,43,42,1418,223,522,0.427,0,3,0,223,519,0.43,142,188,0.755,154,200,354,68,32,66,66,147,588
2922,5,2000,24,1,5,78,9,1975,289,623,0.464,1,1,1,288,622,0.463,195,258,0.756,186,298,484,88,45,85,119,302,774
2922,6,2001,25,1,4,69,59,1941,308,765,0.403,0,5,0,308,760,0.405,231,287,0.805,160,331,491,79,47,50,88,258,847
2922,7,2002,26,1,5,72,63,1922,297,581,0.511,2,3,0.667,295,578,0.51,171,206,0.83,152,301,453,82,39,59,86,250,767
2922,8,2003,27,1,3,54,21,1117,151,328,0.46,0,2,0,151,326,0.463,102,131,0.779,111,159,270,38,14,55,43,171,404
2922,9,2004,28,1,4,76,76,2254,311,708,0.439,1,5,0.2,310,703,0.441,207,241,0.859,230,413,643,78,47,94,82,209,830
2922,10,2005,29,1,4,74,73,2265,319,621,0.514,0,1,0,319,620,0.515,175,228,0.768,179,362,541,67,43,38,79,222,813
2922,11,2006,30,1,4,44,5,887,145,305,0.475,0,2,0,145,303,0.479,89,115,0.774,83,147,230,31,24,13,40,120,379
2922,12,2007,31,1,4,11,0,148,23,48,0.479,0,1,0,23,47,0.489,10,12,0.833,13,27,40,3,6,7,13,23,56
2922,12,2007,31,1,4,54,11,1355,191,429,0.445,0,4,0,191,425,0.449,115,136,0.846,107,253,360,46,31,20,63,125,497
2922,12,2007,31,1,4,65,11,1503,214,477,0.449,0,5,0,214,472,0.453,125,148,0.845,120,280,400,49,37,27,76,148,553
2922,13,2008,32,1,4,27,1,580,87,170,0.512,0,2,0,87,168,0.518,45,69,0.652,55,81,136,19,9,16,22,73,219
2922,13,2008,32,1,4,50,35,1146,225,483,0.466,0,1,0,225,482,0.467,109,135,0.807,108,157,265,47,25,31,49,113,559
2922,13,2008,32,1,4,77,36,1726,312,653,0.478,0,3,0,312,650,0.48,154,204,0.755,163,238,401,66,34,47,71,186,778
2922,14,2009,33,1,5,21,0,411,57,115,0.496,1,3,0.333,56,112,0.5,21,28,0.75,36,64,100,16,7,14,10,50,136
2922,14,2009,33,1,5,36,3,691,99,218,0.454,2,4,0.5,97,214,0.453,38,54,0.704,53,110,163,25,10,26,15,72,238
2922,14,2009,33,1,5,57,3,1102,156,333,0.468,3,7,0.429,153,326,0.469,59,82,0.72,89,174,263,41,17,40,25,122,374
2922,15,2010,34,1,4,64,1,592,77,193,0.399,1,7,0.143,76,186,0.409,39,48,0.813,66,91,157,21,6,19,22,95,194
2924,1,1987,22,1,2,42,4,461,57,150,0.38,3,9,0.333,54,141,0.383,21,28,0.75,13,19,32,43,25,3,30,74,138
2926,1,1988,22,1,1,61,60,2170,331,694,0.477,12,39,0.308,319,655,0.487,167,204,0.819,40,98,138,434,92,8,184,140,841
2926,2,1989,23,1,1,81,81,3145,547,1183,0.462,46,128,0.359,501,1055,0.475,263,357,0.737,49,177,226,621,102,7,249,173,1403
2926,3,1990,24,1,1,33,5,674,98,204,0.48,4,24,0.167,94,180,0.522,55,65,0.846,7,30,37,142,22,1,47,45,255
2926,3,1990,24,1,1,46,46,1747,280,607,0.461,22,59,0.373,258,548,0.471,106,131,0.809,11,109,120,303,57,7,122,98,688
2926,3,1990,24,1,1,79,51,2421,378,811,0.466,26,83,0.313,352,728,0.484,161,196,0.821,18,139,157,445,79,8,169,143,943
2926,4,1991,25,1,1,78,78,2699,522,1003,0.52,49,135,0.363,473,868,0.545,287,340,0.844,36,127,163,554,106,11,237,131,1380
2926,5,1992,26,1,1,81,80,2735,432,910,0.475,54,137,0.394,378,773,0.489,219,253,0.866,34,143,177,562,104,7,227,112,1137
2926,6,1993,27,1,1,82,82,2422,387,744,0.52,96,219,0.438,291,525,0.554,195,222,0.878,28,132,160,446,80,7,163,110,1065
2926,7,1994,28,1,1,78,78,2209,341,711,0.48,89,220,0.405,252,491,0.513,135,155,0.871,24,114,138,327,59,4,126,121,906
2926,8,1995,29,1,1,81,81,2030,287,593,0.484,142,331,0.429,145,262,0.553,126,148,0.851,27,128,155,323,71,10,123,109,842
2926,9,1996,30,1,1,68,56,1617,201,464,0.433,91,238,0.382,110,226,0.487,87,106,0.821,21,75,96,245,47,3,100,116,580
2926,10,1997,31,1,1,33,3,654,87,206,0.422,51,120,0.425,36,86,0.419,35,41,0.854,3,34,37,102,18,0,62,25,260
2926,10,1997,31,1,1,48,3,765,101,239,0.423,59,135,0.437,42,104,0.404,39,45,0.867,4,40,44,116,19,0,71,30,300
2927,1,1992,22,1,2,48,5,708,100,246,0.407,2,21,0.095,98,225,0.436,45,56,0.804,30,51,81,99,44,1,63,98,247
2927,2,1993,23,1,2,69,33,1546,261,570,0.458,8,23,0.348,253,547,0.463,109,127,0.858,26,80,106,186,58,9,103,178,639
2927,3,1994,24,1,2,59,2,829,116,288,0.403,21,60,0.35,95,228,0.417,48,64,0.75,29,47,76,104,37,4,49,88,301
2927,3,1994,24,1,2,66,2,877,124,306,0.405,21,60,0.35,103,246,0.419,63,84,0.75,34,50,84,109,40,5,50,96,332
2928,1,1981,23,1,4,82,-1,2578,304,594,0.512,0,0,-1,304,594,0.512,177,301,0.588,433,561,994,93,70,63,146,316,785
2928,2,1982,24,1,4,74,55,2213,220,412,0.534,0,1,0,220,411,0.535,88,159,0.553,279,534,813,83,65,54,105,291,528
2928,3,1983,25,1,4,49,41,1433,180,306,0.588,0,0,-1,180,306,0.588,53,99,0.535,209,276,485,46,36,20,83,186,413
2928,4,1984,26,1,4,75,63,2091,244,436,0.56,0,0,-1,244,436,0.56,94,168,0.56,282,390,672,72,61,22,124,274,582
2928,5,1985,27,1,4,80,78,2497,366,690,0.53,0,0,-1,366,690,0.53,155,256,0.605,405,464,869,96,78,54,160,285,887
2928,6,1986,28,1,4,77,74,2441,314,586,0.536,0,1,0,314,585,0.537,112,227,0.493,384,472,856,95,62,50,135,286,740
2928,7,1987,29,1,4,80,78,2374,297,544,0.546,0,1,0,297,543,0.547,113,197,0.574,366,551,917,95,71,56,135,295,707
2928,8,1988,30,1,4,20,10,499,58,123,0.472,0,1,0,58,122,0.475,11,27,0.407,79,103,182,25,12,11,36,63,127
2928,9,1989,31,1,4,80,78,1897,219,397,0.552,0,0,-1,219,397,0.552,18,58,0.31,272,380,652,118,61,54,110,248,456
2928,10,1990,32,1,4,74,0,1300,101,213,0.474,0,2,0,101,211,0.479,20,55,0.364,180,272,452,69,56,28,70,203,222
2928,11,1991,33,1,4,81,28,1923,128,263,0.487,0,0,-1,128,263,0.487,12,50,0.24,302,407,709,88,83,22,93,265,268
2928,12,1992,34,1,4,45,7,800,50,92,0.543,0,1,0,50,91,0.549,4,11,0.364,107,149,256,33,21,7,44,121,104
2928,13,1993,35,1,4,66,13,833,38,87,0.437,0,0,-1,38,87,0.437,9,22,0.409,103,165,268,28,23,16,39,133,85
2929,1,2001,24,1,3,17,0,180,19,59,0.322,3,18,0.167,16,41,0.39,10,16,0.625,10,12,22,10,5,3,7,8,51
2930,1,1995,22,1,4,82,0,1736,220,406,0.542,0,2,0,220,404,0.545,127,262,0.485,174,312,486,67,61,49,106,235,567
2930,2,1996,23,1,4,65,0,1384,144,238,0.605,1,1,1,143,237,0.603,68,177,0.384,143,246,389,110,47,46,72,166,357
2930,3,1997,24,1,4,81,52,2526,202,375,0.539,0,0,-1,202,375,0.539,128,258,0.496,257,512,769,191,82,60,130,251,532
2930,4,1998,25,1,4,18,4,347,26,61,0.426,0,0,-1,26,61,0.426,17,30,0.567,35,65,100,29,15,9,15,35,69
2930,4,1998,25,1,4,30,29,706,67,133,0.504,0,1,0,67,132,0.508,48,73,0.658,85,121,206,59,26,6,36,60,182
2930,4,1998,25,1,4,48,33,1053,93,194,0.479,0,1,0,93,193,0.482,65,103,0.631,120,186,306,88,41,15,51,95,251
2930,5,1999,26,1,4,48,10,1098,77,144,0.535,0,1,0,77,143,0.538,76,128,0.594,135,215,350,48,46,18,60,107,230
2930,6,2000,27,1,3,46,46,1145,108,192,0.563,0,1,0,108,191,0.565,73,101,0.723,121,210,331,56,27,23,45,127,289
2930,7,2001,28,1,4,79,29,1610,106,218,0.486,0,1,0,106,217,0.488,89,154,0.578,172,390,562,101,57,37,62,156,301
2931,1,1994,23,1,4,43,9,316,29,72,0.403,0,0,-1,29,72,0.403,18,38,0.474,40,59,99,4,12,6,12,47,76
2933,1,1987,23,1,2,28,0,168,33,79,0.418,0,2,0,33,77,0.429,12,21,0.571,17,17,34,22,1,1,19,30,78
2933,2,1988,24,1,2,15,6,191,37,93,0.398,0,0,-1,37,93,0.398,21,28,0.75,16,14,30,11,5,6,12,23,95
2933,2,1988,24,1,2,57,12,1358,288,569,0.506,13,41,0.317,275,528,0.521,157,201,0.781,110,107,217,144,86,36,95,137,746
2933,2,1988,24,1,2,72,18,1549,325,662,0.491,13,41,0.317,312,621,0.502,178,229,0.777,126,121,247,155,91,42,107,160,841
2933,3,1989,25,1,2,80,5,1597,311,715,0.435,7,37,0.189,304,678,0.448,174,218,0.798,128,202,330,140,88,40,129,165,803
2933,4,1990,26,1,3,65,35,1644,348,708,0.492,10,40,0.25,338,668,0.506,169,222,0.761,117,183,300,147,76,57,102,174,875
2933,5,1991,27,1,3,75,39,1885,407,902,0.451,9,46,0.196,398,856,0.465,221,301,0.734,176,213,389,169,85,35,140,190,1044
2933,6,1992,28,1,2,55,5,877,116,318,0.365,8,21,0.381,108,297,0.364,70,91,0.769,40,76,116,57,36,13,62,85,310
2935,1,1980,27,1,2,51,-1,1552,325,685,0.474,7,22,0.318,318,663,0.48,135,171,0.789,28,118,146,187,62,15,121,154,792
2935,2,1981,28,1,2,76,-1,2378,519,1057,0.491,4,18,0.222,515,1039,0.496,237,313,0.757,49,107,156,372,84,18,176,231,1279
2935,3,1982,29,1,2,26,2,596,87,186,0.468,0,3,0,87,183,0.475,40,55,0.727,17,52,69,74,22,8,39,62,214
2935,3,1982,29,1,2,48,39,1446,253,575,0.44,5,24,0.208,248,551,0.45,123,168,0.732,34,83,117,233,45,19,116,151,634
2935,3,1982,29,1,2,74,41,2042,340,761,0.447,5,27,0.185,335,734,0.456,163,223,0.731,51,135,186,307,67,27,155,213,848
2935,4,1983,30,1,2,79,17,1238,175,400,0.438,3,8,0.375,172,392,0.439,101,133,0.759,27,103,130,216,44,8,102,113,454
2936,1,1980,31,1,2,82,-1,2677,599,1326,0.452,10,53,0.189,589,1273,0.463,233,283,0.823,93,163,256,363,125,7,200,190,1441
2936,2,1981,32,1,2,82,-1,2199,486,1043,0.466,1,28,0.036,485,1015,0.478,221,271,0.815,46,147,193,357,113,14,195,132,1194
2936,3,1982,33,1,2,82,40,2033,348,748,0.465,3,11,0.273,345,737,0.468,122,151,0.808,53,102,155,255,91,1,124,199,821
2936,4,1983,34,1,2,15,0,142,29,66,0.439,0,2,0,29,64,0.453,13,14,0.929,2,6,8,14,2,0,9,17,71
2936,4,1983,34,1,2,65,16,1264,244,499,0.489,3,16,0.188,241,483,0.499,101,117,0.863,35,53,88,192,54,0,89,122,592
2936,4,1983,34,1,2,80,16,1406,273,565,0.483,3,18,0.167,270,547,0.494,114,131,0.87,37,59,96,206,56,0,98,139,663
2937,1,1980,25,1,3,30,-1,496,97,230,0.422,8,35,0.229,89,195,0.456,57,63,0.905,22,32,54,42,25,7,33,54,259
2941,1,2004,23,1,3,20,0,178,16,43,0.372,6,12,0.5,10,31,0.323,6,8,0.75,13,28,41,7,5,5,14,18,44
2941,2,2005,24,1,3,33,5,510,44,136,0.324,3,12,0.25,41,124,0.331,14,16,0.875,39,77,116,28,6,4,27,58,105
2942,1,1980,26,1,1,62,-1,1051,121,315,0.384,17,71,0.239,104,244,0.426,40,52,0.769,56,65,121,259,75,1,95,110,299
2943,1,1989,22,1,5,82,71,2041,386,746,0.517,0,1,0,386,745,0.518,184,255,0.722,185,315,500,70,37,151,130,310,956
2943,2,1990,23,1,5,82,82,2404,515,967,0.533,0,1,0,515,966,0.533,241,297,0.811,135,377,512,142,45,169,143,328,1271
2943,3,1991,24,1,5,76,38,1690,342,705,0.485,0,0,-1,342,705,0.485,144,189,0.762,116,241,357,84,24,111,86,246,828
2943,4,1992,25,1,5,74,55,1772,436,855,0.51,0,2,0,436,853,0.511,152,193,0.788,124,293,417,116,29,100,130,231,1024
2943,5,1993,26,1,5,81,81,2072,494,1017,0.486,0,0,-1,494,1017,0.486,167,228,0.732,126,306,432,121,27,75,147,285,1155
2943,6,1994,27,1,5,78,75,2113,493,923,0.534,0,1,0,493,922,0.535,238,300,0.793,135,348,483,156,49,82,151,281,1224
2943,7,1995,28,1,5,78,78,2381,558,1060,0.526,0,2,0,558,1058,0.527,284,377,0.753,192,409,601,111,40,79,189,278,1400
2943,8,1996,29,1,5,63,63,1901,466,894,0.521,1,5,0.2,465,889,0.523,231,293,0.788,119,314,433,110,21,45,160,226,1164
2943,9,1997,30,1,5,52,52,1518,356,733,0.486,2,8,0.25,354,725,0.488,173,217,0.797,105,256,361,67,22,59,126,175,887
2943,10,1998,31,1,5,73,69,2085,514,1038,0.495,0,3,0,514,1035,0.497,188,240,0.783,127,378,505,101,40,88,134,243,1216
2943,11,1999,32,1,5,49,49,1271,310,633,0.49,0,2,0,310,631,0.491,108,132,0.818,73,202,275,52,18,52,75,159,728
2943,12,2000,33,1,5,79,79,1852,431,890,0.484,0,1,0,431,889,0.485,156,211,0.739,94,307,401,85,20,100,108,249,1018
2944,1,1992,22,1,2,61,59,1806,297,654,0.454,40,125,0.32,257,529,0.486,95,127,0.748,81,107,188,278,59,19,152,162,729
2944,2,1993,23,1,2,48,43,1610,279,619,0.451,53,132,0.402,226,487,0.464,155,197,0.787,56,141,197,267,50,16,129,148,766
2944,3,1994,24,1,2,78,77,2776,491,1076,0.456,91,262,0.347,400,814,0.491,273,327,0.835,156,196,352,394,84,35,202,217,1346
2944,4,1995,25,1,2,78,59,2603,417,976,0.427,135,404,0.334,282,572,0.493,295,349,0.845,100,170,270,267,60,32,151,216,1264
2944,4,1995,25,1,2,80,61,2665,428,1005,0.426,137,416,0.329,291,589,0.494,312,371,0.841,104,172,276,274,62,33,155,225,1305
2944,5,1996,26,1,2,80,80,2856,494,1143,0.432,140,423,0.331,354,720,0.492,318,385,0.826,124,202,326,224,68,17,151,207,1446
2944,6,1997,27,1,2,72,72,2818,491,1145,0.429,130,388,0.335,361,757,0.477,333,393,0.847,90,148,238,305,62,23,176,173,1445
2944,7,1998,28,1,2,73,73,2857,489,1101,0.444,97,276,0.351,392,825,0.475,389,455,0.855,133,176,309,292,75,29,176,219,1464
2944,8,1999,29,1,2,36,36,1314,217,540,0.402,47,139,0.338,170,401,0.424,191,225,0.849,50,101,151,118,36,11,99,100,672
2944,9,2000,30,1,2,82,81,2689,420,900,0.467,96,241,0.398,324,659,0.492,289,340,0.85,123,190,313,209,71,31,117,214,1225
2944,10,2001,31,1,2,81,36,2542,359,788,0.456,78,230,0.339,281,558,0.504,309,347,0.89,87,185,272,213,48,24,137,203,1105
2944,11,2002,32,1,2,77,76,2211,310,682,0.455,116,246,0.472,194,436,0.445,159,181,0.878,45,148,193,151,54,15,108,158,895
2944,12,2003,33,1,2,53,18,1032,113,291,0.388,39,118,0.331,74,173,0.428,95,114,0.833,21,78,99,70,28,9,43,79,360
2944,13,2004,34,1,2,71,4,929,119,293,0.406,43,107,0.402,76,186,0.409,77,83,0.928,27,54,81,56,15,6,42,91,358
2944,14,2005,35,1,2,13,0,114,9,30,0.3,3,15,0.2,6,15,0.4,2,3,0.667,2,14,16,14,2,0,3,8,23
2944,14,2005,35,1,2,37,1,636,93,218,0.427,38,90,0.422,55,128,0.43,67,77,0.87,13,36,49,57,12,7,24,74,291
2944,14,2005,35,1,2,50,1,750,102,248,0.411,41,105,0.39,61,143,0.427,69,80,0.863,15,50,65,71,14,7,27,82,314
2945,1,1986,23,1,5,38,5,408,46,122,0.377,0,2,0,46,120,0.383,16,29,0.552,46,64,110,19,6,23,29,95,108
2945,2,1987,24,1,5,35,3,233,30,60,0.5,0,0,-1,30,60,0.5,16,25,0.64,13,24,37,5,4,13,19,70,76
2945,3,1988,25,1,5,48,2,421,44,103,0.427,0,0,-1,44,103,0.427,44,66,0.667,27,58,85,8,7,42,30,105,132
2945,4,1989,26,1,4,43,18,623,72,153,0.471,0,0,-1,72,153,0.471,49,76,0.645,42,87,129,12,13,58,48,102,193
2945,5,1990,27,1,5,13,3,107,10,24,0.417,0,0,-1,10,24,0.417,1,6,0.167,11,23,34,1,4,11,9,18,21
2947,1,1996,22,1,1,43,1,389,42,100,0.42,2,10,0.2,40,90,0.444,29,49,0.592,9,34,43,73,28,0,38,53,115
2947,2,1997,23,1,1,67,0,775,74,164,0.451,4,15,0.267,70,149,0.47,47,66,0.712,17,53,70,159,37,3,48,94,199
2947,3,1998,24,1,1,47,0,844,69,161,0.429,2,16,0.125,67,145,0.462,44,61,0.721,19,58,77,164,60,4,51,99,184
2947,3,1998,24,1,1,64,0,918,79,184,0.429,2,17,0.118,77,167,0.461,49,71,0.69,19,62,81,177,60,5,63,114,209
2947,4,1999,25,1,1,48,48,1716,149,348,0.428,5,21,0.238,144,327,0.44,110,150,0.733,25,137,162,301,100,1,111,149,413
2947,5,2000,26,1,1,82,80,2866,257,597,0.43,11,45,0.244,246,552,0.446,126,177,0.712,42,219,261,624,140,8,162,243,651
2947,6,2001,27,1,1,50,50,1740,182,435,0.418,5,19,0.263,177,416,0.425,122,154,0.792,27,139,166,369,77,7,124,123,491
2947,7,2002,28,1,1,61,61,2225,276,624,0.442,3,27,0.111,273,597,0.457,183,227,0.806,33,182,215,400,95,9,138,167,738
2947,8,2003,29,1,1,82,82,3108,361,799,0.452,7,32,0.219,354,767,0.462,325,379,0.858,71,230,301,544,133,11,194,235,1054
2947,9,2004,30,1,1,82,82,2966,295,715,0.413,2,18,0.111,293,697,0.42,252,316,0.797,62,219,281,563,97,6,187,213,844
2947,10,2005,31,1,2,81,15,1844,125,327,0.382,13,45,0.289,112,282,0.397,59,80,0.738,37,118,155,317,67,16,89,189,322
2947,11,2006,32,1,1,82,82,2351,163,399,0.409,1,10,0.1,162,389,0.416,64,93,0.688,38,160,198,346,76,19,116,218,391
2947,12,2007,33,1,1,82,45,1929,135,324,0.417,0,4,0,135,320,0.422,72,113,0.637,35,153,188,330,55,16,111,185,342
2947,13,2008,34,1,1,22,5,305,6,38,0.158,0,2,0,6,36,0.167,10,22,0.455,4,16,20,42,10,4,10,30,22
2949,1,2005,21,1,2,68,7,906,122,328,0.372,30,85,0.353,92,243,0.379,64,96,0.667,50,71,121,36,26,19,58,116,338
2949,2,2006,22,1,2,68,45,1310,205,453,0.453,46,129,0.357,159,324,0.491,86,117,0.735,55,106,161,102,29,23,70,106,542
2949,3,2007,23,1,3,39,1,563,66,146,0.452,11,44,0.25,55,102,0.539,49,75,0.653,17,66,83,39,11,12,26,51,192
2949,4,2008,24,1,3,27,18,680,83,161,0.516,3,14,0.214,80,147,0.544,58,77,0.753,25,89,114,56,19,14,48,49,227
2949,4,2008,24,1,3,36,18,761,96,189,0.508,5,23,0.217,91,166,0.548,64,88,0.727,30,96,126,64,20,15,52,55,261
2952,1,1980,27,1,1,82,-1,2673,470,1002,0.469,21,68,0.309,449,934,0.481,200,239,0.837,75,167,242,426,136,17,282,294,1161
2952,2,1981,28,1,1,71,-1,1803,355,769,0.462,17,66,0.258,338,703,0.481,231,247,0.935,46,98,144,284,98,17,206,225,958
2952,3,1982,29,1,2,80,6,1938,363,801,0.453,19,76,0.25,344,725,0.474,195,254,0.768,37,105,142,301,73,18,217,238,940
2952,4,1983,30,1,2,41,39,1438,234,534,0.438,23,55,0.418,211,479,0.441,154,185,0.832,35,67,102,218,61,14,147,158,645
2952,5,1984,31,1,2,81,81,2624,508,1115,0.456,29,111,0.261,479,1004,0.477,221,264,0.837,51,128,179,377,117,17,222,278,1266
2952,6,1985,32,1,2,71,12,1490,280,628,0.446,8,28,0.286,272,600,0.453,132,162,0.815,27,76,103,252,49,9,158,156,700
2952,7,1986,33,1,2,78,0,1279,240,541,0.444,13,43,0.302,227,498,0.456,110,125,0.88,29,70,99,180,44,2,85,139,603
2957,1,2004,25,1,4,73,7,976,133,273,0.487,0,0,-1,133,273,0.487,71,88,0.807,91,134,225,48,42,12,43,126,337
2957,2,2005,26,1,4,81,21,1668,257,488,0.527,0,3,0,257,485,0.53,94,111,0.847,125,219,344,114,51,18,70,206,608
2957,3,2006,27,1,4,62,7,1329,236,491,0.481,2,5,0.4,234,486,0.481,94,115,0.817,76,170,246,88,35,16,85,157,568
2957,4,2007,28,1,4,37,1,700,118,225,0.524,0,2,0,118,223,0.529,46,54,0.852,44,90,134,38,17,10,43,105,282
2957,5,2008,29,1,5,80,13,1554,214,467,0.458,0,2,0,214,465,0.46,67,73,0.918,81,190,271,135,53,16,86,181,495
2957,6,2009,30,1,5,77,29,1521,243,457,0.532,0,1,0,243,456,0.533,80,90,0.889,75,152,227,94,64,20,74,200,566
2957,7,2010,31,1,5,75,1,1410,241,488,0.494,1,6,0.167,240,482,0.498,60,74,0.811,59,173,232,70,62,14,81,206,543
2958,1,2005,23,1,5,27,4,255,23,58,0.397,0,0,-1,23,58,0.397,16,27,0.593,18,39,57,2,12,4,10,46,62
2958,2,2006,24,1,5,42,25,590,53,123,0.431,0,0,-1,53,123,0.431,41,57,0.719,54,92,146,8,21,19,30,118,147
2960,1,1980,22,1,2,40,-1,442,72,153,0.471,0,2,0,72,151,0.477,54,65,0.831,27,27,54,51,12,6,57,58,198
2960,2,1981,23,1,3,82,-1,2317,404,866,0.467,1,10,0.1,403,856,0.471,375,423,0.887,142,155,297,232,117,20,172,230,1184
2960,3,1982,24,1,2,82,1,1755,270,564,0.479,8,24,0.333,262,540,0.485,279,327,0.853,99,111,210,206,86,9,111,140,827
2960,4,1983,25,1,2,48,4,722,91,197,0.462,2,10,0.2,89,187,0.476,88,113,0.779,27,57,84,78,27,3,55,59,272
2961,1,2007,24,1,2,31,0,272,23,72,0.319,5,29,0.172,18,43,0.419,34,42,0.81,5,17,22,28,7,1,29,33,85
2964,1,1981,22,1,1,15,-1,212,22,63,0.349,0,0,-1,22,63,0.349,12,16,0.75,7,11,18,32,13,3,18,15,56
2964,2,1982,23,1,1,82,82,2610,366,730,0.501,1,15,0.067,365,715,0.51,124,148,0.838,53,171,224,424,87,13,145,240,857
2964,3,1983,24,1,1,32,9,880,128,298,0.43,2,7,0.286,126,291,0.433,63,86,0.733,22,67,89,159,37,4,71,93,321
2964,3,1983,24,1,1,49,49,1548,264,512,0.516,3,15,0.2,261,497,0.525,84,113,0.743,39,102,141,238,70,1,126,162,615
2964,3,1983,24,1,1,81,58,2428,392,810,0.484,5,22,0.227,387,788,0.491,147,199,0.739,61,169,230,397,107,5,197,255,936
2964,4,1984,25,1,1,79,74,2436,350,738,0.474,10,39,0.256,340,699,0.486,108,131,0.824,48,141,189,539,100,8,210,230,818
2964,5,1985,26,1,1,79,41,2292,326,662,0.492,7,31,0.226,319,631,0.506,122,141,0.865,38,131,169,557,81,9,150,200,781
2964,6,1986,27,1,1,74,74,2344,345,723,0.477,5,20,0.25,340,703,0.484,101,127,0.795,50,120,170,472,85,14,154,182,796
2964,7,1987,28,1,1,80,30,1951,263,590,0.446,11,42,0.262,252,548,0.46,71,89,0.798,29,86,115,432,67,6,140,160,608
2964,8,1988,29,1,1,55,25,992,112,274,0.409,2,12,0.167,110,262,0.42,24,33,0.727,14,56,70,162,37,3,52,72,250
2964,8,1988,29,1,1,58,25,1044,117,293,0.399,2,13,0.154,115,280,0.411,24,33,0.727,15,57,72,167,41,3,58,79,260
2964,9,1989,30,1,1,80,79,2613,444,982,0.452,18,74,0.243,426,908,0.469,94,107,0.879,55,161,216,429,103,17,204,168,1000
2964,10,1990,31,1,1,82,25,1756,210,510,0.412,8,40,0.2,202,470,0.43,59,77,0.766,37,101,138,298,49,4,99,140,487
2964,11,1991,32,1,1,80,74,2375,371,756,0.491,31,78,0.397,340,678,0.501,58,83,0.699,45,141,186,362,83,16,126,189,831
2964,12,1992,33,1,1,42,0,471,57,143,0.399,2,13,0.154,55,130,0.423,8,13,0.615,3,24,27,79,12,5,31,55,124
2964,12,1992,33,1,1,46,0,489,58,151,0.384,3,15,0.2,55,136,0.404,8,13,0.615,3,25,28,83,12,5,33,57,127
2966,1,1993,28,1,3,17,1,407,73,160,0.456,0,2,0,73,158,0.462,41,54,0.759,38,42,80,24,15,7,24,61,187
2966,1,1993,28,1,3,20,1,422,73,163,0.448,0,2,0,73,161,0.453,41,54,0.759,38,43,81,24,17,7,26,64,187
2966,2,1994,29,1,3,23,0,286,43,100,0.43,0,0,-1,43,100,0.43,52,73,0.712,26,35,61,19,18,5,19,37,138
2966,2,1994,29,1,3,28,1,349,52,118,0.441,0,0,-1,52,118,0.441,55,77,0.714,30,43,73,22,19,7,21,43,159
2967,1,1993,23,1,5,44,4,280,44,82,0.537,0,0,-1,44,82,0.537,16,32,0.5,17,45,62,8,8,18,26,54,104
2967,2,1994,24,1,5,76,63,1930,288,540,0.533,0,2,0,288,538,0.535,97,162,0.599,96,319,415,75,30,127,168,208,673
2967,3,1995,25,1,5,19,8,368,52,118,0.441,0,1,0,52,117,0.444,28,50,0.56,11,54,65,25,14,23,48,62,132
2968,1,1991,23,1,5,81,46,2099,195,381,0.512,0,1,0,195,380,0.513,182,252,0.722,272,369,641,25,48,121,77,337,572
2968,2,1992,24,1,5,61,54,1481,141,331,0.426,0,0,-1,141,331,0.426,123,178,0.691,167,268,435,53,27,79,70,241,405
2968,3,1993,25,1,5,71,48,1296,105,226,0.465,0,0,-1,105,226,0.465,83,127,0.654,134,190,324,17,23,66,70,243,293
2968,4,1994,26,1,5,79,79,2210,256,507,0.505,0,0,-1,256,507,0.505,165,272,0.607,235,423,658,43,41,67,127,304,677
2968,5,1995,27,1,5,34,34,905,105,215,0.488,0,0,-1,105,215,0.488,107,135,0.793,90,170,260,17,12,32,68,131,317
2968,6,1996,28,1,5,71,70,1267,146,281,0.52,0,0,-1,146,281,0.52,104,151,0.689,100,206,306,11,20,54,77,240,396
2968,7,1997,29,1,5,72,64,1539,137,282,0.486,0,0,-1,137,282,0.486,94,161,0.584,152,258,410,21,34,50,87,273,368
2968,7,1997,29,1,5,73,65,1558,139,284,0.489,0,0,-1,139,284,0.489,94,161,0.584,157,259,416,22,34,50,88,275,372
2968,8,1998,30,1,5,68,0,813,59,129,0.457,0,0,-1,59,129,0.457,44,79,0.557,93,133,226,17,23,37,49,175,162
2968,9,1999,31,1,5,26,0,159,15,33,0.455,0,0,-1,15,33,0.455,12,26,0.462,18,28,46,0,5,10,9,41,42
2968,10,2000,32,1,5,26,0,149,15,33,0.455,0,0,-1,15,33,0.455,20,30,0.667,15,24,39,3,6,8,9,32,50
2968,11,2001,33,1,5,18,0,113,12,20,0.6,0,0,-1,12,20,0.6,15,25,0.6,16,19,35,2,2,2,11,24,39
2968,12,2002,34,1,5,32,8,248,6,26,0.231,0,0,-1,6,26,0.231,17,33,0.515,16,34,50,3,7,8,12,73,29
2975,1,1984,24,1,3,38,0,363,44,82,0.537,0,2,0,44,80,0.55,36,50,0.72,16,45,61,30,12,4,34,55,124
2975,2,1985,25,1,4,75,32,1292,194,354,0.548,0,3,0,194,351,0.553,112,146,0.767,77,150,227,132,47,13,115,195,500
2975,3,1986,26,1,3,43,7,471,88,192,0.458,0,1,0,88,191,0.461,38,49,0.776,28,53,81,49,18,9,54,78,214
2976,1,1999,23,1,4,18,0,199,14,37,0.378,0,0,-1,14,37,0.378,19,20,0.95,19,15,34,5,2,11,9,31,47
2976,2,2000,24,1,4,25,0,198,17,51,0.333,0,1,0,17,50,0.34,18,27,0.667,15,30,45,5,4,11,17,47,52
2978,1,1993,22,1,2,77,69,2741,449,968,0.464,73,198,0.369,376,770,0.488,211,283,0.746,79,192,271,295,126,52,203,166,1182
2978,2,1994,23,1,2,82,82,3533,613,1417,0.433,141,391,0.361,472,1026,0.46,353,456,0.774,80,321,401,385,180,76,226,158,1720
2978,3,1995,24,1,2,69,69,2771,490,1171,0.418,90,326,0.276,400,845,0.473,350,448,0.781,58,198,256,279,112,46,230,108,1420
2978,4,1996,25,1,2,78,78,3064,515,1202,0.428,91,282,0.323,424,920,0.461,352,446,0.789,124,256,380,328,127,45,222,150,1473
2978,5,1997,26,1,2,80,79,3353,649,1444,0.449,147,415,0.354,502,1029,0.488,493,585,0.843,58,308,366,507,132,45,322,153,1938
2978,6,1998,27,1,2,14,13,547,110,277,0.397,9,48,0.188,101,229,0.441,70,94,0.745,7,44,51,68,19,5,44,26,299
2978,7,1999,28,1,3,37,4,1233,215,518,0.415,21,77,0.273,194,441,0.44,155,191,0.812,41,115,156,91,46,2,79,65,606
2978,8,2000,29,1,3,82,82,3276,568,1305,0.435,44,127,0.346,524,1178,0.445,344,397,0.866,49,300,349,332,109,22,226,184,1524
2978,9,2001,30,1,3,77,77,3017,524,1219,0.43,41,135,0.304,483,1084,0.446,275,351,0.783,49,298,347,269,106,28,218,159,1364
2978,10,2002,31,1,3,81,81,3326,573,1419,0.404,145,403,0.36,428,1016,0.421,284,346,0.821,59,239,298,313,94,14,223,161,1575
2978,11,2003,32,1,3,74,73,2859,454,1127,0.403,134,360,0.372,320,767,0.417,173,218,0.794,45,240,285,332,102,22,172,134,1215
2978,12,2004,33,1,3,82,82,3100,518,1266,0.409,99,299,0.331,419,967,0.433,240,295,0.814,56,254,310,286,88,21,158,101,1375
2978,13,2005,34,1,3,80,79,2450,398,961,0.414,69,211,0.327,329,750,0.439,156,188,0.83,65,189,254,179,53,21,127,124,1021
2981,1,1985,23,1,2,74,14,1278,210,458,0.459,4,25,0.16,206,433,0.476,102,126,0.81,39,75,114,127,47,12,80,205,526
2981,2,1986,24,1,2,74,17,1331,191,441,0.433,9,53,0.17,182,388,0.469,107,132,0.811,29,110,139,206,59,8,139,200,498
2981,3,1987,25,1,2,44,0,375,67,156,0.429,11,29,0.379,56,127,0.441,31,50,0.62,8,16,24,57,13,0,29,78,176
2983,1,1980,30,1,3,16,-1,446,62,146,0.425,0,4,0,62,142,0.437,22,27,0.815,13,32,45,67,25,1,33,53,146
2985,1,1999,22,1,5,23,6,313,53,125,0.424,0,3,0,53,122,0.434,21,40,0.525,27,48,75,12,10,23,32,58,127
2985,2,2000,23,1,5,30,1,202,29,79,0.367,0,6,0,29,73,0.397,17,36,0.472,21,26,47,3,10,11,22,44,75
2985,3,2001,24,1,5,29,0,280,28,88,0.318,1,4,0.25,27,84,0.321,25,34,0.735,35,74,109,16,10,11,19,47,82
2985,4,2002,25,1,5,67,4,884,117,249,0.47,1,2,0.5,116,247,0.47,50,104,0.481,100,170,270,16,24,44,52,103,285
2985,5,2003,26,1,5,79,6,1594,185,427,0.433,0,0,-1,185,427,0.433,71,134,0.53,211,343,554,24,45,40,69,169,441
2985,6,2004,27,1,5,42,2,453,43,103,0.417,0,0,-1,43,103,0.417,22,36,0.611,50,75,125,23,11,15,19,61,108
2990,1,1998,24,1,4,15,0,110,12,26,0.462,0,0,-1,12,26,0.462,16,25,0.64,9,22,31,2,5,2,8,13,40
2991,1,1984,23,1,5,81,73,2426,392,816,0.48,3,16,0.188,389,800,0.486,183,243,0.753,116,446,562,170,73,67,161,303,970
2991,2,1985,24,1,5,82,66,2315,414,871,0.475,1,11,0.091,413,860,0.48,297,372,0.798,141,473,614,199,71,78,184,265,1126
2991,3,1986,25,1,5,79,65,2397,416,885,0.47,2,10,0.2,414,875,0.473,242,315,0.768,173,450,623,206,75,69,146,261,1076
2991,4,1987,26,1,5,81,81,2761,382,760,0.503,1,4,0.25,381,756,0.504,307,367,0.837,184,486,670,180,106,97,130,304,1072
2991,5,1988,27,1,5,80,80,2692,411,828,0.496,3,15,0.2,408,813,0.502,254,314,0.809,157,505,662,183,90,69,156,302,1079
2993,1,1998,22,1,5,81,37,1761,155,323,0.48,0,0,-1,155,323,0.48,65,142,0.458,197,339,536,61,29,195,85,251,375
2993,2,1999,23,1,5,42,2,394,22,53,0.415,0,0,-1,22,53,0.415,17,25,0.68,43,56,99,5,4,28,12,76,61
2993,3,2000,24,1,5,42,1,389,20,53,0.377,0,0,-1,20,53,0.377,18,32,0.563,33,61,94,6,5,19,17,81,58
2993,4,2001,25,1,5,26,0,123,11,34,0.324,0,0,-1,11,34,0.324,11,18,0.611,16,13,29,2,4,3,5,19,33
2993,5,2003,27,1,4,47,0,251,14,37,0.378,0,0,-1,14,37,0.378,8,12,0.667,19,36,55,6,2,15,10,42,36
2993,6,2004,28,1,5,25,2,147,5,12,0.417,0,0,-1,5,12,0.417,3,4,0.75,8,21,29,0,2,10,3,34,13
2993,7,2005,29,1,4,12,1,145,11,21,0.524,0,0,-1,11,21,0.524,3,7,0.429,21,19,40,5,6,5,6,32,25
2994,1,1993,22,1,2,39,12,865,124,278,0.446,0,4,0,124,274,0.453,99,119,0.832,39,85,124,49,24,5,44,82,347
2994,2,1994,23,1,2,82,82,2853,365,811,0.45,2,9,0.222,363,802,0.453,291,351,0.829,119,230,349,199,116,16,131,165,1023
2994,3,1995,24,1,2,81,51,2329,312,661,0.472,20,68,0.294,292,593,0.492,267,324,0.824,95,173,268,153,91,18,110,142,911
2994,4,1996,25,1,2,82,77,2810,379,911,0.416,41,148,0.277,338,763,0.443,320,379,0.844,125,275,400,241,114,16,157,187,1119
2994,5,1997,26,1,2,52,52,1788,251,603,0.416,70,182,0.385,181,421,0.43,202,234,0.863,74,143,217,133,60,20,101,119,774
2994,6,1998,27,1,2,31,15,718,75,225,0.333,10,48,0.208,65,177,0.367,75,86,0.872,15,50,65,50,21,8,35,52,235
2994,7,1999,28,1,2,46,32,1194,114,290,0.393,31,106,0.292,83,184,0.451,61,71,0.859,30,77,107,82,28,15,45,65,320
2994,8,2000,29,1,2,45,6,691,86,189,0.455,17,56,0.304,69,133,0.519,64,77,0.831,23,61,84,61,18,12,33,56,253
2994,9,2001,30,1,2,78,74,2504,245,611,0.401,91,242,0.376,154,369,0.417,175,207,0.845,65,219,284,168,93,14,90,182,756
2994,10,2002,31,1,2,50,5,665,70,188,0.372,24,68,0.353,46,120,0.383,44,52,0.846,20,65,85,42,29,6,30,42,208
2997,1,1985,22,1,1,82,5,1490,157,333,0.471,2,11,0.182,155,322,0.481,142,193,0.736,26,79,105,415,109,11,150,203,458
2997,2,1986,23,1,1,82,38,1935,228,466,0.489,2,15,0.133,226,451,0.501,172,205,0.839,33,146,179,610,157,10,168,227,630
2997,3,1987,24,1,1,82,2,1858,231,463,0.499,7,39,0.179,224,424,0.528,179,229,0.782,32,119,151,670,177,14,164,224,648
2997,4,1988,25,1,1,82,79,2842,454,791,0.574,24,67,0.358,430,724,0.594,272,324,0.84,54,183,237,1128,242,16,262,247,1204
2997,5,1989,26,1,1,82,82,3171,497,923,0.538,16,66,0.242,481,857,0.561,390,452,0.863,83,165,248,1118,263,14,308,241,1400
2997,6,1990,27,1,1,78,78,2915,472,918,0.514,47,113,0.416,425,805,0.528,354,432,0.819,57,149,206,1134,207,18,272,233,1345
2997,7,1991,28,1,1,82,82,3103,496,978,0.507,58,168,0.345,438,810,0.541,363,434,0.836,46,191,237,1164,234,16,298,233,1413
2997,8,1992,29,1,1,82,82,3002,453,939,0.482,83,204,0.407,370,735,0.503,308,366,0.842,68,202,270,1126,244,22,286,234,1297
2997,9,1993,30,1,1,82,82,2863,437,899,0.486,72,187,0.385,365,712,0.513,293,367,0.798,64,173,237,987,199,21,266,224,1239
2997,10,1994,31,1,1,82,82,2969,458,868,0.528,48,149,0.322,410,719,0.57,272,338,0.805,72,186,258,1031,199,22,266,236,1236
2997,11,1995,32,1,1,82,82,2867,429,791,0.542,102,227,0.449,327,564,0.58,246,306,0.804,57,194,251,1011,194,22,267,215,1206
2997,12,1996,33,1,1,82,82,2915,440,818,0.538,95,225,0.422,345,593,0.582,234,282,0.83,54,172,226,916,140,15,246,207,1209
2997,13,1997,34,1,1,82,82,2896,416,759,0.548,76,180,0.422,340,579,0.587,275,325,0.846,45,183,228,860,166,15,248,194,1183
2997,14,1998,35,1,1,64,64,1858,270,511,0.528,39,91,0.429,231,420,0.55,191,231,0.827,35,131,166,543,89,10,161,138,770
2997,15,1999,36,1,1,50,50,1410,200,410,0.488,16,50,0.32,184,360,0.511,137,169,0.811,31,115,146,374,81,13,110,107,553
2997,16,2000,37,1,1,82,82,2432,363,725,0.501,43,121,0.355,320,604,0.53,221,257,0.86,45,170,215,703,143,15,179,192,990
2997,17,2001,38,1,1,82,82,2397,328,651,0.504,61,132,0.462,267,519,0.514,227,278,0.817,54,173,227,713,132,21,203,194,944
2997,18,2002,39,1,1,82,82,2566,401,775,0.517,25,78,0.321,376,697,0.539,275,321,0.857,59,204,263,674,152,24,208,209,1102
2997,19,2003,40,1,1,82,82,2275,309,640,0.483,29,80,0.363,280,560,0.5,237,287,0.826,51,150,201,629,137,16,182,184,884
2998,1,1999,21,1,3,48,1,1025,141,373,0.378,57,178,0.32,84,195,0.431,63,74,0.851,43,100,143,72,41,7,53,43,402
2998,2,2000,22,1,3,74,11,1749,321,717,0.448,100,267,0.375,221,450,0.491,135,153,0.882,74,202,276,106,52,7,88,97,877
2998,3,2001,23,1,3,75,75,2905,559,1189,0.47,144,360,0.4,415,829,0.501,267,312,0.856,93,341,434,164,91,13,146,144,1529
2998,4,2002,24,1,3,71,71,2649,547,1130,0.484,129,310,0.416,418,820,0.51,283,323,0.876,72,301,373,175,81,14,140,120,1506
2998,5,2003,25,1,3,72,72,2450,497,1034,0.481,155,406,0.382,342,628,0.545,231,264,0.875,61,336,397,141,72,5,101,143,1380
2998,6,2004,26,1,3,81,81,3264,665,1386,0.48,240,554,0.433,425,832,0.511,394,425,0.927,91,417,508,173,108,14,153,159,1964
2998,7,2005,27,1,3,66,66,2534,451,1016,0.444,174,433,0.402,277,583,0.475,253,275,0.92,62,223,285,138,79,12,102,157,1329
2998,8,2006,28,1,3,31,31,1147,171,424,0.403,71,179,0.397,100,245,0.408,98,105,0.933,34,131,165,68,19,2,51,82,511
2998,8,2006,28,1,3,40,40,1454,274,594,0.461,91,225,0.404,183,369,0.496,140,155,0.903,45,205,250,68,26,8,52,89,779
2998,8,2006,28,1,3,71,71,2601,445,1018,0.437,162,404,0.401,283,614,0.461,238,260,0.915,79,336,415,136,45,10,103,171,1290
2998,9,2007,29,1,3,13,13,425,83,196,0.423,34,84,0.405,49,112,0.438,31,38,0.816,11,43,54,11,8,4,19,29,231
2998,10,2008,30,1,3,77,77,2711,451,1026,0.44,231,524,0.441,220,502,0.438,130,140,0.929,64,267,331,96,57,10,61,127,1263
2998,11,2009,31,1,3,61,59,2089,287,719,0.399,145,384,0.378,142,335,0.424,93,104,0.894,44,220,264,75,52,3,51,101,812
2998,12,2010,32,1,3,62,55,1947,278,688,0.404,132,352,0.375,146,336,0.435,96,107,0.897,39,188,227,92,48,5,56,83,784
2998,13,2011,33,1,3,25,13,506,79,184,0.429,42,105,0.4,37,79,0.468,15,16,0.938,14,52,66,22,11,2,11,22,215
2998,13,2011,33,1,3,33,13,617,100,227,0.441,57,136,0.419,43,91,0.473,23,25,0.92,14,61,75,29,13,2,17,24,280
3005,1,1996,22,1,1,70,70,2865,481,1129,0.426,133,337,0.395,348,792,0.439,236,296,0.797,59,222,281,653,98,19,267,166,1331
3005,2,1997,23,1,1,81,81,3311,564,1407,0.401,176,496,0.355,388,911,0.426,330,401,0.823,86,244,330,709,123,13,288,162,1634
3005,3,1998,24,1,1,22,22,806,94,258,0.364,26,99,0.263,68,159,0.428,59,75,0.787,24,57,81,181,33,2,64,38,273
3005,3,1998,24,1,1,49,49,2033,354,833,0.425,65,205,0.317,289,628,0.46,179,212,0.844,63,154,217,399,80,5,159,112,952
3005,3,1998,24,1,1,71,71,2839,448,1091,0.411,91,304,0.299,357,787,0.454,238,287,0.829,87,211,298,580,113,7,223,150,1225
3005,4,1999,25,1,1,50,50,1673,249,629,0.396,44,142,0.31,205,487,0.421,89,122,0.73,41,126,167,312,49,4,110,81,631
3005,5,2000,26,1,1,78,78,2372,386,894,0.432,80,212,0.377,306,682,0.449,122,145,0.841,61,182,243,405,77,1,149,173,974
3005,6,2001,27,1,1,82,82,2655,406,935,0.434,82,219,0.374,324,716,0.453,172,207,0.831,69,234,303,468,106,8,191,202,1066
3005,7,2002,28,1,1,75,71,2796,369,918,0.402,104,295,0.353,265,623,0.425,174,196,0.888,78,214,292,490,67,7,149,153,1016
3005,8,2003,29,1,1,59,27,1315,156,415,0.376,44,114,0.386,112,301,0.372,53,67,0.791,40,115,155,204,39,6,82,67,409
3005,9,2004,30,1,1,82,82,3118,408,1018,0.401,156,427,0.365,252,591,0.426,127,145,0.876,52,256,308,500,99,9,180,173,1099
3005,10,2005,31,1,1,81,70,2762,457,1165,0.392,181,490,0.369,276,675,0.409,182,199,0.915,56,254,310,458,86,2,164,158,1277
3005,11,2006,32,1,1,27,27,862,114,287,0.397,36,104,0.346,78,183,0.426,53,62,0.855,23,72,95,128,19,1,55,49,317
3005,12,2007,33,1,1,62,51,1501,171,437,0.391,59,175,0.337,112,262,0.427,66,83,0.795,31,108,139,299,47,2,101,95,467
3005,13,2008,34,1,1,31,4,413,43,143,0.301,14,55,0.255,29,88,0.33,6,8,0.75,6,41,47,53,11,2,30,30,106
3005,13,2008,34,1,1,29,29,624,77,194,0.397,36,94,0.383,41,100,0.41,21,26,0.808,14,57,71,112,19,0,50,46,211
3005,13,2008,34,1,1,60,33,1037,120,337,0.356,50,149,0.336,70,188,0.372,27,34,0.794,20,98,118,165,30,2,80,76,317
3006,1,2006,23,1,2,61,1,1236,204,492,0.415,82,216,0.38,122,276,0.442,99,110,0.9,12,104,116,75,27,3,82,118,589
3006,2,2007,24,1,2,61,0,1034,177,425,0.416,56,155,0.361,121,270,0.448,61,68,0.897,6,68,74,61,21,2,55,88,471
3006,3,2008,25,1,1,35,0,402,65,180,0.361,29,85,0.341,36,95,0.379,41,50,0.82,4,20,24,28,7,5,21,34,200
3009,1,2008,22,1,2,33,0,270,29,92,0.315,6,25,0.24,23,67,0.343,9,19,0.474,9,19,28,30,12,6,11,36,73
3010,1,1997,23,1,2,28,15,759,102,256,0.398,28,92,0.304,74,164,0.451,65,80,0.813,21,69,90,68,27,5,66,75,297
3010,2,1998,24,1,2,67,19,1505,199,558,0.357,48,163,0.294,151,395,0.382,65,84,0.774,35,126,161,167,56,8,106,140,511
3010,3,1999,25,1,2,33,2,567,89,221,0.403,18,59,0.305,71,162,0.438,53,65,0.815,12,71,83,64,40,2,36,44,249
3010,4,2000,26,1,2,68,67,2025,316,730,0.433,73,186,0.392,243,544,0.447,162,195,0.831,69,254,323,211,105,13,102,190,867
3010,5,2001,27,1,1,22,0,409,41,136,0.301,14,48,0.292,27,88,0.307,44,51,0.863,9,67,76,66,22,1,27,42,140
3010,5,2001,27,1,1,28,0,421,40,131,0.305,16,47,0.34,24,84,0.286,24,28,0.857,9,43,52,29,22,1,21,46,120
3010,5,2001,27,1,1,50,0,830,81,267,0.303,30,95,0.316,51,172,0.297,68,79,0.861,18,110,128,95,44,2,48,88,260
3010,6,2002,28,1,1,79,4,1643,190,488,0.389,95,247,0.385,95,241,0.394,131,155,0.845,22,191,213,184,56,1,94,145,606
3010,7,2003,29,1,2,71,10,1275,163,380,0.429,62,160,0.388,101,220,0.459,70,87,0.805,23,122,145,209,38,7,98,111,458
3010,8,2004,30,1,1,43,0,571,79,196,0.403,29,66,0.439,50,130,0.385,44,51,0.863,13,58,71,90,26,2,54,63,231
3010,9,2005,31,1,2,62,5,1014,114,304,0.375,21,83,0.253,93,221,0.421,52,64,0.813,11,92,103,115,30,1,64,103,301
3012,1,1988,29,1,4,41,0,271,29,79,0.367,0,2,0,29,77,0.377,20,30,0.667,24,47,71,20,3,12,24,48,78
3013,1,1993,24,1,4,23,0,339,42,92,0.457,4,8,0.5,38,84,0.452,68,85,0.8,40,75,115,14,11,1,13,20,156
3013,2,1994,25,1,4,67,11,1131,141,341,0.413,3,13,0.231,138,328,0.421,159,206,0.772,109,172,281,48,38,14,61,69,444
3013,3,1995,26,1,4,70,24,1344,149,329,0.453,2,7,0.286,147,322,0.457,141,172,0.82,136,239,375,44,24,13,79,143,441
3013,4,1996,27,1,4,63,0,746,72,169,0.426,1,9,0.111,71,160,0.444,69,85,0.812,60,118,178,32,18,12,20,80,214
3013,5,1997,28,1,4,82,21,2004,262,586,0.447,0,13,0,262,573,0.457,175,218,0.803,174,345,519,73,47,20,102,196,699
3013,6,1998,29,1,4,58,8,1638,259,617,0.42,0,4,0,259,613,0.423,218,279,0.781,152,275,427,51,31,24,74,122,736
3013,7,1999,30,1,4,44,0,695,76,180,0.422,0,2,0,76,178,0.427,71,99,0.717,66,95,161,17,15,7,37,64,223
3013,8,2000,31,1,4,20,0,148,21,48,0.438,1,4,0.25,20,44,0.455,11,14,0.786,11,33,44,4,5,2,12,15,54
3013,9,2001,32,1,4,28,8,491,45,117,0.385,0,1,0,45,116,0.388,28,37,0.757,34,74,108,7,14,1,22,30,118
3014,1,1993,24,1,2,9,0,138,20,61,0.328,2,13,0.154,18,48,0.375,8,10,0.8,8,6,14,13,8,0,15,13,50
3016,1,1989,22,1,1,81,10,1358,265,567,0.467,19,59,0.322,246,508,0.484,172,231,0.745,51,109,160,319,98,3,148,142,721
3016,2,1990,23,1,1,51,0,1019,170,386,0.44,6,21,0.286,164,365,0.449,83,130,0.638,43,83,126,219,70,8,85,71,429
3016,2,1990,23,1,1,31,24,1121,173,370,0.468,2,9,0.222,171,361,0.474,91,148,0.615,47,86,133,249,57,6,85,89,439
3016,2,1990,23,1,1,82,24,2140,343,756,0.454,8,30,0.267,335,726,0.461,174,278,0.626,90,169,259,468,127,14,170,160,868
3016,3,1991,24,1,1,58,56,2076,314,651,0.482,11,33,0.333,303,618,0.49,161,211,0.763,57,162,219,463,117,11,156,125,800
3016,4,1992,25,1,1,57,54,2053,300,659,0.455,5,15,0.333,295,644,0.458,182,265,0.687,92,173,265,491,118,17,160,122,787
3016,5,1993,26,1,2,78,35,2474,396,816,0.485,4,30,0.133,392,786,0.499,273,381,0.717,120,217,337,559,131,24,199,153,1069
3016,6,1994,27,1,1,82,58,2889,528,1093,0.483,2,10,0.2,526,1083,0.486,353,471,0.749,122,248,370,740,147,24,257,171,1411
3016,7,1995,28,1,1,64,61,2267,441,946,0.466,46,123,0.374,395,823,0.48,283,380,0.745,73,244,317,562,123,9,209,118,1211
3016,8,1996,29,1,1,67,63,2526,471,1023,0.46,38,111,0.342,433,912,0.475,276,423,0.652,89,208,297,640,97,16,255,135,1256
3016,9,1997,30,1,1,82,81,2997,515,1105,0.466,13,77,0.169,502,1028,0.488,367,497,0.738,95,240,335,727,143,14,270,166,1410
3016,10,1998,31,1,1,76,76,3020,490,1130,0.434,12,48,0.25,478,1082,0.442,357,492,0.726,112,293,405,801,126,25,266,182,1349
3016,11,1999,32,1,1,44,43,1632,251,603,0.416,12,42,0.286,239,561,0.426,176,236,0.746,56,156,212,434,76,5,142,91,690
3016,12,2000,33,1,1,69,67,2188,327,762,0.429,1,21,0.048,326,741,0.44,214,305,0.702,73,186,259,519,94,18,187,147,869
3016,13,2001,34,1,1,21,0,351,41,98,0.418,0,1,0,41,97,0.423,15,26,0.577,11,24,35,72,10,1,24,21,97
3016,13,2001,34,1,1,33,28,1020,141,331,0.426,4,16,0.25,137,315,0.435,115,147,0.782,25,80,105,231,43,4,83,55,401
3016,13,2001,34,1,1,54,28,1371,182,429,0.424,4,17,0.235,178,412,0.432,130,173,0.751,36,104,140,303,53,5,107,76,498
3016,14,2002,35,1,1,76,64,2294,316,714,0.443,8,26,0.308,308,688,0.448,154,201,0.766,49,183,232,463,82,11,159,114,794
3016,15,2003,36,1,1,47,8,956,120,278,0.432,1,11,0.091,119,267,0.446,79,107,0.738,20,75,95,215,46,6,76,55,320
3016,16,2004,37,1,1,15,1,282,28,84,0.333,0,3,0,28,81,0.346,15,22,0.682,10,27,37,59,8,4,18,17,71
3016,16,2004,37,1,1,46,9,915,122,269,0.454,10,33,0.303,112,236,0.475,57,76,0.75,24,94,118,185,27,7,67,59,311
3016,16,2004,37,1,1,61,10,1197,150,353,0.425,10,36,0.278,140,317,0.442,72,98,0.735,34,121,155,244,35,11,85,76,382
3016,17,2005,38,1,1,16,2,196,9,43,0.209,1,2,0.5,8,41,0.195,9,10,0.9,3,24,27,39,3,2,16,15,28
3021,1,1984,22,1,2,40,1,469,109,214,0.509,0,3,0,109,211,0.517,40,47,0.851,21,25,46,46,20,0,32,46,258
3023,1,1984,22,1,1,73,2,1284,217,488,0.445,9,37,0.243,208,451,0.461,64,72,0.889,23,68,91,239,29,1,81,81,507
3023,2,1985,23,1,1,73,1,1150,170,400,0.425,12,38,0.316,158,362,0.436,48,59,0.814,17,53,70,206,36,1,85,87,400
3023,3,1986,24,1,1,70,4,1150,220,476,0.462,21,60,0.35,199,416,0.478,39,48,0.813,22,58,80,261,34,0,85,110,500
3023,4,1987,25,1,1,76,42,1765,365,751,0.486,50,149,0.336,315,602,0.523,70,84,0.833,20,78,98,315,35,0,97,109,850
3023,5,1988,26,1,1,52,12,1024,176,379,0.464,26,64,0.406,150,315,0.476,43,48,0.896,14,34,48,183,27,2,57,54,421
3023,6,1989,27,1,2,68,8,1338,307,675,0.455,48,92,0.522,259,583,0.444,47,57,0.825,18,69,87,137,27,1,87,78,709
3023,7,1990,28,1,2,63,2,867,148,363,0.408,44,100,0.44,104,263,0.395,44,52,0.846,15,56,71,102,25,0,52,69,384
3023,8,1991,29,1,2,24,0,225,43,107,0.402,15,35,0.429,28,72,0.389,11,11,1,3,6,9,24,7,0,16,11,112
3027,1,2001,20,1,5,11,4,120,20,41,0.488,0,4,0,20,37,0.541,3,5,0.6,4,19,23,2,2,4,3,21,43
3027,2,2003,22,1,5,26,0,138,14,56,0.25,4,16,0.25,10,40,0.25,0,2,0,8,20,28,7,6,3,9,24,32
3028,1,1996,22,1,2,79,3,1150,148,360,0.411,27,78,0.346,121,282,0.429,99,141,0.702,34,101,135,233,56,21,115,126,422
3028,2,1997,23,1,2,82,23,2269,253,587,0.431,53,164,0.323,200,423,0.473,196,319,0.614,76,232,308,390,90,33,181,218,755
3028,3,1998,24,1,2,46,4,942,87,231,0.377,19,60,0.317,68,171,0.398,74,131,0.565,25,69,94,171,44,7,93,113,267
3028,4,1999,25,1,1,50,6,841,70,210,0.333,9,45,0.2,61,165,0.37,65,103,0.631,21,81,102,152,46,14,67,98,214
3028,5,2000,26,1,2,73,45,2216,356,815,0.437,122,332,0.367,234,483,0.484,175,251,0.697,50,238,288,284,91,19,148,201,1009
3028,6,2001,27,1,2,53,42,1684,202,518,0.39,47,172,0.273,155,346,0.448,135,189,0.714,54,173,227,242,54,8,160,127,586
3028,7,2002,28,1,1,78,5,1780,250,590,0.424,42,133,0.316,208,457,0.455,236,328,0.72,89,167,256,275,88,17,133,160,778
3028,8,2003,29,1,2,55,0,1130,135,328,0.412,28,85,0.329,107,243,0.44,103,148,0.696,58,109,167,177,45,2,82,108,401
3028,9,2004,30,1,2,53,0,707,71,173,0.41,9,36,0.25,62,137,0.453,48,69,0.696,30,73,103,89,37,9,39,86,199
3028,9,2004,30,1,2,27,18,956,131,312,0.42,12,43,0.279,119,269,0.442,123,157,0.783,70,153,223,144,25,5,66,72,397
3028,9,2004,30,1,2,80,18,1663,202,485,0.416,21,79,0.266,181,406,0.446,171,226,0.757,100,226,326,233,62,14,105,158,596
3028,10,2005,31,1,1,61,59,1922,215,504,0.427,55,155,0.355,160,349,0.458,141,188,0.75,79,258,337,317,65,7,147,168,626
3033,1,2004,21,1,4,42,1,494,69,140,0.493,0,1,0,69,139,0.496,42,58,0.724,68,89,157,14,18,12,32,57,180
3033,2,2005,22,1,5,77,28,1509,237,446,0.531,0,1,0,237,445,0.533,176,235,0.749,169,249,418,44,27,28,108,224,650
3033,3,2006,23,1,5,66,44,1222,200,444,0.45,0,0,-1,200,444,0.45,133,204,0.652,118,232,350,59,19,56,95,209,533
3033,4,2007,24,1,5,48,0,385,58,134,0.433,0,0,-1,58,134,0.433,37,66,0.561,45,75,120,28,9,11,42,79,153
3035,1,2001,21,1,4,80,6,1312,153,339,0.451,0,4,0,153,335,0.457,85,141,0.603,109,175,284,28,62,82,64,160,391
3035,2,2002,22,1,4,68,14,1805,293,611,0.48,0,3,0,293,608,0.482,217,305,0.711,161,269,430,50,53,113,122,178,803
3035,3,2003,23,1,4,67,26,1478,235,489,0.481,0,2,0,235,487,0.483,177,245,0.722,114,270,384,45,55,104,99,152,647
3035,4,2004,24,1,4,77,10,1528,268,571,0.469,1,4,0.25,267,567,0.471,190,262,0.725,141,237,378,38,56,118,88,188,727
3035,5,2005,25,1,4,60,14,1279,219,488,0.449,0,4,0,219,484,0.452,166,219,0.758,92,181,273,43,41,92,90,182,604
3035,6,2006,26,1,5,66,5,1344,225,458,0.491,0,2,0,225,456,0.493,136,209,0.651,103,188,291,25,38,50,91,198,586
3035,7,2007,27,1,5,54,18,1029,161,346,0.465,0,5,0,161,341,0.472,97,134,0.724,85,165,250,17,30,62,69,146,419
3035,8,2008,28,1,4,21,0,295,42,88,0.477,0,0,-1,42,88,0.477,21,28,0.75,18,52,70,4,5,18,12,39,105
3035,8,2008,28,1,4,35,4,549,93,177,0.525,0,2,0,93,175,0.531,52,81,0.642,46,83,129,22,10,36,39,74,238
3035,8,2008,28,1,4,56,4,844,135,265,0.509,0,2,0,135,263,0.513,73,109,0.67,64,135,199,26,15,54,51,113,343
3035,9,2009,29,1,4,13,0,121,15,41,0.366,1,1,1,14,40,0.35,8,15,0.533,11,22,33,2,4,6,9,25,39
3035,9,2009,29,1,4,19,0,185,24,56,0.429,1,1,1,23,55,0.418,13,26,0.5,16,30,46,3,4,8,16,40,62
3044,1,1997,28,1,5,70,24,662,54,121,0.446,0,1,0,54,120,0.45,45,61,0.738,56,109,165,17,16,32,41,119,153
3048,1,2000,22,1,3,73,53,2171,342,669,0.511,28,78,0.359,314,591,0.531,133,161,0.826,89,183,272,201,58,23,83,175,845
3048,2,2001,23,1,3,82,82,2856,469,920,0.51,26,77,0.338,443,843,0.526,181,208,0.87,133,314,447,260,59,33,138,226,1145
3048,3,2002,24,1,3,82,82,3117,609,1200,0.508,87,191,0.455,522,1009,0.517,226,272,0.831,120,271,391,257,66,21,181,188,1531
3048,4,2003,25,1,3,52,42,1836,351,729,0.481,61,145,0.421,290,584,0.497,150,173,0.867,53,188,241,136,44,22,87,123,913
3048,5,2004,26,1,3,28,0,622,106,236,0.449,20,46,0.435,86,190,0.453,53,64,0.828,24,64,88,33,12,1,28,42,285
3048,6,2005,27,1,3,81,37,2558,465,919,0.506,63,169,0.373,402,750,0.536,260,304,0.855,82,221,303,191,40,16,132,178,1253
3048,7,2006,28,1,3,32,31,1174,201,422,0.476,44,112,0.393,157,310,0.506,115,128,0.898,41,82,123,101,19,4,50,60,561
3048,7,2006,28,1,3,40,40,1555,292,590,0.495,58,143,0.406,234,447,0.523,163,182,0.896,36,154,190,112,21,15,86,90,805
3048,7,2006,28,1,3,72,71,2729,493,1012,0.487,102,255,0.4,391,757,0.517,278,310,0.897,77,236,313,213,40,19,136,150,1366
3048,8,2007,29,1,3,32,19,900,161,388,0.415,44,106,0.415,117,282,0.415,113,126,0.897,16,82,98,55,18,3,54,65,479
3048,9,2008,30,1,3,25,1,556,75,209,0.359,19,52,0.365,56,157,0.357,36,41,0.878,18,63,81,35,9,7,20,36,205
3048,9,2008,30,1,3,50,1,1180,236,513,0.46,71,166,0.428,165,347,0.476,113,134,0.843,16,120,136,69,14,5,56,67,656
3048,9,2008,30,1,3,75,2,1736,311,722,0.431,90,218,0.413,221,504,0.438,149,175,0.851,34,183,217,104,23,12,76,103,861
3048,10,2009,31,1,3,74,5,1527,179,398,0.45,69,168,0.411,110,230,0.478,90,106,0.849,43,189,232,82,28,10,55,130,517
3051,1,2002,24,1,5,55,0,600,109,248,0.44,48,116,0.414,61,132,0.462,42,57,0.737,19,92,111,22,11,18,25,84,308
3051,2,2003,25,1,5,41,1,412,62,162,0.383,16,47,0.34,46,115,0.4,42,58,0.724,26,51,77,10,8,10,31,41,182
3051,3,2004,26,1,5,14,0,105,17,45,0.378,4,14,0.286,13,31,0.419,5,6,0.833,4,10,14,2,3,4,6,13,43
3051,3,2004,26,1,5,16,0,114,17,46,0.37,4,14,0.286,13,32,0.406,9,10,0.9,4,14,18,2,3,5,6,13,47
3052,1,1996,22,1,5,71,21,888,105,248,0.423,0,0,-1,105,248,0.423,71,93,0.763,69,114,183,16,9,7,38,170,281
3052,2,1997,23,1,5,36,2,288,33,85,0.388,0,2,0,33,83,0.398,25,32,0.781,25,38,63,9,4,3,23,44,91
3052,1,1997,23,1,5,52,2,376,49,118,0.415,0,2,0,49,116,0.422,45,57,0.789,35,51,86,14,5,3,27,61,143
