20,1,1982,22,1,1,42,3,291,65,150,0.433,0,9,0,65,141,0.461,0.433,20,27,0.741,10,17,27,45,16,5,24,37
20,2,1983,23,1,1,81,3,1266,228,483,0.472,0,8,0,228,475,0.48,0.472,86,113,0.761,23,62,85,221,81,6,110,119
20,3,1984,24,1,1,60,0,654,84,221,0.38,0,1,0,84,220,0.382,0.38,34,48,0.708,12,47,59,90,31,5,46,78
20,4,1985,25,1,1,16,0,198,36,66,0.545,0,0,-1,36,66,0.545,0.545,19,24,0.792,3,11,14,38,17,0,17,10
20,5,1986,26,1,1,73,19,1491,262,577,0.454,1,9,0.111,261,568,0.46,0.455,132,151,0.874,24,62,86,259,89,4,137,87
20,6,1987,27,1,1,8,0,122,9,32,0.281,0,4,0,9,28,0.321,0.281,10,14,0.714,2,8,10,29,5,0,17,7
20,7,1988,28,1,1,16,11,414,54,115,0.47,0,2,0,54,113,0.478,0.47,24,32,0.75,4,15,19,92,10,1,47,10
32,1,1995,22,1,1,34,4,496,37,105,0.352,8,32,0.25,29,73,0.397,0.39,31,40,0.775,10,32,42,77,18,5,42,78
32,1,1995,22,1,1,49,4,552,40,122,0.328,9,37,0.243,31,85,0.365,0.365,31,40,0.775,12,36,48,95,18,6,50,81
32,2,1996,23,1,1,65,0,961,104,242,0.43,14,62,0.226,90,180,0.5,0.459,65,77,0.844,22,56,78,146,29,3,77,130
32,3,1997,24,1,1,82,0,1083,139,308,0.451,20,72,0.278,119,236,0.504,0.484,70,89,0.787,20,64,84,198,44,10,110,141
32,4,1998,25,1,1,82,18,1726,229,519,0.441,48,118,0.407,181,401,0.451,0.487,127,149,0.852,25,141,166,346,54,13,160,182
32,5,1999,26,1,1,50,0,1038,140,314,0.446,21,50,0.42,119,264,0.451,0.479,67,80,0.838,12,82,94,185,30,2,109,122
32,6,2000,27,1,1,82,5,2096,282,675,0.418,60,163,0.368,222,512,0.434,0.462,84,102,0.824,23,147,170,347,59,9,132,223
32,8,2002,29,1,1,39,0,609,59,175,0.337,14,58,0.241,45,117,0.385,0.377,39,49,0.796,9,40,49,100,24,3,53,55
32,9,2003,30,1,1,82,76,2243,262,628,0.417,131,337,0.389,131,291,0.45,0.521,89,105,0.848,24,162,186,444,71,9,149,222
32,10,2004,31,1,1,34,0,727,86,249,0.345,24,78,0.308,62,171,0.363,0.394,44,53,0.83,13,50,63,117,26,2,48,52
32,10,2004,31,1,1,33,23,730,80,202,0.396,28,85,0.329,52,117,0.444,0.465,32,36,0.889,7,59,66,156,30,3,50,85
32,10,2004,31,1,1,67,23,1457,166,451,0.368,52,163,0.319,114,288,0.396,0.426,76,89,0.854,20,109,129,273,56,5,98,137
32,11,2005,32,1,1,74,1,1428,161,405,0.398,27,103,0.262,134,302,0.444,0.431,66,83,0.795,15,75,90,250,45,9,111,156
32,12,2006,33,1,1,13,0,112,4,17,0.235,1,4,0.25,3,13,0.231,0.265,0,0,-1,1,13,14,25,3,0,3,11
32,12,2006,33,1,1,19,0,282,30,86,0.349,12,38,0.316,18,48,0.375,0.419,20,24,0.833,2,17,19,44,8,2,18,23
32,12,2006,33,1,1,32,0,394,34,103,0.33,13,42,0.31,21,61,0.344,0.393,20,24,0.833,3,30,33,69,11,2,21,34
35,1,2001,21,1,1,50,14,936,115,311,0.37,28,84,0.333,87,227,0.383,0.415,56,72,0.778,21,60,81,145,48,2,54,99
43,9,2014,28,1,1,82,82,3023,576,1278,0.451,69,209,0.33,507,1069,0.474,0.478,339,430,0.788,38,257,295,471,141,23,264,197
62,1,1996,27,1,1,30,0,282,36,100,0.36,13,56,0.232,23,44,0.523,0.425,31,39,0.795,4,12,16,23,7,0,39,27
69,2,1981,25,1,1,71,-1,911,134,291,0.46,2,14,0.143,132,277,0.477,0.464,50,64,0.781,22,65,87,167,34,4,72,114
69,3,1982,26,1,1,14,0,196,24,51,0.471,0,2,0,24,49,0.49,0.471,8,12,0.667,3,9,12,22,9,0,15,26
69,3,1982,26,1,1,22,0,270,35,86,0.407,0,6,0,35,80,0.438,0.407,13,20,0.65,5,17,22,42,13,0,26,36
69,5,1984,28,1,1,78,5,1687,243,564,0.431,32,89,0.36,211,475,0.444,0.459,111,131,0.847,23,115,138,288,61,4,117,175
69,7,1986,30,1,1,81,1,1389,304,715,0.425,39,176,0.222,265,539,0.492,0.452,126,149,0.846,30,71,101,177,61,1,124,159
69,9,1988,32,1,1,56,0,656,139,307,0.453,36,91,0.396,103,216,0.477,0.511,30,37,0.811,9,39,48,81,34,6,43,78
70,2,2007,23,1,1,61,3,712,65,161,0.404,14,44,0.318,51,117,0.436,0.447,35,45,0.778,9,64,73,90,32,4,50,62
95,1,1986,23,1,1,18,0,139,16,44,0.364,0,3,0,16,41,0.39,0.364,8,12,0.667,2,4,6,22,9,1,11,9
95,2,1987,24,1,1,63,0,1303,160,393,0.407,28,102,0.275,132,291,0.454,0.443,105,124,0.847,38,85,123,244,85,6,81,88
95,3,1988,25,1,1,82,75,2778,416,927,0.449,139,379,0.367,277,548,0.505,0.524,166,199,0.834,40,183,223,503,168,16,144,138
95,4,1989,26,1,1,77,77,2787,468,1082,0.433,166,466,0.356,302,616,0.49,0.509,322,393,0.819,71,212,283,490,166,11,180,149
95,5,1990,27,1,1,79,74,2690,398,989,0.402,158,432,0.366,240,557,0.431,0.482,267,314,0.85,49,176,225,495,121,3,141,133
95,6,1991,28,1,1,66,66,2346,560,1421,0.394,167,564,0.296,393,857,0.459,0.453,465,529,0.879,58,198,256,693,147,6,240,162
95,7,1992,29,1,1,78,78,2795,485,1233,0.393,125,386,0.324,360,847,0.425,0.444,313,360,0.869,58,252,310,594,145,9,212,162
95,8,1993,30,1,1,70,70,2499,365,831,0.439,68,212,0.321,297,619,0.48,0.48,237,277,0.856,52,188,240,526,100,4,175,146
95,9,1994,31,1,1,70,67,2337,285,698,0.408,55,191,0.288,230,507,0.454,0.448,224,270,0.83,37,146,183,480,96,6,167,140
95,10,1995,32,1,1,29,0,443,67,148,0.453,29,81,0.358,38,67,0.567,0.551,25,30,0.833,6,23,29,95,23,1,26,41
95,11,1996,33,1,1,21,3,329,37,83,0.446,14,41,0.341,23,42,0.548,0.53,26,35,0.743,5,17,22,67,21,4,25,25
98,8,1989,29,1,1,28,26,1028,209,462,0.452,58,150,0.387,151,312,0.484,0.515,91,112,0.813,34,67,101,187,41,7,63,78
98,8,1989,29,1,1,45,28,1349,271,589,0.46,58,155,0.374,213,434,0.491,0.509,114,128,0.891,37,117,154,215,52,1,82,108
98,8,1989,29,1,1,73,54,2377,480,1051,0.457,116,305,0.38,364,746,0.488,0.512,205,240,0.854,71,184,255,402,93,8,145,186
98,9,1990,30,1,1,75,68,2727,506,1154,0.438,108,289,0.374,398,865,0.46,0.485,222,267,0.831,69,257,326,453,113,18,185,238
109,1,2001,23,1,1,38,6,472,62,178,0.348,3,10,0.3,59,168,0.351,0.357,33,45,0.733,20,43,63,21,16,3,21,76
109,1,2001,23,1,1,27,18,910,177,395,0.448,14,36,0.389,163,359,0.454,0.466,90,105,0.857,22,58,80,41,29,2,54,63
109,1,2001,23,1,1,65,24,1382,239,573,0.417,17,46,0.37,222,527,0.421,0.432,123,150,0.82,42,101,143,62,45,5,75,139
109,3,2003,25,1,1,66,7,1360,193,505,0.382,19,57,0.333,174,448,0.388,0.401,118,146,0.808,39,79,118,79,31,6,68,125
116,1,1988,23,1,1,28,0,197,21,55,0.382,1,8,0.125,20,47,0.426,0.391,16,17,0.941,3,20,23,23,17,3,12,23
116,2,1989,24,1,1,57,3,868,145,313,0.463,20,53,0.377,125,260,0.481,0.495,49,59,0.831,10,59,69,83,44,3,44,54
116,2,1989,24,1,1,66,3,906,148,324,0.457,20,55,0.364,128,269,0.476,0.488,50,61,0.82,10,62,72,92,45,3,45,57
116,3,1990,25,1,1,41,0,302,63,138,0.457,7,22,0.318,56,116,0.483,0.482,35,37,0.946,2,23,25,39,15,3,16,22
116,4,1991,26,1,1,34,0,236,59,117,0.504,7,23,0.304,52,94,0.553,0.534,26,31,0.839,10,14,24,22,8,1,16,11
121,2,2006,24,1,1,51,9,978,129,274,0.471,11,34,0.324,118,240,0.492,0.491,100,134,0.746,32,79,111,67,51,18,67,126
127,1,2000,23,1,1,27,0,361,27,95,0.284,3,14,0.214,24,81,0.296,0.3,3,4,0.75,5,18,23,70,12,0,29,29
127,2,2001,24,1,1,37,2,288,30,84,0.357,8,30,0.267,22,54,0.407,0.405,9,13,0.692,4,27,31,68,13,0,20,27
127,3,2002,25,1,1,50,7,600,66,191,0.346,27,71,0.38,39,120,0.325,0.416,18,29,0.621,10,62,72,143,32,2,40,42
127,4,2003,26,1,1,47,4,980,139,335,0.415,51,130,0.392,88,205,0.429,0.491,37,54,0.685,21,86,107,192,38,15,86,120
127,5,2004,27,1,1,82,28,2581,287,764,0.376,161,434,0.371,126,330,0.382,0.481,103,134,0.769,26,200,226,372,114,18,128,212
127,6,2005,28,1,1,80,78,2717,403,974,0.414,139,389,0.357,264,585,0.451,0.485,191,258,0.74,42,237,279,514,118,7,170,212
127,7,2006,29,1,1,63,63,2431,280,738,0.379,102,312,0.327,178,426,0.418,0.449,99,143,0.692,36,219,255,425,101,15,157,194
127,8,2007,30,1,1,82,82,3040,383,1020,0.375,192,529,0.363,191,491,0.389,0.47,130,177,0.734,29,253,282,444,129,10,170,195
127,9,2008,31,1,1,74,74,2526,364,924,0.394,143,407,0.351,221,517,0.427,0.471,98,137,0.715,28,232,260,392,98,18,160,139
127,10,2009,32,1,1,29,28,856,123,298,0.413,32,101,0.317,91,197,0.462,0.466,70,99,0.707,8,75,83,148,51,3,52,63
127,10,2009,32,1,1,48,48,1591,193,522,0.37,80,230,0.348,113,292,0.387,0.446,86,109,0.789,25,119,144,258,57,7,88,72
127,10,2009,32,1,1,77,76,2447,316,820,0.385,112,331,0.338,204,489,0.417,0.454,156,208,0.75,33,194,227,406,108,10,140,135
127,11,2010,33,1,1,25,25,655,60,169,0.355,30,81,0.37,30,88,0.341,0.444,15,27,0.556,4,50,54,72,23,5,34,53
127,11,2010,33,1,1,27,13,766,95,277,0.343,28,87,0.322,67,190,0.353,0.394,44,54,0.815,9,66,75,104,27,5,61,50
127,11,2010,33,1,1,52,38,1421,155,446,0.348,58,168,0.345,97,278,0.349,0.413,59,81,0.728,13,116,129,176,50,10,95,103
139,6,2003,28,1,1,76,76,2556,355,832,0.427,116,331,0.35,239,501,0.477,0.496,231,269,0.859,53,211,264,325,90,16,128,141
145,1,1992,21,1,1,64,13,1086,187,480,0.39,3,13,0.231,184,467,0.394,0.393,73,98,0.745,38,89,127,203,67,9,97,68
145,2,1993,22,1,1,55,55,2010,370,850,0.435,7,25,0.28,363,825,0.44,0.439,180,232,0.776,51,175,226,449,96,11,153,140
145,3,1994,23,1,1,82,82,3135,576,1381,0.417,40,132,0.303,536,1249,0.429,0.432,346,423,0.818,89,233,322,784,158,15,266,201
145,4,1995,24,1,1,72,70,2689,411,1031,0.399,97,294,0.33,314,737,0.426,0.446,348,414,0.841,73,177,250,680,103,14,225,184
145,5,1996,25,1,1,31,28,1042,143,380,0.376,36,99,0.364,107,281,0.381,0.424,151,188,0.803,37,64,101,247,52,8,58,73
145,5,1996,25,1,1,38,36,1302,206,454,0.454,56,157,0.357,150,297,0.505,0.515,109,150,0.727,26,76,102,328,59,6,88,105
145,5,1996,25,1,1,69,64,2344,349,834,0.418,92,256,0.359,257,578,0.445,0.474,260,338,0.769,63,140,203,575,111,14,146,178
145,6,1997,26,1,1,82,81,3081,485,1137,0.427,132,366,0.361,353,771,0.458,0.485,334,435,0.768,91,272,363,584,162,15,193,222
145,7,1998,27,1,1,16,16,386,64,147,0.435,10,27,0.37,54,120,0.45,0.469,41,49,0.837,3,36,39,100,26,0,29,36
145,7,1998,27,1,1,45,40,1472,204,527,0.387,47,133,0.353,157,394,0.398,0.432,112,145,0.772,36,98,134,245,61,1,114,99
145,7,1998,27,1,1,61,56,1858,268,674,0.398,57,160,0.356,211,514,0.411,0.44,153,194,0.789,39,134,173,345,87,1,143,135
145,8,1999,28,1,1,34,33,1010,161,357,0.451,6,24,0.25,155,333,0.465,0.459,84,101,0.832,24,79,103,193,33,2,71,78
145,9,2000,29,1,1,82,82,2593,434,986,0.44,85,220,0.386,349,766,0.456,0.483,196,253,0.775,55,170,225,420,139,8,130,230
145,10,2001,30,1,1,33,28,849,88,227,0.388,11,33,0.333,77,194,0.397,0.412,59,71,0.831,16,57,73,134,44,2,52,62
145,11,2002,31,1,1,76,76,2430,312,716,0.436,9,33,0.273,303,683,0.444,0.442,98,132,0.742,57,218,275,403,141,10,119,210
145,12,2003,32,1,1,23,1,446,61,150,0.407,1,2,0.5,60,148,0.405,0.41,16,22,0.727,14,31,45,77,18,4,42,43
145,12,2003,32,1,1,38,1,689,102,232,0.44,0,5,0,102,227,0.449,0.44,29,35,0.829,17,70,87,121,40,1,33,63
145,12,2003,32,1,1,61,2,1135,163,382,0.427,1,7,0.143,162,375,0.432,0.428,45,57,0.789,31,101,132,198,58,5,75,106
145,13,2004,33,1,1,44,31,905,113,256,0.441,1,4,0.25,112,252,0.444,0.443,35,48,0.729,19,62,81,125,26,5,50,73
145,14,2005,34,1,1,39,20,717,81,190,0.426,6,13,0.462,75,177,0.424,0.442,27,37,0.73,23,60,83,98,33,0,46,81
145,14,2005,34,1,1,43,20,743,85,201,0.423,6,13,0.462,79,188,0.42,0.438,27,37,0.73,24,64,88,103,33,0,49,87
147,1,1989,22,1,1,36,12,730,73,175,0.417,1,7,0.143,72,168,0.429,0.42,57,82,0.695,44,45,89,153,44,3,84,64
165,1,1992,24,1,1,82,1,1510,161,435,0.37,8,55,0.145,153,380,0.403,0.379,117,158,0.741,33,103,136,314,59,9,98,170
165,2,1993,25,1,1,70,35,1699,174,419,0.415,4,30,0.133,170,389,0.437,0.42,107,159,0.673,42,128,170,398,113,12,104,141
165,3,1994,26,1,1,80,36,1994,225,571,0.394,48,160,0.3,177,411,0.431,0.436,130,168,0.774,43,146,189,365,114,13,127,163
165,4,1995,27,1,1,61,2,943,128,293,0.437,56,155,0.361,72,138,0.522,0.532,60,76,0.789,7,57,64,160,50,7,57,99
165,5,1996,28,1,1,69,68,2096,324,781,0.415,90,271,0.332,234,510,0.459,0.472,229,297,0.771,29,145,174,476,116,11,160,137
165,6,1997,29,1,1,65,44,1863,199,507,0.393,88,238,0.37,111,269,0.413,0.479,130,178,0.73,25,159,184,407,129,4,129,122
165,7,1998,30,1,1,80,0,1021,150,349,0.43,66,159,0.415,84,190,0.442,0.524,53,80,0.663,18,93,111,205,64,3,91,97
165,8,1999,31,1,1,50,0,806,104,251,0.414,49,125,0.392,55,126,0.437,0.512,62,89,0.697,14,49,63,100,66,3,55,75
165,9,2000,32,1,1,82,3,1548,169,416,0.406,88,233,0.378,81,183,0.443,0.512,88,114,0.772,17,116,133,208,59,9,85,143
165,10,2001,33,1,1,58,0,856,97,253,0.383,65,159,0.409,32,94,0.34,0.512,23,35,0.657,21,40,61,82,40,3,43,63
165,11,2002,34,1,1,24,3,553,70,188,0.372,19,73,0.26,51,115,0.443,0.423,13,21,0.619,6,38,44,79,28,1,36,42
165,11,2002,34,1,1,36,35,961,113,287,0.394,29,90,0.322,84,197,0.426,0.444,47,70,0.671,16,72,88,203,49,4,58,72
165,11,2002,34,1,1,60,38,1514,183,475,0.385,48,163,0.294,135,312,0.433,0.436,60,91,0.659,22,110,132,282,77,5,94,114
167,1,2002,20,1,1,47,30,1155,174,384,0.453,39,113,0.345,135,271,0.498,0.504,124,160,0.775,41,91,132,174,69,11,97,115
167,2,2003,21,1,1,82,82,2866,509,1180,0.431,109,313,0.348,400,867,0.461,0.478,370,468,0.791,97,289,386,514,124,17,290,260
167,3,2004,22,1,1,55,52,2066,358,914,0.392,125,333,0.375,233,581,0.401,0.46,237,317,0.748,55,199,254,275,103,12,226,176
167,4,2005,23,1,1,80,80,3274,656,1523,0.431,205,562,0.365,451,961,0.469,0.498,521,640,0.814,83,295,378,411,139,23,242,245
167,5,2006,24,1,1,80,80,3384,746,1668,0.447,199,540,0.369,547,1128,0.485,0.507,655,799,0.82,59,221,280,484,161,25,297,286
167,6,2007,25,1,1,74,73,2942,647,1548,0.418,205,584,0.351,442,964,0.459,0.484,606,718,0.844,61,277,338,443,139,13,236,249
167,7,2008,26,1,1,13,8,425,78,196,0.398,22,78,0.282,56,118,0.475,0.454,74,96,0.771,6,45,51,66,23,1,49,30
167,8,2010,28,1,1,32,32,1169,253,616,0.411,63,181,0.348,190,435,0.437,0.462,153,207,0.739,17,116,133,230,41,9,117,95
167,9,2011,29,1,1,21,14,726,130,330,0.394,47,145,0.324,83,185,0.449,0.465,56,67,0.836,6,64,70,117,30,12,71,76
167,9,2011,29,1,1,49,2,1070,139,404,0.344,50,182,0.275,89,222,0.401,0.406,64,86,0.744,16,103,119,157,44,9,106,112
167,9,2011,29,1,1,70,16,1796,269,734,0.366,97,327,0.297,172,407,0.423,0.433,120,153,0.784,22,167,189,274,74,21,177,188
167,10,2012,30,1,1,17,0,211,26,64,0.406,13,39,0.333,13,25,0.52,0.508,7,10,0.7,2,16,18,18,11,1,12,35
175,1,1990,22,1,1,81,0,1291,190,392,0.485,3,6,0.5,187,386,0.484,0.489,69,78,0.885,19,83,102,199,46,6,83,105
175,2,1991,23,1,1,82,0,1731,304,632,0.481,15,30,0.5,289,602,0.48,0.493,97,111,0.874,25,124,149,301,70,4,107,118
175,3,1992,24,1,1,82,3,1875,335,697,0.481,35,87,0.402,300,610,0.492,0.506,104,129,0.806,19,126,145,266,46,5,94,88
175,4,1993,25,1,1,82,74,2492,408,818,0.499,63,139,0.453,345,679,0.508,0.537,130,151,0.861,27,122,149,330,66,6,83,169
175,5,1994,26,1,1,82,82,2770,479,1007,0.476,60,135,0.444,419,872,0.481,0.505,194,227,0.855,28,142,170,323,80,9,131,147
175,6,1995,27,1,1,82,82,2577,418,894,0.468,108,253,0.427,310,641,0.484,0.528,206,233,0.884,25,161,186,244,84,8,103,159
175,7,1996,28,1,1,82,64,2262,340,727,0.468,98,207,0.473,242,520,0.465,0.535,234,279,0.839,22,162,184,401,68,6,128,147
175,8,1997,29,1,1,49,17,1020,148,327,0.453,25,90,0.278,123,237,0.519,0.491,68,79,0.861,7,67,74,126,25,2,53,56
175,9,1998,30,1,1,62,0,772,99,194,0.51,9,34,0.265,90,160,0.563,0.534,37,43,0.86,12,57,69,144,25,0,35,68
175,9,1998,30,1,1,66,0,831,105,213,0.493,9,35,0.257,96,178,0.539,0.514,42,50,0.84,16,60,76,150,29,0,42,74
175,10,1999,31,1,1,10,1,178,21,43,0.488,6,8,0.75,15,35,0.429,0.558,9,10,0.9,1,15,16,27,3,0,10,16
175,10,1999,31,1,1,22,0,180,19,45,0.422,1,7,0.143,18,38,0.474,0.433,9,11,0.818,1,22,23,34,9,0,15,15
175,10,1999,31,1,1,32,1,358,40,88,0.455,7,15,0.467,33,73,0.452,0.494,18,21,0.857,2,37,39,61,12,0,25,31
175,11,2000,32,1,1,27,18,583,83,186,0.446,13,29,0.448,70,157,0.446,0.481,22,25,0.88,2,45,47,78,7,1,40,34
176,1,1997,28,1,1,67,0,1010,132,345,0.383,55,181,0.304,77,164,0.47,0.462,92,106,0.868,35,41,76,175,61,9,99,114
176,2,1998,29,1,1,48,17,1236,156,380,0.411,25,68,0.368,131,312,0.42,0.443,105,123,0.854,65,94,159,236,58,5,112,96
176,3,1999,30,1,1,50,15,1502,230,522,0.441,69,189,0.365,161,333,0.483,0.507,161,178,0.904,53,127,180,335,108,4,158,90
176,4,2000,31,1,1,82,82,2590,484,1119,0.433,137,403,0.34,347,716,0.485,0.494,225,247,0.911,65,205,270,501,169,9,248,137
176,5,2001,32,1,1,75,75,2767,413,1002,0.412,143,403,0.355,270,599,0.451,0.484,220,249,0.884,94,249,343,524,135,13,200,155
176,6,2002,33,1,1,82,79,2730,347,828,0.419,139,398,0.349,208,430,0.484,0.503,182,205,0.888,83,236,319,453,157,10,175,166
176,7,2003,34,1,1,82,23,2350,263,643,0.409,78,232,0.336,185,411,0.45,0.47,165,188,0.878,91,204,295,323,135,13,160,167
176,8,2004,35,1,1,79,22,2247,291,736,0.395,135,429,0.315,156,307,0.508,0.487,123,144,0.854,63,163,226,311,133,16,155,148
176,9,2005,36,1,1,14,9,412,53,159,0.333,17,70,0.243,36,89,0.404,0.387,19,21,0.905,16,32,48,65,15,2,28,30
176,9,2005,36,1,1,52,7,576,36,118,0.305,11,41,0.268,25,77,0.325,0.352,39,47,0.83,19,48,67,113,30,6,39,62
176,9,2005,36,1,1,66,16,988,89,277,0.321,28,111,0.252,61,166,0.367,0.372,58,68,0.853,35,80,115,178,45,8,67,92
176,10,2006,37,1,1,62,2,622,43,128,0.336,11,48,0.229,32,80,0.4,0.379,33,42,0.786,18,63,81,86,27,3,58,71
176,11,2007,38,1,1,81,4,1275,156,377,0.414,72,214,0.336,84,163,0.515,0.509,73,93,0.785,34,101,135,191,70,6,76,102
176,12,2008,39,1,1,50,2,549,40,110,0.364,23,69,0.333,17,41,0.415,0.468,20,30,0.667,17,50,67,73,28,2,41,53
184,1,2000,25,1,1,82,0,1626,314,741,0.424,57,163,0.35,257,578,0.445,0.462,97,133,0.729,20,106,126,306,52,3,142,137
184,2,2001,26,1,1,81,75,2363,380,952,0.399,121,339,0.357,259,613,0.423,0.463,90,130,0.692,28,145,173,330,67,5,149,184
184,3,2002,27,1,1,79,62,2285,368,790,0.466,138,336,0.411,230,454,0.507,0.553,83,120,0.692,31,127,158,263,72,11,128,177
184,4,2003,28,1,1,65,7,1398,168,465,0.361,86,242,0.355,82,223,0.368,0.454,40,49,0.816,21,75,96,175,27,4,77,108
184,5,2004,29,1,1,40,0,751,88,235,0.374,42,130,0.323,46,105,0.438,0.464,31,43,0.721,6,42,48,95,19,1,48,60
184,5,2004,29,1,1,24,24,793,104,249,0.418,39,111,0.351,65,138,0.471,0.496,42,54,0.778,3,42,45,128,26,1,44,42
184,5,2004,29,1,1,64,24,1544,192,484,0.397,81,241,0.336,111,243,0.457,0.48,73,97,0.753,9,84,93,223,45,2,92,102
184,6,2005,30,1,1,82,82,2903,388,910,0.426,176,455,0.387,212,455,0.466,0.523,163,203,0.803,31,166,197,358,73,2,151,181
184,7,2006,31,1,1,43,39,1161,160,399,0.401,64,182,0.352,96,217,0.442,0.481,107,132,0.811,11,64,75,129,29,2,57,94
184,7,2006,31,1,1,71,41,1713,226,573,0.394,97,274,0.354,129,299,0.431,0.479,129,163,0.791,23,97,120,198,43,2,87,152
184,8,2007,32,1,1,75,23,2064,310,715,0.434,116,306,0.379,194,409,0.474,0.515,252,311,0.81,18,121,139,346,50,4,127,136
184,10,2009,34,1,1,14,0,115,9,27,0.333,5,17,0.294,4,10,0.4,0.426,4,4,1,0,6,6,28,2,1,10,5
184,10,2009,34,1,1,19,0,297,25,86,0.291,10,40,0.25,15,46,0.326,0.349,11,12,0.917,5,13,18,31,8,1,13,22
184,10,2009,34,1,1,33,0,412,34,113,0.301,15,57,0.263,19,56,0.339,0.367,15,16,0.938,5,19,24,59,10,2,23,27
184,11,2010,35,1,1,40,11,644,57,157,0.363,22,73,0.301,35,84,0.417,0.433,25,27,0.926,5,24,29,91,17,0,32,53
185,1,2009,21,1,1,72,12,1908,267,621,0.43,108,246,0.439,159,375,0.424,0.517,208,233,0.893,17,116,133,250,42,2,119,140
185,2,2010,22,1,1,80,2,1472,168,435,0.386,70,178,0.393,98,257,0.381,0.467,102,131,0.779,11,86,97,193,45,5,74,127
185,3,2011,23,1,1,82,82,2757,399,958,0.416,111,333,0.333,288,625,0.461,0.474,269,297,0.906,38,187,225,498,54,3,155,152
185,4,2012,24,1,1,48,46,1408,183,487,0.376,61,179,0.341,122,308,0.396,0.438,105,120,0.875,24,85,109,307,36,1,110,65
185,5,2013,25,1,1,76,5,1226,103,294,0.35,67,190,0.353,36,104,0.346,0.464,83,99,0.838,20,71,91,170,34,3,68,64
185,6,2014,26,1,1,61,9,1857,291,694,0.419,132,321,0.411,159,373,0.426,0.514,195,221,0.882,15,111,126,303,52,3,116,140
185,6,2014,26,1,1,71,9,1939,298,718,0.415,133,332,0.401,165,386,0.427,0.508,201,227,0.885,15,115,130,313,53,3,125,147
185,7,2015,27,1,1,10,0,215,30,83,0.361,7,31,0.226,23,52,0.442,0.404,36,45,0.8,2,16,18,31,3,0,17,14
191,1,2000,20,1,1,59,1,484,56,181,0.309,18,63,0.286,38,118,0.322,0.359,24,36,0.667,8,32,40,88,14,2,42,60
191,2,2001,21,1,1,55,0,463,55,144,0.382,16,59,0.271,39,85,0.459,0.438,28,36,0.778,5,24,29,75,13,4,45,48
191,3,2002,22,1,1,28,0,258,26,90,0.289,6,35,0.171,20,55,0.364,0.322,13,19,0.684,4,20,24,36,7,0,19,17
213,1,2004,22,1,1,81,2,1385,177,442,0.4,27,86,0.314,150,356,0.421,0.431,99,131,0.756,30,103,133,175,88,13,125,171
213,2,2005,23,1,1,81,2,1145,115,286,0.402,21,59,0.356,94,227,0.414,0.439,121,163,0.742,29,97,126,155,63,13,79,146
213,3,2006,24,1,1,18,1,269,33,80,0.413,6,19,0.316,27,61,0.443,0.45,27,30,0.9,4,15,19,32,7,0,23,38
213,3,2006,24,1,1,40,28,1228,186,388,0.479,16,44,0.364,170,344,0.494,0.5,91,117,0.778,19,97,116,188,47,11,96,124
213,3,2006,24,1,1,58,29,1497,219,468,0.468,22,63,0.349,197,405,0.486,0.491,118,147,0.803,23,112,135,220,54,11,119,162
213,4,2007,25,1,1,45,1,503,84,196,0.429,5,29,0.172,79,167,0.473,0.441,48,60,0.8,10,28,38,60,23,3,40,70
213,5,2008,26,1,1,12,2,259,42,82,0.512,15,37,0.405,27,45,0.6,0.604,15,19,0.789,1,24,25,36,6,5,21,27
213,5,2008,26,1,1,24,1,310,44,109,0.404,25,65,0.385,19,44,0.432,0.518,12,16,0.75,3,17,20,25,8,8,16,38
213,5,2008,26,1,1,36,3,569,86,191,0.45,40,102,0.392,46,89,0.517,0.555,27,35,0.771,4,41,45,61,14,13,37,65
213,6,2009,27,1,1,16,0,166,15,39,0.385,2,14,0.143,13,25,0.52,0.41,10,15,0.667,0,15,15,22,10,2,11,21
213,6,2009,27,1,1,22,0,206,21,57,0.368,3,19,0.158,18,38,0.474,0.395,11,18,0.611,1,17,18,28,11,2,14,26
213,7,2010,28,1,1,22,0,244,39,73,0.534,7,24,0.292,32,49,0.653,0.582,24,29,0.828,3,20,23,26,12,2,20,30
217,1,2004,21,1,1,70,46,1500,210,470,0.447,83,210,0.395,127,260,0.488,0.535,47,61,0.77,23,100,123,165,93,7,120,184
217,2,2005,22,1,1,63,6,1087,168,354,0.475,51,139,0.367,117,215,0.544,0.547,55,69,0.797,32,98,130,126,30,7,87,127
217,7,2010,27,1,1,44,5,786,155,365,0.425,44,136,0.324,111,229,0.485,0.485,64,73,0.877,11,58,69,64,23,12,46,71
217,10,2013,30,1,1,41,2,513,83,193,0.43,18,47,0.383,65,146,0.445,0.477,31,41,0.756,8,38,46,58,17,6,21,51
217,11,2014,31,1,1,20,0,368,56,131,0.427,7,25,0.28,49,106,0.462,0.454,31,39,0.795,5,32,37,32,7,4,19,30
218,1,2007,22,1,1,33,1,191,28,78,0.359,6,21,0.286,22,57,0.386,0.397,16,24,0.667,7,18,25,24,1,1,14,19
218,2,2008,23,1,1,44,9,460,71,170,0.418,21,54,0.389,50,116,0.431,0.479,28,35,0.8,4,43,47,58,14,1,35,48
218,4,2010,25,1,1,78,18,1546,232,527,0.44,56,157,0.357,176,370,0.476,0.493,76,90,0.844,17,129,146,258,35,6,102,119
218,5,2011,26,1,1,81,2,1669,285,649,0.439,66,189,0.349,219,460,0.476,0.49,133,157,0.847,29,130,159,317,30,1,136,136
218,6,2012,27,1,1,41,11,1032,167,418,0.4,53,143,0.371,114,275,0.415,0.463,76,98,0.776,14,100,114,232,21,0,103,61
218,7,2013,28,1,1,74,2,1713,316,758,0.417,97,280,0.346,219,478,0.458,0.481,105,134,0.784,34,173,207,294,32,0,145,131
218,8,2014,29,1,1,79,1,1471,254,656,0.387,73,231,0.316,181,425,0.426,0.443,79,100,0.79,16,138,154,303,26,0,125,129
218,9,2015,30,1,1,9,0,141,25,62,0.403,3,11,0.273,22,51,0.431,0.427,11,11,1,1,12,13,34,10,0,5,12
226,1,2002,23,1,1,19,4,228,24,68,0.353,1,7,0.143,23,61,0.377,0.36,9,10,0.9,5,13,18,34,17,1,12,29
235,1,2005,22,1,1,11,1,169,25,55,0.455,5,15,0.333,20,40,0.5,0.5,7,9,0.778,6,15,21,27,5,1,11,16
235,1,2005,22,1,1,27,0,314,20,69,0.29,9,37,0.243,11,32,0.344,0.355,7,10,0.7,5,14,19,42,14,0,16,35
235,1,2005,22,1,1,38,1,483,45,124,0.363,14,52,0.269,31,72,0.431,0.419,14,19,0.737,11,29,40,69,19,1,27,51
235,2,2006,23,1,1,17,0,261,35,97,0.361,2,13,0.154,33,84,0.393,0.371,6,9,0.667,8,14,22,50,10,0,14,12
235,2,2006,23,1,1,19,0,282,38,104,0.365,2,14,0.143,36,90,0.4,0.375,9,12,0.75,9,16,25,52,10,0,15,13
239,1,1998,24,1,1,27,0,256,18,38,0.474,9,21,0.429,9,17,0.529,0.592,11,13,0.846,5,30,35,49,10,1,30,28
239,3,2000,26,1,1,16,0,159,15,33,0.455,7,18,0.389,8,15,0.533,0.561,4,5,0.8,0,12,12,33,2,0,13,23
261,1,2009,20,1,1,53,0,655,69,189,0.365,7,27,0.259,62,162,0.383,0.384,83,103,0.806,8,49,57,78,16,2,56,81
261,3,2011,22,1,1,11,0,149,17,49,0.347,3,14,0.214,14,35,0.4,0.378,13,17,0.765,2,13,15,28,2,1,17,16
261,3,2011,22,1,1,60,14,1347,201,468,0.429,46,132,0.348,155,336,0.461,0.479,153,189,0.81,24,126,150,238,36,4,110,133
261,3,2011,22,1,1,71,14,1496,218,517,0.422,49,146,0.336,169,371,0.456,0.469,166,206,0.806,26,139,165,266,38,5,127,149
261,4,2012,23,1,1,31,11,705,117,276,0.424,44,104,0.423,73,172,0.424,0.504,75,88,0.852,8,58,66,118,24,4,53,70
261,5,2013,24,1,1,80,4,1765,260,621,0.419,71,201,0.353,189,420,0.45,0.476,102,122,0.836,22,154,176,264,59,17,120,168
261,6,2014,25,1,1,31,5,650,90,239,0.377,25,83,0.301,65,156,0.417,0.429,45,57,0.789,8,51,59,66,20,5,22,72
261,6,2014,25,1,1,41,14,1036,158,378,0.418,51,129,0.395,107,249,0.43,0.485,49,61,0.803,14,72,86,128,40,4,60,89
261,6,2014,25,1,1,72,19,1686,248,617,0.402,76,212,0.358,172,405,0.425,0.464,94,118,0.797,22,123,145,194,60,9,82,161
261,7,2015,26,1,1,9,0,174,23,52,0.442,5,14,0.357,18,38,0.474,0.49,14,14,1,1,14,15,20,7,0,13,19
275,1,2010,21,1,1,56,16,700,155,299,0.518,45,110,0.409,110,189,0.582,0.594,42,52,0.808,12,66,78,74,29,12,54,84
275,2,2011,22,1,1,28,26,496,94,223,0.422,25,83,0.301,69,140,0.493,0.478,23,30,0.767,7,45,52,64,20,8,47,76
275,3,2012,23,1,1,53,12,1151,188,445,0.422,38,132,0.288,150,313,0.479,0.465,58,69,0.841,19,132,151,152,56,28,70,98
275,4,2013,24,1,1,45,0,549,65,176,0.369,21,72,0.292,44,104,0.423,0.429,30,38,0.789,9,48,57,84,19,4,33,54
286,1,2008,21,1,1,33,0,241,36,93,0.387,16,41,0.39,20,52,0.385,0.473,7,9,0.778,3,11,14,15,5,0,12,15
294,1,1993,23,1,1,75,2,857,110,260,0.423,26,80,0.325,84,180,0.467,0.473,30,41,0.732,12,51,63,136,30,0,50,110
294,2,1994,24,1,1,74,5,983,105,263,0.399,27,75,0.36,78,188,0.415,0.451,11,15,0.733,16,74,90,163,39,1,40,84
303,1,1980,23,1,1,68,-1,869,88,250,0.352,10,26,0.385,78,224,0.348,0.372,58,87,0.667,16,47,63,139,58,5,104,105
308,1,1980,30,1,1,82,-1,2035,251,626,0.401,11,52,0.212,240,574,0.418,0.41,226,286,0.79,65,143,208,307,62,6,147,161
308,2,1981,31,1,1,73,-1,1112,118,306,0.386,32,95,0.337,86,211,0.408,0.438,67,98,0.684,25,49,74,200,47,2,76,85
309,1,1996,23,1,1,59,1,571,69,163,0.423,8,25,0.32,61,138,0.442,0.448,75,90,0.833,11,33,44,97,20,3,63,80
309,2,1997,24,1,1,76,46,2064,274,620,0.442,57,155,0.368,217,465,0.467,0.488,149,197,0.756,36,130,166,318,98,5,153,221
309,3,1998,25,1,1,82,0,1547,201,480,0.419,21,70,0.3,180,410,0.439,0.441,112,131,0.855,28,94,122,281,85,5,111,193
309,4,1999,26,1,1,49,0,1043,127,305,0.416,22,59,0.373,105,246,0.427,0.452,70,83,0.843,19,61,80,169,42,4,62,111
309,5,2000,27,1,1,82,0,1691,271,561,0.483,35,93,0.376,236,468,0.504,0.514,156,190,0.821,16,126,142,272,76,5,107,204
309,6,2001,28,1,1,77,21,2457,347,788,0.44,37,97,0.381,310,691,0.449,0.464,187,226,0.827,38,184,222,473,110,11,127,246
309,7,2002,29,1,1,30,18,793,112,254,0.441,8,25,0.32,104,229,0.454,0.457,47,51,0.922,10,71,81,149,32,1,40,72
309,7,2002,29,1,1,44,3,954,116,264,0.439,13,34,0.382,103,230,0.448,0.464,57,65,0.877,10,60,70,175,57,6,59,101
309,7,2002,29,1,1,74,21,1747,228,518,0.44,21,59,0.356,207,459,0.451,0.46,104,116,0.897,20,131,151,324,89,7,99,173
309,8,2003,30,1,1,72,52,1807,231,583,0.396,36,109,0.33,195,474,0.411,0.427,105,123,0.854,26,121,147,255,44,7,106,174
309,9,2004,31,1,1,61,1,762,64,172,0.372,3,20,0.15,61,152,0.401,0.381,40,46,0.87,17,51,68,112,31,4,33,66
309,10,2005,32,1,1,76,6,1461,190,452,0.42,26,85,0.306,164,367,0.447,0.449,108,122,0.885,19,88,107,143,66,9,67,148
310,1,2013,24,1,1,41,0,713,79,189,0.418,36,96,0.375,43,93,0.462,0.513,34,41,0.829,45,64,109,117,37,21,44,83
314,1,1999,20,1,1,50,50,1758,260,605,0.43,15,74,0.203,245,531,0.461,0.442,127,169,0.751,30,106,136,325,78,5,146,122
314,2,2000,21,1,1,82,82,3155,459,1031,0.445,77,212,0.363,382,819,0.466,0.483,195,250,0.78,73,233,306,665,132,15,247,171
314,3,2001,22,1,1,82,82,3190,525,1157,0.454,108,285,0.379,417,872,0.478,0.5,143,188,0.761,47,257,304,685,107,12,248,148
314,4,2002,23,1,1,80,80,2659,446,985,0.453,51,138,0.37,395,847,0.466,0.479,155,193,0.803,37,185,222,403,87,15,134,133
314,5,2003,24,1,1,55,55,1835,329,700,0.47,56,137,0.409,273,563,0.485,0.51,161,187,0.861,34,113,147,285,72,8,127,93
314,6,2004,25,1,1,82,82,2980,527,1170,0.45,148,378,0.392,379,792,0.479,0.514,304,373,0.815,67,210,277,444,112,18,175,146
314,7,2005,26,1,1,80,80,3084,560,1264,0.443,131,364,0.36,429,900,0.477,0.495,320,413,0.775,77,255,332,541,124,30,203,191
314,8,2006,27,1,1,82,82,3167,597,1382,0.432,192,497,0.386,405,885,0.458,0.501,342,403,0.849,29,211,240,444,82,10,199,169
314,9,2007,28,1,1,82,82,2784,471,1166,0.404,173,481,0.36,298,685,0.435,0.478,288,347,0.83,39,224,263,388,88,6,197,139
314,10,2008,29,1,1,15,12,473,78,192,0.406,24,61,0.393,54,131,0.412,0.469,23,31,0.742,11,45,56,75,19,2,38,34
314,10,2008,29,1,1,33,32,1100,170,411,0.414,69,187,0.369,101,224,0.451,0.498,55,69,0.797,5,99,104,215,35,2,81,63
314,10,2008,29,1,1,48,44,1573,248,603,0.411,93,248,0.375,155,355,0.437,0.488,78,100,0.78,16,144,160,290,54,4,119,97
314,11,2009,30,1,1,79,79,2740,437,1005,0.435,167,428,0.39,270,577,0.468,0.518,135,171,0.789,38,240,278,392,98,11,128,145
314,12,2010,31,1,1,80,80,2195,268,644,0.416,126,324,0.389,142,320,0.444,0.514,68,79,0.861,20,164,184,310,67,3,90,157
314,13,2011,32,1,1,22,12,582,55,126,0.437,40,88,0.455,15,38,0.395,0.595,10,16,0.625,2,47,49,55,11,3,32,47
314,13,2011,32,1,1,56,56,1674,192,441,0.435,113,256,0.441,79,185,0.427,0.563,29,46,0.63,15,128,143,202,38,6,68,125
314,13,2011,32,1,1,80,68,2285,248,576,0.431,153,348,0.44,95,228,0.417,0.563,39,62,0.629,17,178,195,265,50,9,101,175
314,14,2012,33,1,1,39,4,557,35,124,0.282,27,85,0.318,8,39,0.205,0.391,6,8,0.75,5,54,59,80,21,3,20,45
316,1,1998,21,1,1,29,26,920,103,295,0.349,43,136,0.316,60,159,0.377,0.422,79,86,0.919,22,55,77,97,30,2,56,54
316,1,1998,21,1,1,51,44,1296,177,454,0.39,64,189,0.339,113,265,0.426,0.46,147,180,0.817,40,73,113,217,77,2,118,118
316,1,1998,21,1,1,80,70,2216,280,749,0.374,107,325,0.329,173,424,0.408,0.445,226,266,0.85,62,128,190,314,107,4,174,172
316,5,2002,25,1,1,82,54,2355,348,823,0.423,124,315,0.394,224,508,0.441,0.498,207,234,0.885,35,191,226,450,66,17,138,169
316,6,2003,26,1,1,74,74,2327,366,870,0.421,149,380,0.392,217,490,0.443,0.506,318,362,0.878,38,235,273,287,63,15,134,136
316,7,2004,27,1,1,78,78,2758,392,996,0.394,130,335,0.388,262,661,0.396,0.459,404,460,0.878,35,241,276,446,84,8,189,177
316,8,2005,28,1,1,80,80,2866,404,913,0.442,165,387,0.426,239,526,0.454,0.533,343,382,0.898,48,223,271,464,81,9,180,194
316,9,2006,29,1,1,81,81,2925,423,1012,0.418,184,425,0.433,239,587,0.407,0.509,465,520,0.894,41,211,252,699,71,8,170,160
316,10,2007,30,1,1,70,70,2533,348,815,0.427,109,316,0.345,239,499,0.479,0.494,386,437,0.883,23,214,237,502,84,17,140,161
316,11,2008,31,1,1,78,78,2522,393,877,0.448,137,342,0.401,256,535,0.479,0.526,401,437,0.918,42,170,212,529,101,17,160,130
316,12,2009,32,1,1,77,77,2719,403,959,0.42,160,390,0.41,243,569,0.427,0.504,409,448,0.913,31,198,229,491,90,17,173,158
316,12,2009,32,1,1,79,79,2789,410,980,0.418,162,397,0.408,248,583,0.425,0.501,418,458,0.913,32,207,239,506,93,18,177,161
316,13,2010,33,1,1,73,73,2490,402,962,0.418,157,407,0.386,245,555,0.441,0.499,466,512,0.91,25,203,228,409,82,9,177,153
316,14,2011,34,1,1,21,21,664,104,258,0.403,41,125,0.328,63,133,0.474,0.483,119,132,0.902,13,52,65,116,19,2,48,52
316,14,2011,34,1,1,51,51,1646,235,536,0.438,105,238,0.441,130,298,0.436,0.536,265,287,0.923,12,113,125,271,52,12,129,94
316,14,2011,34,1,1,72,72,2310,339,794,0.427,146,363,0.402,193,431,0.448,0.519,384,419,0.916,25,165,190,387,71,14,177,146
332,1,1988,22,1,1,10,0,112,15,41,0.366,2,11,0.182,13,30,0.433,0.39,5,6,0.833,2,4,6,18,3,0,8,16
333,1,2004,23,1,1,75,14,1392,157,407,0.386,75,202,0.371,82,205,0.4,0.478,55,67,0.821,18,99,117,209,57,7,128,100
333,2,2005,24,1,1,44,1,648,61,186,0.328,36,93,0.387,25,93,0.269,0.425,33,41,0.805,18,53,71,69,13,0,39,47
333,3,2006,25,1,1,68,57,1781,206,470,0.438,76,184,0.413,130,286,0.455,0.519,72,91,0.791,26,120,146,306,42,5,83,107
333,4,2007,26,1,1,33,2,583,45,129,0.349,19,68,0.279,26,61,0.426,0.422,11,20,0.55,7,38,45,84,10,3,28,49
333,4,2007,26,1,1,49,40,1642,164,380,0.432,48,140,0.343,116,240,0.483,0.495,32,44,0.727,14,110,124,324,51,5,101,72
333,4,2007,26,1,1,82,42,2225,209,509,0.411,67,208,0.322,142,301,0.472,0.476,43,64,0.672,21,148,169,408,61,8,129,121
333,5,2008,27,1,1,81,78,2424,261,640,0.408,121,298,0.406,140,342,0.409,0.502,49,64,0.766,31,164,195,413,55,4,113,133
333,6,2009,28,1,1,69,69,2188,277,647,0.428,140,328,0.427,137,319,0.429,0.536,63,75,0.84,28,145,173,348,69,4,108,126
333,7,2010,29,1,1,29,10,762,74,167,0.443,38,87,0.437,36,80,0.45,0.557,12,16,0.75,6,63,69,177,21,4,63,39
333,7,2010,29,1,1,51,28,1397,143,355,0.403,78,207,0.377,65,148,0.439,0.513,24,32,0.75,15,103,118,203,37,2,65,84
333,7,2010,29,1,1,80,38,2159,217,522,0.416,116,294,0.395,101,228,0.443,0.527,36,48,0.75,21,166,187,380,58,6,128,123
333,8,2011,30,1,1,79,0,1581,110,306,0.359,73,193,0.378,37,113,0.327,0.479,26,30,0.867,19,137,156,170,40,3,73,99
333,9,2012,31,1,1,53,5,1237,101,268,0.377,53,158,0.335,48,110,0.436,0.476,21,27,0.778,9,76,85,175,39,2,72,75
333,10,2013,32,1,1,45,13,1175,114,270,0.422,72,171,0.421,42,99,0.424,0.556,27,35,0.771,21,111,132,173,34,6,62,83
333,11,2014,33,1,1,28,1,607,45,120,0.375,27,79,0.342,18,41,0.439,0.488,5,8,0.625,5,51,56,102,20,6,31,36
333,11,2014,33,1,1,27,27,891,88,233,0.378,52,131,0.397,36,102,0.353,0.489,28,35,0.8,8,95,103,205,34,2,71,49
333,11,2014,33,1,1,55,28,1498,133,353,0.377,79,210,0.376,54,143,0.378,0.489,33,43,0.767,13,146,159,307,54,8,102,85
333,12,2015,34,1,1,10,0,216,16,46,0.348,13,37,0.351,3,9,0.333,0.489,5,6,0.833,2,22,24,38,8,1,14,18
334,1,2007,23,1,1,14,0,166,9,30,0.3,1,5,0.2,8,25,0.32,0.317,6,6,1,6,9,15,17,5,0,12,9
339,1,1990,22,1,1,50,17,1267,212,571,0.371,18,80,0.225,194,491,0.395,0.387,63,81,0.778,42,98,140,210,82,14,111,110
339,2,1991,23,1,1,72,70,2585,432,1039,0.416,14,91,0.154,418,948,0.441,0.423,139,176,0.79,67,182,249,441,169,40,207,180
339,3,1992,24,1,1,72,67,2548,429,993,0.432,12,54,0.222,417,939,0.444,0.438,126,177,0.712,101,168,269,492,170,40,152,182
339,4,1993,25,1,1,80,78,2820,414,964,0.429,118,315,0.375,296,649,0.456,0.491,123,169,0.728,89,191,280,671,203,23,187,156
339,5,1994,26,1,1,81,81,2915,444,1079,0.411,114,341,0.334,330,738,0.447,0.464,116,159,0.73,117,307,424,789,212,44,196,144
339,6,1995,27,1,1,80,80,3069,509,1198,0.425,199,555,0.359,310,643,0.482,0.508,156,214,0.729,117,276,393,616,200,26,242,164
339,7,1996,28,1,1,81,81,2893,455,1123,0.405,231,623,0.371,224,500,0.448,0.508,127,170,0.747,110,222,332,478,212,17,188,151
339,8,1997,29,1,1,78,78,3056,501,1159,0.432,221,604,0.366,280,555,0.505,0.528,131,174,0.753,114,299,413,463,212,20,185,141
339,9,1998,30,1,1,70,69,2700,368,938,0.392,90,334,0.269,278,604,0.46,0.44,95,134,0.709,81,260,341,469,183,21,176,122
339,10,1999,31,1,1,48,48,1763,247,651,0.379,77,251,0.307,170,400,0.425,0.439,69,91,0.758,45,179,224,278,99,9,115,61
339,11,2000,32,1,1,73,72,2459,327,837,0.391,101,301,0.336,226,536,0.422,0.451,67,95,0.705,55,215,270,489,146,22,143,122
339,12,2001,33,1,1,69,59,2352,317,801,0.396,73,225,0.324,244,576,0.424,0.441,53,76,0.697,71,201,272,462,163,20,128,134
339,13,2002,34,1,1,35,0,599,50,146,0.342,15,42,0.357,35,104,0.337,0.394,4,8,0.5,8,44,52,114,24,4,37,20
340,1,2011,21,1,1,81,25,1841,206,486,0.424,32,116,0.276,174,370,0.47,0.457,99,133,0.744,68,155,223,289,92,26,194,130
340,2,2012,22,1,1,40,1,464,49,126,0.389,6,30,0.2,43,96,0.448,0.413,28,44,0.636,22,43,65,66,31,14,47,58
340,3,2013,23,1,1,76,12,1553,253,568,0.445,31,78,0.397,222,490,0.453,0.473,106,134,0.791,78,147,225,233,109,55,137,112
340,4,2014,24,1,1,43,40,1416,265,556,0.477,50,140,0.357,215,416,0.517,0.522,183,237,0.772,27,175,202,235,69,14,143,99
340,5,2015,25,1,1,10,10,312,45,102,0.441,11,29,0.379,34,73,0.466,0.495,32,39,0.821,9,41,50,54,10,6,32,27
353,1,1988,23,1,1,79,14,1628,166,426,0.39,3,16,0.188,163,410,0.398,0.393,58,74,0.784,35,101,136,404,127,3,101,138
353,2,1989,24,1,1,79,21,1755,178,418,0.426,1,13,0.077,177,405,0.437,0.427,66,88,0.75,53,112,165,620,111,7,124,141
353,3,1990,25,1,1,81,65,2743,326,664,0.491,5,26,0.192,321,638,0.503,0.495,106,134,0.791,48,159,207,867,166,3,146,168
353,4,1991,26,1,1,81,46,2299,241,524,0.46,0,12,0,241,512,0.471,0.46,86,108,0.796,58,158,216,669,137,3,120,160
353,5,1992,27,1,1,82,69,2790,317,671,0.472,2,27,0.074,315,644,0.489,0.474,94,120,0.783,58,177,235,743,170,6,156,156
353,6,1993,28,1,1,81,80,2833,331,730,0.453,6,26,0.231,325,704,0.462,0.458,140,168,0.833,51,247,298,711,161,5,154,179
353,7,1994,29,1,1,77,77,2746,354,751,0.471,2,12,0.167,352,739,0.476,0.473,125,155,0.806,78,235,313,780,133,2,171,147
353,8,1995,30,1,1,78,78,2629,348,730,0.477,6,30,0.2,342,700,0.489,0.481,160,180,0.889,51,206,257,675,103,0,132,151
353,9,1997,32,1,1,65,65,1880,204,443,0.46,60,144,0.417,144,299,0.482,0.528,54,64,0.844,25,116,141,469,82,2,108,114
353,10,1998,33,1,1,59,31,1554,139,318,0.437,4,16,0.25,135,302,0.447,0.443,59,66,0.894,30,101,131,327,65,3,104,56
353,10,1998,33,1,1,61,31,1570,141,323,0.437,4,16,0.25,137,307,0.446,0.443,61,68,0.897,30,102,132,331,67,3,105,58
353,11,1999,34,1,1,36,5,714,76,154,0.494,0,6,0,76,148,0.514,0.494,31,36,0.861,16,57,73,134,43,1,47,44
353,12,2000,35,1,1,80,5,1731,157,358,0.439,17,51,0.333,140,307,0.456,0.462,79,87,0.908,25,110,135,299,65,4,59,119
366,1,1996,23,1,1,11,0,131,16,50,0.32,3,19,0.158,13,31,0.419,0.35,9,11,0.818,1,8,9,21,5,1,12,18
366,2,1997,24,1,1,16,4,409,44,101,0.436,11,35,0.314,33,66,0.5,0.49,18,20,0.9,7,21,28,50,3,2,20,28
366,2,1997,24,1,1,21,4,430,46,105,0.438,12,37,0.324,34,68,0.5,0.495,18,20,0.9,7,22,29,53,3,2,27,28
400,1,2011,20,1,1,31,0,162,23,67,0.343,0,5,0,23,62,0.371,0.343,6,12,0.5,4,13,17,12,9,0,16,20
400,2,2012,21,1,1,64,28,1368,200,402,0.498,22,54,0.407,178,348,0.511,0.525,62,78,0.795,34,81,115,87,43,12,75,109
400,3,2013,22,1,1,50,50,1435,192,478,0.402,40,126,0.317,152,352,0.432,0.444,37,49,0.755,30,81,111,104,64,19,72,129
400,4,2014,23,1,1,60,58,1855,361,825,0.438,79,200,0.395,282,625,0.451,0.485,90,112,0.804,48,178,226,85,63,11,96,145
413,1,1992,21,1,1,82,9,1605,252,601,0.419,1,23,0.043,251,578,0.434,0.42,100,124,0.806,49,113,162,316,81,22,136,107
413,2,1993,22,1,1,82,8,1622,297,621,0.478,13,42,0.31,284,579,0.491,0.489,118,143,0.825,37,142,179,302,79,27,107,122
413,3,1994,23,1,1,73,10,1548,230,548,0.42,7,32,0.219,223,516,0.432,0.426,139,162,0.858,38,121,159,277,84,16,111,108
413,4,1995,24,1,1,67,41,1961,341,762,0.448,48,121,0.397,293,641,0.457,0.479,159,186,0.855,35,151,186,363,107,14,144,118
413,5,1996,25,1,1,75,75,2570,510,1096,0.465,91,235,0.387,419,861,0.487,0.507,338,381,0.887,47,201,248,487,132,33,142,146
413,6,1997,26,1,1,78,78,2868,575,1313,0.438,101,271,0.373,474,1042,0.455,0.476,268,297,0.902,48,253,301,490,138,30,178,177
413,7,1998,27,1,1,50,48,1784,339,731,0.464,31,93,0.333,308,638,0.483,0.485,132,156,0.846,23,153,176,387,111,17,145,120
413,8,1999,28,1,1,15,14,505,85,208,0.409,7,28,0.25,78,180,0.433,0.425,26,31,0.839,11,42,53,104,24,3,36,25
413,8,1999,28,1,1,21,20,712,127,299,0.425,5,19,0.263,122,280,0.436,0.433,39,47,0.83,16,65,81,205,39,7,38,57
413,8,1999,28,1,1,36,34,1217,212,507,0.418,12,47,0.255,200,460,0.435,0.43,65,78,0.833,27,107,134,309,63,10,74,82
413,9,2000,29,1,1,71,71,2587,486,1042,0.466,53,132,0.402,433,910,0.476,0.492,187,208,0.899,44,194,238,629,134,30,184,158
413,10,2001,30,1,1,78,78,2821,511,1134,0.451,33,91,0.363,478,1043,0.458,0.465,195,224,0.871,60,238,298,583,161,21,155,138
413,11,2002,31,1,1,32,28,962,155,365,0.425,4,23,0.174,151,342,0.442,0.43,83,84,0.988,17,76,93,264,52,6,43,49
417,1,1980,24,1,1,82,-1,1589,269,687,0.392,21,86,0.244,248,601,0.413,0.407,141,162,0.87,50,117,167,223,93,9,135,165
417,2,1981,25,1,1,80,-1,2595,319,817,0.39,57,169,0.337,262,648,0.404,0.425,107,132,0.811,66,132,198,452,136,17,162,194
417,3,1982,26,1,1,81,3,1616,230,565,0.407,46,138,0.333,184,427,0.431,0.448,119,152,0.783,40,126,166,438,65,11,139,183
417,4,1983,27,1,1,15,0,140,14,42,0.333,1,8,0.125,13,34,0.382,0.345,10,13,0.769,3,16,19,23,7,0,14,20
417,5,1984,28,1,1,82,0,1428,213,521,0.409,15,51,0.294,198,470,0.421,0.423,120,137,0.876,41,102,143,252,84,6,109,155
417,6,1985,29,1,1,56,6,746,106,250,0.424,6,26,0.231,100,224,0.446,0.436,69,82,0.841,11,47,58,122,47,4,54,76
417,7,1986,30,1,1,33,0,269,26,70,0.371,4,14,0.286,22,56,0.393,0.4,14,18,0.778,2,21,23,39,13,0,17,43
418,1,2003,22,1,1,64,41,1503,171,464,0.369,101,286,0.353,70,178,0.393,0.477,85,111,0.766,18,127,145,164,38,3,59,80
418,2,2004,23,1,1,31,2,403,39,137,0.285,19,66,0.288,20,71,0.282,0.354,13,20,0.65,7,26,33,39,18,4,19,27
418,2,2004,23,1,1,36,2,443,43,158,0.272,19,74,0.257,24,84,0.286,0.332,13,20,0.65,9,27,36,51,18,4,24,32
423,1,2004,23,1,1,13,1,160,13,35,0.371,5,14,0.357,8,21,0.381,0.443,1,6,0.167,2,9,11,17,7,0,10,9
423,2,2005,24,1,1,18,0,185,11,37,0.297,3,15,0.2,8,22,0.364,0.338,6,13,0.462,6,16,22,12,8,1,13,11
445,1,1989,23,1,1,82,6,1372,156,371,0.42,55,153,0.359,101,218,0.463,0.495,61,69,0.884,19,75,94,306,69,3,65,116
445,2,1990,24,1,1,72,1,975,119,276,0.431,31,79,0.392,88,197,0.447,0.487,50,57,0.877,15,49,64,207,47,0,38,105
445,3,1991,25,1,1,80,0,980,159,370,0.43,45,135,0.333,114,235,0.485,0.491,61,72,0.847,28,44,72,204,53,5,51,122
445,4,1992,26,1,1,82,0,1082,167,374,0.447,32,90,0.356,135,284,0.475,0.489,51,63,0.81,27,72,99,205,66,7,51,82
445,5,1993,27,1,1,82,0,1516,183,385,0.475,41,99,0.414,142,286,0.497,0.529,112,135,0.83,22,77,99,243,79,3,72,136
445,6,1994,28,1,1,73,0,1225,142,289,0.491,23,61,0.377,119,228,0.522,0.531,74,85,0.871,10,92,102,149,51,2,55,98
445,7,1995,29,1,1,28,0,186,35,65,0.538,8,17,0.471,27,48,0.563,0.6,18,21,0.857,1,12,13,22,8,1,14,14
445,7,1995,29,1,1,31,0,622,91,210,0.433,17,52,0.327,74,158,0.468,0.474,46,58,0.793,13,40,53,94,26,3,33,42
445,7,1995,29,1,1,59,0,808,126,275,0.458,25,69,0.362,101,206,0.49,0.504,64,79,0.81,14,52,66,116,34,4,47,56
445,8,1996,30,1,1,69,0,716,134,293,0.457,25,62,0.403,109,231,0.472,0.5,59,69,0.855,11,30,41,100,42,3,43,53
445,9,1997,31,1,1,38,0,251,19,39,0.487,5,12,0.417,14,27,0.519,0.551,14,15,0.933,6,12,18,29,21,0,17,35
445,10,1998,32,1,1,43,0,312,28,66,0.424,5,11,0.455,23,55,0.418,0.462,18,20,0.9,6,24,30,49,18,3,12,25
448,1,2009,24,1,1,21,1,256,47,113,0.416,14,36,0.389,33,77,0.429,0.478,8,9,0.889,6,10,16,30,6,2,16,21
448,2,2010,25,1,1,23,0,191,28,85,0.329,9,32,0.281,19,53,0.358,0.382,5,7,0.714,8,12,20,42,6,0,22,14
448,2,2010,25,1,1,22,0,328,60,152,0.395,17,66,0.258,43,86,0.5,0.451,8,8,1,1,17,18,46,9,1,24,28
448,2,2010,25,1,1,45,0,519,88,237,0.371,26,98,0.265,62,139,0.446,0.426,13,15,0.867,9,29,38,88,15,1,46,42
452,1,1991,22,1,1,82,5,1945,284,612,0.464,7,34,0.206,277,578,0.479,0.47,137,157,0.873,41,141,182,344,83,14,137,161
452,2,1992,23,1,1,31,20,883,149,350,0.426,5,22,0.227,144,328,0.439,0.433,60,78,0.769,15,64,79,164,33,7,59,74
452,3,1993,24,1,1,80,48,2254,328,701,0.468,26,82,0.317,302,619,0.488,0.486,192,242,0.793,45,201,246,461,138,32,136,203
452,6,1996,27,1,1,65,23,1591,246,616,0.399,68,220,0.309,178,396,0.449,0.455,135,158,0.854,36,100,136,146,80,12,74,119
452,7,1997,28,1,1,21,2,522,61,166,0.367,20,65,0.308,41,101,0.406,0.428,18,22,0.818,8,40,48,67,31,7,24,45
452,9,1999,30,1,1,49,0,1377,187,495,0.378,135,349,0.387,52,146,0.356,0.514,40,55,0.727,15,88,103,143,56,8,80,75
452,10,2000,31,1,1,38,12,673,93,258,0.36,67,187,0.358,26,71,0.366,0.49,11,16,0.688,9,45,54,86,24,5,39,62
452,11,2001,32,1,1,7,0,155,16,44,0.364,12,32,0.375,4,12,0.333,0.5,4,5,0.8,0,11,11,12,4,0,7,10
458,4,1983,34,1,1,80,1,1432,371,714,0.52,14,32,0.438,357,682,0.523,0.529,58,72,0.806,32,65,97,242,59,13,110,98
473,1,1992,23,1,1,56,0,535,77,169,0.456,0,6,0,77,163,0.472,0.456,38,58,0.655,26,43,69,59,35,12,42,68
473,2,1993,24,1,1,75,34,1726,225,486,0.463,2,6,0.333,223,480,0.465,0.465,115,157,0.732,75,137,212,196,108,34,120,206
473,3,1994,25,1,1,61,2,1041,110,251,0.438,0,4,0,110,247,0.445,0.438,53,87,0.609,40,72,112,133,63,14,75,132
473,4,1995,26,1,1,67,2,1086,124,287,0.432,14,47,0.298,110,240,0.458,0.456,55,82,0.671,24,84,108,133,99,19,78,153
473,5,1996,27,1,1,68,0,671,78,192,0.406,1,11,0.091,77,181,0.425,0.409,28,46,0.609,17,49,66,73,57,12,31,88
473,6,1997,28,1,1,72,3,1057,140,333,0.42,4,22,0.182,136,311,0.437,0.426,57,84,0.679,34,77,111,133,81,17,58,116
473,7,1998,29,1,1,71,6,1147,116,302,0.384,0,5,0,116,297,0.391,0.384,56,78,0.718,34,60,94,151,71,12,63,118
473,8,1999,30,1,1,39,32,1139,132,319,0.414,0,10,0,132,309,0.427,0.414,78,103,0.757,27,105,132,149,68,8,80,93
473,9,2000,31,1,1,59,55,1625,157,435,0.361,3,6,0.5,154,429,0.359,0.364,62,84,0.738,23,121,144,202,61,15,105,120
473,10,2001,32,1,1,54,35,1238,100,237,0.422,0,3,0,100,234,0.427,0.422,23,40,0.575,23,76,99,154,62,10,56,132
473,11,2003,34,1,1,32,0,262,16,43,0.372,0,0,-1,16,43,0.372,0.372,9,12,0.75,3,23,26,35,17,2,17,36
475,2,2003,23,1,1,15,0,168,27,59,0.458,0,1,0,27,58,0.466,0.458,11,14,0.786,8,22,30,39,13,0,22,9
475,3,2005,25,1,1,76,0,1066,124,348,0.356,26,72,0.361,98,276,0.355,0.394,59,75,0.787,21,72,93,155,32,1,74,59
480,1,1998,25,1,1,38,10,622,49,141,0.348,22,61,0.361,27,80,0.338,0.426,42,62,0.677,14,42,56,100,25,3,52,55
480,2,2000,27,1,1,37,0,289,29,70,0.414,2,13,0.154,27,57,0.474,0.429,11,18,0.611,3,24,27,49,9,1,31,35
480,3,2001,28,1,1,7,0,142,10,35,0.286,2,11,0.182,8,24,0.333,0.314,4,9,0.444,2,7,9,24,7,1,9,16
480,3,2001,28,1,1,22,0,208,18,54,0.333,2,14,0.143,16,40,0.4,0.352,8,15,0.533,5,16,21,31,8,1,17,21
480,4,2002,29,1,1,59,2,520,45,113,0.398,6,11,0.545,39,102,0.382,0.425,29,41,0.707,23,45,68,114,25,2,47,51
480,5,2003,30,1,1,17,0,196,23,50,0.46,4,6,0.667,19,44,0.432,0.5,10,12,0.833,4,15,19,36,10,3,17,20
480,6,2004,31,1,1,37,0,402,38,101,0.376,11,23,0.478,27,78,0.346,0.431,27,31,0.871,9,28,37,80,25,3,33,44
480,6,2004,31,1,1,40,0,412,40,105,0.381,11,23,0.478,29,82,0.354,0.433,27,31,0.871,9,28,37,82,25,3,33,44
480,7,2005,32,1,1,80,39,1945,166,442,0.376,48,130,0.369,118,312,0.378,0.43,57,74,0.77,23,164,187,410,82,7,125,106
480,8,2006,33,1,1,23,0,215,16,46,0.348,5,12,0.417,11,34,0.324,0.402,7,12,0.583,1,19,20,33,8,1,19,21
480,8,2006,33,1,1,27,0,246,21,54,0.389,5,13,0.385,16,41,0.39,0.435,7,12,0.583,1,21,22,35,8,1,22,22
492,1,1980,25,1,1,67,-1,1690,306,655,0.467,2,5,0.4,304,650,0.468,0.469,105,143,0.734,69,169,238,383,135,4,149,202
492,2,1981,26,1,1,82,-1,2384,471,956,0.493,1,6,0.167,470,950,0.495,0.493,149,203,0.734,88,210,298,384,197,3,236,271
492,3,1982,27,1,1,70,70,2156,396,822,0.482,4,15,0.267,392,807,0.486,0.484,110,168,0.655,77,173,250,328,174,3,180,218
492,5,1984,29,1,1,79,0,1249,138,323,0.427,0,6,0,138,317,0.435,0.427,48,74,0.649,41,96,137,214,84,3,100,187
492,6,1985,30,1,1,75,6,858,74,193,0.383,0,1,0,74,192,0.385,0.383,32,50,0.64,26,61,87,148,63,2,67,142
492,7,1986,31,1,1,32,3,419,49,104,0.471,0,1,0,49,103,0.476,0.471,19,27,0.704,9,42,51,86,40,3,55,80
505,1,2006,26,1,1,39,1,340,22,88,0.25,10,54,0.185,12,34,0.353,0.307,16,17,0.941,4,22,26,48,26,2,25,63
507,1,2014,21,1,1,70,68,2262,341,897,0.38,111,336,0.33,230,561,0.41,0.442,102,113,0.903,37,171,208,396,42,6,131,145
507,2,2015,22,1,1,11,11,350,40,125,0.32,13,54,0.241,27,71,0.38,0.372,16,19,0.842,6,20,26,59,13,5,22,23
508,1,2005,24,1,1,24,0,219,28,60,0.467,3,11,0.273,25,49,0.51,0.492,14,19,0.737,1,11,12,28,13,1,12,25
508,2,2006,25,1,1,57,1,570,51,144,0.354,1,6,0.167,50,138,0.362,0.358,10,23,0.435,4,33,37,76,20,0,36,45
519,1,1980,29,1,1,81,-1,2499,261,589,0.443,19,79,0.241,242,510,0.475,0.459,85,128,0.664,70,163,233,320,132,10,91,111
519,3,1982,31,1,1,82,78,2529,312,685,0.455,73,189,0.386,239,496,0.482,0.509,100,123,0.813,46,177,223,407,164,27,95,176
519,4,1983,32,1,1,41,1,643,72,182,0.396,9,35,0.257,63,147,0.429,0.42,41,46,0.891,19,35,54,115,44,2,25,60
519,5,1984,33,1,1,76,10,1327,150,352,0.426,18,59,0.305,132,293,0.451,0.452,63,80,0.788,29,87,116,303,86,1,87,62
519,6,1985,34,1,1,65,14,939,82,203,0.404,31,87,0.356,51,116,0.44,0.48,23,30,0.767,21,40,61,203,38,1,45,75
528,1,2014,24,1,1,14,0,146,15,48,0.313,5,17,0.294,10,31,0.323,0.365,8,9,0.889,4,19,23,10,8,0,10,11
537,2,2007,25,1,1,77,11,1614,263,505,0.521,25,75,0.333,238,430,0.553,0.546,117,143,0.818,21,113,134,387,63,5,110,136
537,3,2008,26,1,1,82,56,2484,367,707,0.519,79,184,0.429,288,523,0.551,0.575,109,120,0.908,34,202,236,678,87,6,126,134
537,4,2009,27,1,1,68,68,2333,320,644,0.497,82,202,0.406,238,442,0.538,0.561,151,154,0.981,16,178,194,607,74,7,143,114
537,5,2010,28,1,1,68,39,1817,274,568,0.482,68,171,0.398,206,397,0.519,0.542,83,104,0.798,23,119,142,404,47,7,99,135
537,6,2011,29,1,1,68,55,2102,262,596,0.44,57,156,0.365,205,440,0.466,0.487,88,103,0.854,30,172,202,605,81,7,148,143
537,7,2012,30,1,1,53,53,1799,218,477,0.457,59,159,0.371,159,318,0.5,0.519,60,68,0.882,19,141,160,468,47,3,104,94
537,8,2013,31,1,1,28,28,887,125,237,0.527,51,98,0.52,74,139,0.532,0.635,25,28,0.893,6,64,70,185,30,2,51,41
537,8,2013,31,1,1,45,30,1273,187,398,0.47,79,184,0.429,108,214,0.505,0.569,47,52,0.904,14,92,106,333,28,6,75,58
537,8,2013,31,1,1,73,58,2160,312,635,0.491,130,282,0.461,182,353,0.516,0.594,72,80,0.9,20,156,176,518,58,8,126,99
550,1,2014,22,1,1,22,0,252,31,87,0.356,18,55,0.327,13,32,0.406,0.46,21,29,0.724,7,17,24,22,8,4,21,25
550,2,2015,23,1,1,9,6,211,29,66,0.439,17,39,0.436,12,27,0.444,0.568,7,10,0.7,6,12,18,14,7,0,15,16
573,1,2000,24,1,1,79,30,1859,201,509,0.395,3,23,0.13,198,486,0.407,0.398,93,124,0.75,48,151,199,378,93,5,173,167
573,2,2001,25,1,1,72,6,1630,195,480,0.406,6,40,0.15,189,440,0.43,0.413,65,103,0.631,46,134,180,268,73,10,119,154
573,3,2002,26,1,1,46,18,1050,89,260,0.342,1,19,0.053,88,241,0.365,0.344,19,36,0.528,19,98,117,214,50,3,72,85
573,4,2003,27,1,1,49,26,912,83,233,0.356,0,8,0,83,225,0.369,0.356,33,50,0.66,12,71,83,203,45,5,81,70
573,5,2005,29,1,1,66,12,742,72,177,0.407,2,17,0.118,70,160,0.438,0.412,35,51,0.686,12,57,69,161,35,18,62,88
573,6,2006,30,1,1,45,8,589,53,137,0.387,4,15,0.267,49,122,0.402,0.401,40,55,0.727,9,53,62,101,24,9,40,71
573,7,2008,32,1,1,70,67,1960,218,476,0.458,45,129,0.349,173,347,0.499,0.505,64,85,0.753,27,173,200,388,107,28,124,172
573,8,2009,33,1,1,78,5,1787,167,386,0.433,21,88,0.239,146,298,0.49,0.46,57,78,0.731,40,165,205,364,96,13,155,142
573,9,2010,34,1,1,54,7,859,76,181,0.42,17,63,0.27,59,118,0.5,0.467,11,13,0.846,17,72,89,160,39,13,58,72
573,10,2011,35,1,1,14,0,153,10,30,0.333,4,12,0.333,6,18,0.333,0.4,2,2,1,0,12,12,26,9,1,14,19
573,10,2011,35,1,1,19,0,310,35,76,0.461,8,28,0.286,27,48,0.563,0.513,6,6,1,7,32,39,43,18,5,25,30
573,10,2011,35,1,1,33,0,463,45,106,0.425,12,40,0.3,33,66,0.5,0.481,8,8,1,7,44,51,69,27,6,39,49
573,11,2012,36,1,1,24,0,209,17,53,0.321,5,17,0.294,12,36,0.333,0.368,8,10,0.8,5,28,33,34,8,4,17,20
580,1,2014,22,1,1,70,70,2414,427,1054,0.405,55,208,0.264,372,846,0.44,0.431,258,367,0.703,101,336,437,441,130,43,247,213
589,1,1994,24,1,1,66,6,1122,162,388,0.418,26,88,0.295,136,300,0.453,0.451,90,107,0.841,25,109,134,192,59,7,94,136
589,2,1995,25,1,1,82,1,1882,253,593,0.427,63,191,0.33,190,402,0.473,0.48,214,254,0.843,38,173,211,405,94,14,167,209
589,3,1996,26,1,1,61,0,1682,289,658,0.439,73,210,0.348,216,448,0.482,0.495,235,285,0.825,51,137,188,278,53,4,157,166
589,4,1997,27,1,1,16,13,398,70,165,0.424,15,49,0.306,55,116,0.474,0.47,42,50,0.84,14,36,50,57,17,6,41,48
589,4,1997,27,1,1,22,9,539,100,241,0.415,19,62,0.306,81,179,0.453,0.454,106,124,0.855,12,38,50,99,23,6,60,66
589,4,1997,27,1,1,23,22,777,167,377,0.443,47,120,0.392,120,257,0.467,0.505,64,77,0.831,21,61,82,149,37,7,67,86
589,4,1997,27,1,1,61,44,1714,337,783,0.43,81,231,0.351,256,552,0.464,0.482,212,251,0.845,47,135,182,305,77,19,168,200
589,5,1998,28,1,1,75,72,2606,510,1156,0.441,15,80,0.188,495,1076,0.46,0.448,436,507,0.86,73,155,228,603,121,20,269,262
589,6,1999,29,1,1,4,3,100,21,49,0.429,1,7,0.143,20,42,0.476,0.439,29,31,0.935,1,5,6,19,3,0,12,13
589,6,1999,29,1,1,8,3,199,39,93,0.419,2,10,0.2,37,83,0.446,0.43,47,50,0.94,5,10,15,36,9,0,20,22
589,7,2000,30,1,1,81,81,2899,545,1170,0.466,26,90,0.289,519,1080,0.481,0.477,390,445,0.876,69,232,301,729,102,8,267,255
589,8,2001,31,1,1,76,75,2709,537,1132,0.474,30,98,0.306,507,1034,0.49,0.488,277,323,0.858,46,244,290,580,88,8,220,214
589,9,2002,32,1,1,74,73,2605,554,1197,0.463,71,204,0.348,483,993,0.486,0.492,282,328,0.86,54,258,312,493,90,12,177,208
589,10,2003,33,1,1,78,77,2700,546,1162,0.47,59,163,0.362,487,999,0.487,0.495,385,447,0.861,57,285,342,450,88,14,177,216
589,11,2004,34,1,1,81,81,2838,620,1270,0.488,74,186,0.398,546,1084,0.504,0.517,289,331,0.873,44,227,271,592,102,18,220,247
589,12,2005,35,1,1,59,38,1522,319,687,0.464,27,103,0.262,292,584,0.5,0.484,134,155,0.865,25,132,157,301,36,14,109,160
589,13,2006,36,1,1,78,75,2653,493,1112,0.443,70,190,0.368,423,922,0.459,0.475,289,335,0.863,40,247,287,491,74,11,175,225
589,14,2007,37,1,1,58,30,1407,261,625,0.418,32,109,0.294,229,516,0.444,0.443,160,182,0.879,27,140,167,270,28,8,101,126
589,15,2008,38,1,1,17,1,299,50,130,0.385,9,22,0.409,41,108,0.38,0.419,21,25,0.84,5,26,31,35,9,3,19,29
589,15,2008,38,1,1,38,33,975,183,402,0.455,14,54,0.259,169,348,0.486,0.473,106,119,0.891,12,93,105,179,28,3,78,69
589,15,2008,38,1,1,55,34,1274,233,532,0.438,23,76,0.303,210,456,0.461,0.46,127,144,0.882,17,119,136,214,37,6,97,98
595,1,2000,22,1,1,16,0,185,15,45,0.333,2,9,0.222,13,36,0.361,0.356,5,6,0.833,1,10,11,20,7,0,16,22
597,1,2005,24,1,1,36,0,433,42,125,0.336,12,49,0.245,30,76,0.395,0.384,15,24,0.625,4,27,31,51,13,0,24,30
598,1,2009,22,1,1,82,82,2626,278,662,0.42,114,311,0.367,164,351,0.467,0.506,148,193,0.767,37,191,228,403,160,8,165,240
598,2,2010,23,1,1,73,22,1807,182,454,0.401,75,236,0.318,107,218,0.491,0.483,82,110,0.745,25,110,135,246,91,12,123,175
598,3,2011,24,1,1,70,28,1579,155,388,0.399,83,231,0.359,72,157,0.459,0.506,54,62,0.871,12,134,146,177,76,7,91,158
598,4,2012,25,1,1,64,64,1825,223,498,0.448,101,260,0.388,122,238,0.513,0.549,80,101,0.792,16,155,171,222,97,11,142,166
598,5,2013,26,1,1,77,77,2068,227,529,0.429,123,301,0.409,104,228,0.456,0.545,89,112,0.795,19,152,171,273,118,12,119,196
598,6,2014,27,1,1,73,73,2178,254,560,0.454,87,226,0.385,167,334,0.5,0.531,121,163,0.742,41,173,214,357,119,16,162,210
598,7,2015,28,1,1,9,0,256,34,78,0.436,10,29,0.345,24,49,0.49,0.5,30,41,0.732,3,18,21,37,13,1,24,33
603,3,1991,23,1,1,70,68,2100,410,922,0.445,48,148,0.324,362,774,0.468,0.471,234,282,0.83,45,146,191,250,73,16,131,167
603,4,1992,24,1,1,21,11,545,108,240,0.45,8,27,0.296,100,213,0.469,0.467,36,53,0.679,9,45,54,86,14,8,42,47
603,4,1992,24,1,1,22,11,567,113,252,0.448,8,29,0.276,105,223,0.471,0.464,36,53,0.679,10,48,58,89,15,8,45,51
611,1,1996,23,1,1,28,0,250,25,79,0.316,13,47,0.277,12,32,0.375,0.399,22,27,0.815,1,18,19,32,8,1,28,22
611,2,1997,24,1,1,19,0,125,10,30,0.333,3,16,0.188,7,14,0.5,0.383,6,8,0.75,1,4,5,15,7,0,13,11
611,2,1997,24,1,1,23,0,155,14,40,0.35,5,19,0.263,9,21,0.429,0.413,6,8,0.75,1,5,6,17,9,0,18,16
614,1,1995,27,1,1,53,11,1021,106,279,0.38,41,125,0.328,65,154,0.422,0.453,55,73,0.753,14,55,69,219,42,3,76,116
614,2,1996,28,1,1,78,54,2408,324,778,0.416,95,259,0.367,229,519,0.441,0.478,259,304,0.852,51,194,245,548,111,8,230,246
614,3,1997,29,1,1,65,61,2076,211,510,0.414,70,181,0.387,141,329,0.429,0.482,113,149,0.758,22,169,191,398,78,11,180,213
614,4,1998,30,1,1,68,0,1599,149,354,0.421,27,87,0.31,122,267,0.457,0.459,104,126,0.825,29,133,162,268,56,6,103,179
614,5,1999,31,1,1,48,0,1297,114,267,0.427,36,94,0.383,78,173,0.451,0.494,64,78,0.821,18,115,133,193,44,1,85,156
614,6,2000,32,1,1,71,2,1675,146,357,0.409,37,104,0.356,109,253,0.431,0.461,47,59,0.797,17,130,147,285,36,4,105,240
614,7,2001,33,1,1,26,0,550,42,113,0.372,12,42,0.286,30,71,0.423,0.425,21,25,0.84,10,54,64,119,22,8,58,82
614,7,2001,33,1,1,51,5,1309,93,222,0.419,20,64,0.313,73,158,0.462,0.464,39,46,0.848,14,124,138,236,37,7,98,160
614,7,2001,33,1,1,77,5,1859,135,335,0.403,32,106,0.302,103,229,0.45,0.451,60,71,0.845,24,178,202,355,59,15,156,242
614,8,2002,34,1,1,69,4,1576,97,296,0.328,33,120,0.275,64,176,0.364,0.383,58,71,0.817,18,136,154,351,56,5,123,177
614,9,2003,35,1,1,12,0,106,6,20,0.3,1,6,0.167,5,14,0.357,0.325,2,3,0.667,3,2,5,16,8,1,6,17
615,1,1980,23,1,1,79,-1,2623,357,661,0.54,4,9,0.444,353,652,0.541,0.543,180,231,0.779,75,199,274,556,183,32,216,197
615,2,1981,24,1,1,81,-1,2415,310,581,0.534,3,8,0.375,307,573,0.536,0.536,140,178,0.787,67,178,245,560,193,39,174,231
615,3,1982,25,1,1,79,79,2498,352,676,0.521,6,22,0.273,346,654,0.529,0.525,171,220,0.777,51,197,248,667,209,33,184,247
615,4,1983,26,1,1,79,79,2465,404,745,0.542,1,6,0.167,403,739,0.545,0.543,181,240,0.754,53,156,209,543,184,31,179,182
615,5,1984,27,1,1,75,75,2494,386,702,0.55,8,20,0.4,378,682,0.554,0.556,170,232,0.733,44,161,205,478,171,20,182,196
615,6,1985,28,1,1,78,78,2616,422,741,0.57,6,26,0.231,416,715,0.582,0.574,175,199,0.879,54,163,217,497,169,24,155,184
615,7,1986,29,1,1,82,82,3270,490,913,0.537,4,17,0.235,486,896,0.542,0.539,282,335,0.842,55,180,235,753,207,27,238,160
615,8,1987,30,1,1,68,68,2624,415,788,0.527,4,17,0.235,411,771,0.533,0.529,227,292,0.777,47,168,215,538,180,15,173,109
615,9,1988,31,1,1,79,79,2871,428,865,0.495,3,22,0.136,425,843,0.504,0.497,227,275,0.825,59,194,253,635,167,22,160,116
615,10,1989,32,1,1,71,70,2298,336,696,0.483,1,13,0.077,335,683,0.49,0.483,151,195,0.774,39,144,183,554,105,17,116,114
615,11,1990,33,1,1,31,13,753,92,159,0.579,3,7,0.429,89,152,0.586,0.588,57,65,0.877,11,62,73,151,42,5,36,32
615,11,1990,33,1,1,50,49,1766,215,450,0.478,1,9,0.111,214,441,0.485,0.479,114,137,0.832,39,128,167,302,82,5,85,46
615,11,1990,33,1,1,81,62,2519,307,609,0.504,4,16,0.25,303,593,0.511,0.507,171,202,0.847,50,190,240,453,124,10,121,78
615,12,1991,34,1,1,76,64,2147,241,483,0.499,5,20,0.25,236,463,0.51,0.504,105,129,0.814,22,151,173,435,128,10,108,138
615,13,1992,35,1,1,56,0,1086,115,249,0.462,3,6,0.5,112,243,0.461,0.468,26,43,0.605,29,66,95,185,83,0,36,73
615,14,1993,36,1,1,35,0,510,51,93,0.548,0,2,0,51,91,0.56,0.548,24,27,0.889,5,37,42,107,33,2,33,35
634,1,1980,30,1,1,22,-1,254,30,69,0.435,3,8,0.375,27,61,0.443,0.457,12,15,0.8,10,9,19,40,13,2,17,13
634,1,1980,30,1,1,57,-1,1535,184,381,0.483,4,23,0.174,180,358,0.503,0.488,72,98,0.735,43,90,133,248,44,9,92,120
634,1,1980,30,1,1,79,-1,1789,214,450,0.476,7,31,0.226,207,419,0.494,0.483,84,113,0.743,53,99,152,288,57,11,109,133
636,1,2001,23,1,1,78,8,1268,160,400,0.4,5,17,0.294,155,383,0.405,0.406,97,137,0.708,26,106,132,207,49,1,139,153
636,2,2002,24,1,1,32,0,153,30,68,0.441,2,8,0.25,28,60,0.467,0.456,8,9,0.889,1,7,8,25,7,0,27,9
636,3,2006,28,1,1,27,0,230,25,71,0.352,4,16,0.25,21,55,0.382,0.38,19,24,0.792,2,12,14,42,3,2,14,30
644,1,1986,24,1,1,45,1,469,75,184,0.408,3,15,0.2,72,169,0.426,0.416,12,20,0.6,6,40,46,82,20,3,49,65
645,1,2012,23,1,1,65,2,1260,177,450,0.393,21,76,0.276,156,374,0.417,0.417,66,85,0.776,21,70,91,133,44,2,105,124
645,2,2013,24,1,1,80,4,1590,179,425,0.421,35,98,0.357,144,327,0.44,0.462,52,80,0.65,18,112,130,164,57,7,104,155
645,3,2014,25,1,1,82,6,2014,207,500,0.414,60,174,0.345,147,326,0.451,0.474,53,68,0.779,17,143,160,248,77,5,127,156
645,4,2015,26,1,1,9,9,223,27,60,0.45,7,22,0.318,20,38,0.526,0.508,5,6,0.833,1,20,21,36,10,2,12,17
653,1,1991,22,1,1,82,9,1355,162,393,0.412,6,34,0.176,156,359,0.435,0.42,71,95,0.747,56,97,153,232,65,12,98,149
653,2,1992,23,1,1,81,28,1976,295,649,0.455,10,52,0.192,285,597,0.477,0.462,216,262,0.824,69,120,189,366,73,13,167,151
653,3,1993,24,1,1,81,37,2232,318,686,0.464,42,137,0.307,276,549,0.503,0.494,177,220,0.805,58,108,166,373,80,11,108,199
653,4,1994,25,1,1,76,4,1726,233,519,0.449,20,99,0.202,213,420,0.507,0.468,102,131,0.779,50,109,159,263,75,12,107,132
653,5,1995,26,1,1,68,65,2207,261,607,0.43,16,76,0.211,245,531,0.461,0.443,141,174,0.81,46,145,191,416,99,13,156,185
653,6,1996,27,1,1,29,3,733,87,218,0.399,25,82,0.305,62,136,0.456,0.456,29,38,0.763,11,48,59,126,31,5,48,78
653,6,1996,27,1,1,52,52,1882,231,559,0.413,63,172,0.366,168,387,0.434,0.47,139,173,0.803,38,163,201,296,63,12,123,175
653,6,1996,27,1,1,81,55,2615,318,777,0.409,88,254,0.346,230,523,0.44,0.466,168,211,0.796,49,211,260,422,94,17,171,253
653,7,1997,28,1,1,51,13,1183,122,314,0.389,30,102,0.294,92,212,0.434,0.436,37,49,0.755,39,79,118,149,35,7,59,96
653,8,1998,29,1,1,53,44,1471,166,438,0.379,13,57,0.228,153,381,0.402,0.394,78,88,0.886,17,106,123,248,51,13,89,135
653,9,1999,30,1,1,48,32,1272,183,414,0.442,6,25,0.24,177,389,0.455,0.449,83,101,0.822,21,96,117,222,45,11,82,113
653,10,2000,31,1,1,80,54,1924,276,607,0.455,8,39,0.205,268,568,0.472,0.461,85,104,0.817,30,142,172,290,58,11,103,178
653,11,2001,32,1,1,47,0,804,91,239,0.381,2,16,0.125,89,223,0.399,0.385,48,56,0.857,9,39,48,138,27,6,59,87
653,12,2002,33,1,1,47,1,693,56,146,0.384,4,20,0.2,52,126,0.413,0.397,33,37,0.892,12,43,55,107,13,4,31,59
653,13,2003,34,1,1,14,0,175,22,49,0.449,0,7,0,22,42,0.524,0.449,8,8,1,1,10,11,16,6,0,10,17
653,13,2003,34,1,1,21,11,516,34,119,0.286,7,25,0.28,27,94,0.287,0.315,27,34,0.794,10,38,48,56,11,4,18,43
653,13,2003,34,1,1,35,11,691,56,168,0.333,7,32,0.219,49,136,0.36,0.354,35,42,0.833,11,48,59,72,17,4,28,60
653,14,2004,35,1,1,22,1,170,12,34,0.353,0,0,-1,12,34,0.353,0.353,4,6,0.667,2,8,10,15,3,0,9,27
660,3,2009,24,1,1,39,14,815,97,224,0.433,13,28,0.464,84,196,0.429,0.462,24,37,0.649,29,70,99,101,29,10,53,73
660,3,2009,24,1,1,48,14,890,105,247,0.425,13,31,0.419,92,216,0.426,0.451,28,46,0.609,31,76,107,111,31,10,58,80
666,1,2010,22,1,1,76,37,2109,376,789,0.477,46,115,0.4,330,674,0.49,0.506,148,174,0.851,41,151,192,432,78,4,202,92
666,2,2011,23,1,1,79,79,2360,398,870,0.457,41,124,0.331,357,746,0.479,0.481,202,232,0.871,40,185,225,403,87,14,194,109
666,3,2012,24,1,1,60,56,1878,230,523,0.44,34,94,0.362,196,429,0.457,0.472,127,153,0.83,30,157,187,287,49,14,114,101
666,4,2013,25,1,1,81,47,2372,341,724,0.471,48,136,0.353,293,588,0.498,0.504,242,275,0.88,31,188,219,415,100,8,173,139
666,5,2014,26,1,1,80,35,2069,324,694,0.467,71,189,0.376,253,505,0.501,0.518,192,224,0.857,47,141,188,297,93,15,132,150
666,6,2015,27,1,1,9,9,319,47,108,0.435,5,25,0.2,42,83,0.506,0.458,43,54,0.796,5,27,32,54,17,4,18,17
671,1,2008,20,1,1,53,46,1381,189,442,0.428,30,91,0.33,159,351,0.453,0.462,90,123,0.732,21,118,139,222,44,2,89,85
671,2,2009,21,1,1,82,61,2508,323,730,0.442,88,217,0.406,235,513,0.458,0.503,161,197,0.817,25,251,276,354,90,8,143,146
671,3,2010,22,1,1,80,80,2569,369,830,0.445,82,212,0.387,287,618,0.464,0.494,139,187,0.743,30,161,191,425,109,12,170,178
671,4,2011,23,1,1,81,81,2872,423,953,0.444,80,217,0.369,343,736,0.466,0.486,181,247,0.733,32,215,247,528,144,18,176,182
671,5,2012,24,1,1,62,61,2174,296,684,0.433,60,159,0.377,236,525,0.45,0.477,136,158,0.861,22,134,156,404,136,11,125,133
671,6,2013,25,1,1,80,80,2757,414,940,0.44,106,293,0.362,308,647,0.476,0.497,234,282,0.83,43,182,225,487,174,24,189,171
671,7,2014,26,1,1,73,73,2446,463,1030,0.45,105,291,0.361,358,739,0.484,0.5,225,276,0.815,41,172,213,441,110,13,150,141
671,8,2015,27,1,1,10,10,331,56,136,0.412,15,34,0.441,41,102,0.402,0.467,40,48,0.833,2,16,18,60,14,2,22,23
683,1,2004,22,1,1,17,0,139,7,27,0.259,0,1,0,7,26,0.269,0.259,0,0,-1,3,3,6,24,10,0,10,14
686,1,1993,23,1,1,65,0,645,62,158,0.392,7,30,0.233,55,128,0.43,0.415,25,35,0.714,13,37,50,150,18,2,69,66
686,2,1994,24,1,1,23,2,136,18,41,0.439,1,7,0.143,17,34,0.5,0.451,11,15,0.733,2,7,9,28,3,0,20,12
693,1,1992,23,1,1,51,1,741,77,193,0.399,10,37,0.27,67,156,0.429,0.425,91,104,0.875,18,60,78,141,45,2,74,94
693,2,1993,24,1,1,9,0,102,13,23,0.565,0,3,0,13,20,0.65,0.565,16,21,0.762,1,6,7,16,6,0,8,17
693,2,1993,24,1,1,10,0,105,14,24,0.583,0,3,0,14,21,0.667,0.583,16,21,0.762,1,6,7,16,6,0,8,18
693,3,1994,25,1,1,51,0,467,40,94,0.426,11,38,0.289,29,56,0.518,0.484,26,38,0.684,8,36,44,86,22,2,38,47
704,1,2001,20,1,1,61,8,1050,107,304,0.352,41,117,0.35,66,187,0.353,0.419,27,34,0.794,9,80,89,141,43,14,85,68
704,2,2002,21,1,1,23,6,481,89,187,0.476,26,58,0.448,63,129,0.488,0.545,10,13,0.769,5,29,34,55,18,5,32,18
704,3,2003,22,1,1,80,31,1992,334,808,0.413,86,242,0.355,248,566,0.438,0.467,104,129,0.806,21,164,185,334,77,25,134,126
704,9,2009,28,1,1,54,54,2087,346,853,0.406,107,317,0.338,239,536,0.446,0.468,265,298,0.889,21,155,176,240,48,13,122,79
704,9,2009,28,1,1,65,65,2479,419,1022,0.41,142,394,0.36,277,628,0.441,0.479,300,344,0.872,23,170,193,288,57,13,148,92
704,12,2012,31,1,1,60,6,1613,283,737,0.384,80,260,0.308,203,477,0.426,0.438,191,206,0.927,16,102,118,191,55,14,111,74
714,1,2002,22,1,1,15,0,129,23,56,0.411,15,35,0.429,8,21,0.381,0.545,8,8,1,2,8,10,24,4,0,9,8
714,1,2002,22,1,1,21,0,156,26,68,0.382,15,39,0.385,11,29,0.379,0.493,12,13,0.923,2,9,11,26,5,0,10,10
716,1,1980,31,1,1,81,-1,1794,249,578,0.431,1,17,0.059,248,561,0.442,0.432,172,212,0.811,27,89,116,246,74,4,130,133
716,2,1981,32,1,1,66,-1,1708,220,485,0.454,1,21,0.048,219,464,0.472,0.455,185,214,0.864,26,74,100,283,61,3,134,87
716,3,1982,33,1,1,27,0,552,84,210,0.4,2,8,0.25,82,202,0.406,0.405,65,73,0.89,6,32,38,75,23,2,30,40
716,3,1982,33,1,1,28,20,840,138,288,0.479,8,21,0.381,130,267,0.487,0.493,76,86,0.884,7,37,44,112,21,4,52,56
716,3,1982,33,1,1,55,20,1392,222,498,0.446,10,29,0.345,212,469,0.452,0.456,141,159,0.887,13,69,82,187,44,6,82,96
716,4,1983,34,1,1,66,0,922,169,375,0.451,6,31,0.194,163,344,0.474,0.459,68,76,0.895,14,65,79,127,27,0,44,44
716,5,1984,35,1,1,6,0,107,11,30,0.367,1,6,0.167,10,24,0.417,0.383,7,11,0.636,2,7,9,17,5,0,4,7
716,5,1984,35,1,1,9,0,108,9,22,0.409,0,0,-1,9,22,0.409,0.409,5,5,1,3,8,11,21,3,0,6,4
716,5,1984,35,1,1,15,0,215,20,52,0.385,1,6,0.167,19,46,0.413,0.394,12,16,0.75,5,15,20,38,8,0,10,11
716,6,1985,36,1,1,4,2,115,7,17,0.412,0,2,0,7,15,0.467,0.412,4,6,0.667,2,12,14,22,3,0,11,5
719,2,2009,21,1,1,56,10,1130,124,270,0.459,2,14,0.143,122,256,0.477,0.463,48,81,0.593,53,107,160,145,39,6,79,96
719,2,2009,21,1,1,63,10,1174,131,285,0.46,2,15,0.133,129,270,0.478,0.463,53,92,0.576,57,109,166,150,40,6,82,101
727,1,1993,23,1,1,40,0,243,37,72,0.514,2,14,0.143,35,58,0.603,0.528,26,38,0.684,4,13,17,55,11,0,30,29
727,2,1994,24,1,1,45,0,313,45,99,0.455,11,24,0.458,34,75,0.453,0.51,31,36,0.861,11,20,31,77,15,1,27,36
727,3,1995,25,1,1,80,0,1019,93,231,0.403,11,36,0.306,82,195,0.421,0.426,98,121,0.81,27,70,97,205,39,6,70,105
727,4,1996,26,1,1,58,4,617,51,114,0.447,8,27,0.296,43,87,0.494,0.482,62,72,0.861,20,34,54,102,22,6,51,60
727,5,1997,27,1,1,48,0,659,79,154,0.513,20,49,0.408,59,105,0.562,0.578,54,64,0.844,15,32,47,102,18,0,42,79
727,6,1998,28,1,1,26,2,379,29,90,0.322,6,20,0.3,23,70,0.329,0.356,32,34,0.941,4,28,32,63,10,1,42,28
727,7,1999,29,1,1,24,0,363,47,116,0.405,13,35,0.371,34,81,0.42,0.461,40,47,0.851,8,22,30,58,9,0,33,30
727,7,1999,29,1,1,27,0,382,51,124,0.411,14,36,0.389,37,88,0.42,0.468,43,50,0.86,8,23,31,63,11,0,33,31
727,8,2000,30,1,1,69,0,937,106,251,0.422,33,80,0.413,73,171,0.427,0.488,80,93,0.86,17,58,75,128,27,5,54,104
727,9,2001,31,1,1,31,0,264,22,65,0.338,4,7,0.571,18,58,0.31,0.369,17,19,0.895,13,15,28,34,6,0,19,32
727,10,2002,32,1,1,41,0,802,98,208,0.471,31,69,0.449,67,139,0.482,0.546,57,66,0.864,16,59,75,141,19,1,51,77
727,11,2003,33,1,1,12,0,180,14,41,0.341,4,13,0.308,10,28,0.357,0.39,9,15,0.6,1,14,15,29,3,0,9,16
733,1,2000,23,1,1,75,11,1793,265,655,0.405,49,151,0.325,216,504,0.429,0.442,127,169,0.751,57,127,184,247,91,13,132,174
733,2,2001,24,1,1,66,11,1495,178,517,0.344,48,143,0.336,130,374,0.348,0.391,79,116,0.681,47,90,137,227,67,14,91,160
733,3,2002,25,1,1,58,1,501,78,187,0.417,12,46,0.261,66,141,0.468,0.449,24,32,0.75,14,38,52,60,18,5,36,53
746,1,2010,21,1,1,80,77,2896,528,1143,0.462,166,380,0.437,362,763,0.474,0.535,177,200,0.885,48,308,356,472,152,19,243,252
746,2,2011,22,1,1,74,74,2489,505,1053,0.48,151,342,0.442,354,711,0.498,0.551,212,227,0.934,52,234,286,432,109,20,226,233
746,3,2012,23,1,1,26,23,732,145,296,0.49,55,121,0.455,90,175,0.514,0.583,38,47,0.809,15,73,88,138,39,8,65,62
746,4,2013,24,1,1,78,78,2983,626,1388,0.451,272,600,0.453,354,788,0.449,0.549,262,291,0.9,59,255,314,539,126,12,240,198
746,5,2014,25,1,1,78,78,2846,652,1383,0.471,261,615,0.424,391,768,0.509,0.566,308,348,0.885,46,288,334,666,128,14,294,194
746,6,2015,26,1,1,9,9,305,76,156,0.487,26,69,0.377,50,87,0.575,0.571,40,42,0.952,6,46,52,62,22,0,36,30
751,1,1990,23,1,1,43,6,559,88,217,0.406,3,21,0.143,85,196,0.434,0.412,17,25,0.68,7,44,51,80,13,2,33,53
774,1,1980,22,1,1,72,-1,1116,115,287,0.401,0,2,0,115,285,0.404,0.401,103,150,0.687,45,62,107,192,48,5,118,82
788,1,2013,25,1,1,28,0,200,15,45,0.333,6,23,0.261,9,22,0.409,0.4,21,27,0.778,2,16,18,21,7,2,18,23
809,1,1984,22,1,1,82,1,1712,200,451,0.443,3,26,0.115,197,425,0.464,0.447,66,98,0.673,53,119,172,239,95,21,111,143
809,2,1985,23,1,1,82,1,2218,329,633,0.52,21,61,0.344,308,572,0.538,0.536,111,154,0.721,47,152,199,360,144,37,123,194
809,3,1986,24,1,1,79,39,2150,390,730,0.534,12,51,0.235,378,679,0.557,0.542,171,229,0.747,75,151,226,416,153,23,144,166
809,4,1987,25,1,1,77,76,2556,497,993,0.501,76,212,0.358,421,781,0.539,0.539,160,234,0.684,51,148,199,609,167,25,138,195
809,5,1988,26,1,1,82,82,3032,536,1167,0.459,60,192,0.313,476,975,0.488,0.485,261,344,0.759,71,175,246,634,168,35,190,164
809,6,1989,27,1,1,81,81,2968,538,1127,0.477,99,278,0.356,439,849,0.517,0.521,229,284,0.806,46,182,228,570,172,41,205,219
809,7,1990,28,1,1,82,82,3007,567,1161,0.488,89,240,0.371,478,921,0.519,0.527,250,315,0.794,54,190,244,609,187,26,207,224
809,8,1991,29,1,1,77,77,2879,572,1226,0.467,89,246,0.362,483,980,0.493,0.503,286,391,0.731,59,174,233,548,147,14,177,222
809,9,1992,30,1,1,65,64,2252,448,1011,0.443,58,186,0.312,390,825,0.473,0.472,198,261,0.759,49,121,170,373,101,17,154,150
809,11,1994,32,1,1,28,28,893,130,342,0.38,37,105,0.352,93,237,0.392,0.434,28,50,0.56,10,45,55,98,45,4,54,46
809,11,1994,32,1,1,54,27,1311,173,402,0.43,36,98,0.367,137,304,0.451,0.475,84,113,0.743,10,76,86,236,80,4,81,117
809,11,1994,32,1,1,82,55,2204,303,744,0.407,73,203,0.36,230,541,0.425,0.456,112,163,0.687,20,121,141,334,125,8,135,163
809,12,1995,33,1,1,80,80,2716,337,756,0.446,106,292,0.363,231,464,0.498,0.516,139,192,0.724,31,163,194,458,79,10,151,219
809,13,1996,34,1,1,82,82,2893,436,939,0.464,121,325,0.372,315,614,0.513,0.529,156,206,0.757,32,170,202,352,131,5,178,201
809,14,1997,35,1,1,75,29,2210,299,674,0.444,60,176,0.341,239,498,0.48,0.488,95,128,0.742,30,107,137,321,92,12,132,144
809,16,1999,37,1,1,45,29,1120,120,291,0.412,43,117,0.368,77,174,0.443,0.486,26,32,0.813,13,54,67,187,44,4,52,66
814,10,1996,32,1,1,80,80,1886,234,501,0.467,28,104,0.269,206,397,0.519,0.495,98,139,0.705,74,139,213,208,105,32,73,137
814,12,1998,34,1,1,82,82,2284,293,665,0.441,16,84,0.19,277,581,0.477,0.453,162,216,0.75,107,183,290,241,108,48,91,181
814,14,2000,36,1,1,80,78,2042,212,531,0.399,33,106,0.311,179,425,0.421,0.43,100,147,0.68,96,241,337,270,85,39,132,164
814,15,2001,37,1,1,47,46,1139,127,271,0.469,19,72,0.264,108,199,0.543,0.504,34,48,0.708,46,120,166,113,39,25,62,70
823,1,2005,21,1,1,76,19,1173,157,366,0.429,44,131,0.336,113,235,0.481,0.489,78,103,0.757,28,74,102,169,77,19,82,139
823,2,2006,22,1,1,56,4,1275,190,405,0.469,5,21,0.238,185,384,0.482,0.475,169,236,0.716,26,99,125,177,53,16,84,121
823,3,2007,23,1,1,80,61,2081,292,593,0.492,14,50,0.28,278,543,0.512,0.504,215,261,0.824,45,151,196,296,96,21,146,242
823,4,2008,24,1,1,25,22,838,134,306,0.438,31,97,0.32,103,209,0.493,0.489,87,105,0.829,11,71,82,163,34,8,68,63
823,4,2008,24,1,1,39,39,1184,187,387,0.483,25,70,0.357,162,317,0.511,0.516,161,196,0.821,17,74,91,206,56,2,93,127
823,4,2008,24,1,1,64,61,2022,321,693,0.463,56,167,0.335,265,526,0.504,0.504,248,301,0.824,28,145,173,369,90,10,161,190
823,5,2009,25,1,1,69,69,2494,455,1039,0.438,64,220,0.291,391,819,0.477,0.469,496,605,0.82,30,201,231,476,114,13,212,164
823,6,2010,26,1,1,64,61,2221,356,884,0.403,60,217,0.276,296,667,0.444,0.437,308,386,0.798,24,179,203,423,79,18,181,178
823,7,2011,27,1,1,17,16,530,83,201,0.413,25,70,0.357,58,131,0.443,0.475,77,95,0.811,6,34,40,92,13,2,49,33
823,7,2011,27,1,1,54,54,1724,260,612,0.425,33,110,0.3,227,502,0.452,0.452,258,307,0.84,11,118,129,411,57,5,158,130
823,7,2011,27,1,1,71,70,2254,343,813,0.422,58,180,0.322,285,633,0.45,0.458,335,402,0.833,17,152,169,503,70,7,207,163
823,8,2012,28,1,1,63,63,1741,241,542,0.445,77,213,0.362,164,329,0.498,0.516,156,209,0.746,12,100,112,316,64,13,122,136
823,10,2014,30,1,1,40,0,818,96,254,0.378,31,101,0.307,65,153,0.425,0.439,92,115,0.8,8,77,85,178,28,2,59,72
823,11,2015,31,1,1,10,0,244,30,67,0.448,12,33,0.364,18,34,0.529,0.537,23,29,0.793,1,17,18,43,14,2,7,16
825,11,2004,33,1,1,69,15,1504,187,463,0.404,38,101,0.376,149,362,0.412,0.445,66,78,0.846,39,101,140,135,41,2,53,74
849,5,1993,26,1,1,81,81,2977,551,1172,0.47,122,307,0.397,429,865,0.496,0.522,419,487,0.86,91,255,346,317,137,30,180,189
859,4,2009,26,1,1,22,4,322,39,101,0.386,14,38,0.368,25,63,0.397,0.455,14,16,0.875,3,24,27,35,6,1,16,15
859,4,2009,26,1,1,32,4,498,55,144,0.382,20,54,0.37,35,90,0.389,0.451,19,24,0.792,6,46,52,58,17,2,25,37
859,6,2011,28,1,1,36,14,586,68,164,0.415,25,64,0.391,43,100,0.43,0.491,39,50,0.78,16,44,60,70,10,9,32,43
869,1,1980,24,1,1,76,2,1061,191,382,0.5,2,6,0.333,189,376,0.503,0.503,89,129,0.69,37,46,83,147,45,15,109,96
869,2,1981,25,1,1,82,10,1608,261,579,0.451,1,16,0.063,260,563,0.462,0.452,113,157,0.72,43,89,132,213,79,12,160,177
869,3,1982,26,1,1,82,31,1844,353,705,0.501,2,12,0.167,351,693,0.506,0.502,125,172,0.727,47,105,152,252,82,11,150,199
869,4,1983,27,1,1,82,9,1551,286,618,0.463,3,16,0.188,283,602,0.47,0.465,96,133,0.722,57,67,124,195,95,3,128,190
869,5,1984,28,1,1,78,78,2088,376,718,0.524,20,57,0.351,356,661,0.539,0.538,136,177,0.768,68,79,147,300,117,14,161,209
869,6,1985,29,1,1,79,78,2648,427,891,0.479,9,38,0.237,418,853,0.49,0.484,199,255,0.78,71,119,190,559,140,9,231,196
869,7,1986,30,1,1,82,82,2568,434,900,0.482,18,52,0.346,416,848,0.491,0.492,185,223,0.83,89,98,187,487,138,11,184,230
869,8,1987,31,1,1,6,6,155,25,50,0.5,0,3,0,25,47,0.532,0.5,17,18,0.944,6,3,9,32,6,0,15,17
869,8,1987,31,1,1,68,53,1890,273,624,0.438,19,74,0.257,254,550,0.462,0.453,173,212,0.816,44,122,166,439,95,11,157,191
869,8,1987,31,1,1,74,59,2045,298,674,0.442,19,77,0.247,279,597,0.467,0.456,190,230,0.826,50,125,175,471,101,11,172,208
869,9,1988,32,1,1,69,3,1436,189,439,0.431,67,159,0.421,122,280,0.436,0.507,136,168,0.81,26,71,97,218,67,5,125,173
869,9,1988,32,1,1,75,5,1505,194,453,0.428,69,163,0.423,125,290,0.431,0.504,138,170,0.812,27,80,107,231,69,5,133,187
869,10,1989,33,1,1,65,0,986,144,348,0.414,33,107,0.308,111,241,0.461,0.461,104,127,0.819,17,51,68,140,42,3,73,121
869,11,1990,34,1,1,11,0,129,11,26,0.423,3,7,0.429,8,19,0.421,0.481,2,2,1,3,9,12,13,8,0,8,14
869,11,1990,34,1,1,46,0,335,42,83,0.506,14,31,0.452,28,52,0.538,0.59,10,13,0.769,8,23,31,61,8,2,16,36
869,11,1990,34,1,1,57,0,464,53,109,0.486,17,38,0.447,36,71,0.507,0.564,12,15,0.8,11,32,43,74,16,2,24,50
869,12,1991,35,1,1,23,10,392,50,117,0.427,7,21,0.333,43,96,0.448,0.457,16,21,0.762,8,29,37,62,12,2,28,43
875,1,1980,28,1,1,66,-1,1551,154,323,0.477,0,2,0,154,321,0.48,0.477,56,77,0.727,34,77,111,274,55,4,102,107
882,1,2000,24,1,1,45,1,597,45,124,0.363,24,67,0.358,21,57,0.368,0.46,27,40,0.675,12,40,52,111,15,2,42,74
882,2,2001,25,1,1,25,7,408,29,96,0.302,16,55,0.291,13,41,0.317,0.385,9,12,0.75,4,17,21,56,14,0,20,43
898,1,2012,22,1,1,38,0,423,52,160,0.325,4,20,0.2,48,140,0.343,0.338,42,60,0.7,7,28,35,36,5,6,39,40
904,1,2009,22,1,1,77,7,1270,150,372,0.403,24,73,0.329,126,299,0.421,0.435,114,146,0.781,30,128,158,136,45,21,74,150
904,2,2010,23,1,1,78,43,2276,353,738,0.478,75,188,0.399,278,550,0.505,0.529,183,237,0.772,42,163,205,226,69,26,101,222
904,3,2011,24,1,1,76,5,2148,287,633,0.453,77,204,0.377,210,429,0.49,0.514,233,270,0.863,24,175,199,193,66,21,99,153
904,4,2012,25,1,1,50,9,1274,168,380,0.442,54,147,0.367,114,233,0.489,0.513,91,117,0.778,31,120,151,145,42,17,52,98
904,5,2013,26,1,1,76,76,2620,386,871,0.443,130,353,0.368,256,518,0.494,0.518,174,213,0.817,47,237,284,355,81,26,116,134
904,6,2014,27,1,1,76,76,2434,272,616,0.442,95,260,0.365,177,356,0.497,0.519,142,176,0.807,53,230,283,265,75,23,92,158
905,1,1980,26,1,1,79,-1,2092,177,431,0.411,1,4,0.25,176,427,0.412,0.412,124,146,0.849,31,107,138,424,107,8,171,261
905,2,1981,27,1,1,24,-1,624,39,116,0.336,0,1,0,39,115,0.339,0.336,42,50,0.84,10,41,51,118,26,3,58,60
905,2,1981,27,1,1,51,-1,1114,78,219,0.356,0,6,0,78,213,0.366,0.356,99,122,0.811,31,77,108,174,40,8,69,147
905,2,1981,27,1,1,75,-1,1738,117,335,0.349,0,7,0,117,328,0.357,0.349,141,172,0.82,41,118,159,292,66,11,127,207
905,3,1982,28,1,1,21,4,243,19,37,0.514,0,0,-1,19,37,0.514,0.514,17,23,0.739,6,19,25,25,5,2,14,37
905,3,1982,28,1,1,19,14,480,34,89,0.382,0,2,0,34,87,0.391,0.382,22,32,0.688,6,21,27,81,16,3,52,51
905,3,1982,28,1,1,40,18,723,53,126,0.421,0,2,0,53,124,0.427,0.421,39,55,0.709,12,40,52,106,21,5,66,88
905,4,1983,29,1,1,14,3,169,14,26,0.538,0,0,-1,14,26,0.538,0.538,18,22,0.818,5,15,20,27,9,0,13,20
905,5,1984,30,1,1,15,2,181,14,46,0.304,0,0,-1,14,46,0.304,0.304,17,21,0.81,2,8,10,35,7,0,14,30
920,1,2004,23,1,1,76,66,2706,318,823,0.386,144,369,0.39,174,454,0.383,0.474,135,168,0.804,42,217,259,517,101,21,204,276
920,2,2005,24,1,1,77,77,2800,445,1122,0.397,145,408,0.355,300,714,0.42,0.461,171,216,0.792,32,272,304,494,122,21,176,244
920,3,2006,25,1,1,81,81,2955,451,1078,0.418,126,341,0.37,325,737,0.441,0.477,256,314,0.815,29,259,288,514,94,21,188,251
920,4,2007,26,1,1,80,80,2839,475,1061,0.448,140,337,0.415,335,724,0.463,0.514,237,284,0.835,32,242,274,500,100,23,191,274
920,5,2008,27,1,1,75,72,2380,330,797,0.414,84,240,0.35,246,557,0.442,0.467,118,142,0.831,28,216,244,452,87,19,157,224
920,8,2011,30,1,1,24,22,686,80,185,0.432,32,76,0.421,48,109,0.44,0.519,14,21,0.667,7,46,53,78,19,7,37,66
920,10,2013,32,1,1,60,60,1764,159,422,0.377,71,182,0.39,88,240,0.367,0.461,70,98,0.714,16,142,158,314,63,25,99,192
920,11,2014,33,1,1,73,61,2116,243,619,0.393,85,242,0.351,158,377,0.419,0.461,95,125,0.76,31,161,192,286,80,26,120,203
925,5,1987,26,1,1,78,43,2147,315,682,0.462,85,228,0.373,230,454,0.507,0.524,131,147,0.891,48,92,140,240,76,7,124,189
931,1,2010,19,1,1,73,51,1767,230,520,0.442,62,159,0.39,168,361,0.465,0.502,65,86,0.756,56,135,191,280,79,18,156,153
931,2,2011,20,1,1,82,82,2901,446,999,0.446,81,222,0.365,365,777,0.47,0.487,172,209,0.823,68,264,332,531,120,29,218,203
931,3,2012,21,1,1,65,65,2196,360,834,0.432,65,171,0.38,295,663,0.445,0.471,94,120,0.783,57,155,212,290,103,18,135,137
931,4,2013,22,1,1,78,78,2926,555,1288,0.431,91,247,0.368,464,1041,0.446,0.466,182,242,0.752,89,240,329,625,123,32,292,170
931,5,2014,23,1,1,34,34,1143,203,454,0.447,30,77,0.39,173,377,0.459,0.48,51,63,0.81,28,114,142,268,56,12,105,92
931,6,2015,24,1,1,8,8,270,51,106,0.481,10,29,0.345,41,77,0.532,0.528,18,18,1,2,15,17,55,11,5,12,23
935,1,1980,26,1,1,20,-1,413,82,213,0.385,1,10,0.1,81,203,0.399,0.387,34,53,0.642,5,15,20,50,30,1,60,35
935,2,1981,27,1,1,82,-1,2154,327,696,0.47,2,15,0.133,325,681,0.477,0.471,125,171,0.731,47,144,191,352,104,18,207,205
935,3,1982,28,1,1,81,81,2257,380,797,0.477,2,16,0.125,378,781,0.484,0.478,132,188,0.702,35,152,187,316,103,20,146,198
935,4,1983,29,1,1,56,54,1844,313,717,0.437,3,21,0.143,310,696,0.445,0.439,129,179,0.721,30,98,128,373,111,14,198,155
935,5,1984,30,1,1,32,0,216,24,63,0.381,0,2,0,24,61,0.393,0.381,11,13,0.846,4,18,22,62,13,1,24,26
935,6,1985,31,1,1,80,60,1950,249,540,0.461,3,13,0.231,246,527,0.467,0.464,108,136,0.794,33,140,173,417,78,10,170,187
941,2,1986,24,1,1,24,0,447,73,155,0.471,1,10,0.1,72,145,0.497,0.474,24,38,0.632,10,20,30,48,23,0,23,40
941,2,1986,24,1,1,28,0,512,77,175,0.44,1,12,0.083,76,163,0.466,0.443,28,44,0.636,11,22,33,55,25,0,27,47
941,3,1987,25,1,1,58,1,479,70,171,0.409,7,23,0.304,63,148,0.426,0.43,44,55,0.8,9,29,38,73,16,2,41,51
941,4,1988,26,1,1,82,2,1279,163,353,0.462,3,15,0.2,160,338,0.473,0.466,107,129,0.829,50,99,149,211,41,10,86,154
941,5,1989,27,1,1,67,60,1696,215,504,0.427,3,14,0.214,212,490,0.433,0.43,120,143,0.839,30,75,105,424,66,12,119,165
941,6,1990,28,1,1,16,0,109,14,26,0.538,0,0,-1,14,26,0.538,0.538,1,2,0.5,1,1,2,16,1,0,13,19
970,1,2010,25,1,1,25,0,131,21,53,0.396,5,16,0.313,16,37,0.432,0.443,11,13,0.846,7,11,18,13,8,3,14,12
970,2,2012,27,1,1,13,0,314,59,151,0.391,15,61,0.246,44,90,0.489,0.44,32,38,0.842,7,39,46,35,14,3,30,26
970,2,2012,27,1,1,16,0,334,62,162,0.383,16,64,0.25,46,98,0.469,0.432,34,41,0.829,7,39,46,36,14,3,32,26
975,1,1989,28,1,1,26,1,224,28,64,0.438,7,22,0.318,21,42,0.5,0.492,7,12,0.583,6,13,19,35,17,2,11,30
975,2,1990,29,1,1,60,7,892,83,202,0.411,20,49,0.408,63,153,0.412,0.46,23,34,0.676,15,55,70,116,48,1,39,87
977,1,2001,22,1,1,50,0,550,104,247,0.421,19,55,0.345,85,192,0.443,0.46,24,35,0.686,5,37,42,52,13,0,35,58
977,2,2002,23,1,1,64,3,1230,209,524,0.399,54,157,0.344,155,367,0.422,0.45,42,49,0.857,17,93,110,123,43,5,80,98
977,5,2005,26,1,1,50,2,550,98,214,0.458,28,62,0.452,70,152,0.461,0.523,13,14,0.929,14,47,61,67,18,3,22,39
977,5,2005,26,1,1,68,7,891,165,366,0.451,44,97,0.454,121,269,0.45,0.511,23,27,0.852,16,67,83,96,44,6,35,65
977,6,2006,27,1,1,81,0,1421,320,759,0.422,123,316,0.389,197,443,0.445,0.503,33,41,0.805,15,117,132,148,42,12,76,96
977,8,2008,29,1,1,78,2,1480,217,531,0.409,117,298,0.393,100,233,0.429,0.519,33,36,0.917,19,148,167,152,59,10,76,114
977,9,2009,30,1,1,81,0,1479,249,560,0.445,151,340,0.444,98,220,0.445,0.579,42,53,0.792,11,146,157,92,61,7,55,113
977,10,2010,31,1,1,50,0,846,129,322,0.401,64,167,0.383,65,155,0.419,0.5,36,40,0.9,7,62,69,48,28,7,27,61
977,10,2010,31,1,1,68,0,1217,173,455,0.38,79,227,0.348,94,228,0.412,0.467,48,52,0.923,13,96,109,85,40,7,47,81
983,1,1999,22,1,1,25,6,524,60,150,0.4,15,47,0.319,45,103,0.437,0.45,34,38,0.895,15,40,55,92,11,2,38,28
983,2,2000,23,1,1,62,38,1592,204,541,0.377,60,193,0.311,144,348,0.414,0.433,77,95,0.811,28,120,148,242,43,0,108,65
983,3,2001,24,1,1,75,7,1008,125,372,0.336,22,109,0.202,103,263,0.392,0.366,85,104,0.817,38,67,105,162,37,3,92,82
983,4,2002,25,1,1,81,4,1854,354,815,0.434,66,187,0.353,288,628,0.459,0.475,176,201,0.876,30,115,145,255,57,6,163,119
983,5,2003,26,1,1,79,74,2600,409,956,0.428,97,266,0.365,312,690,0.452,0.479,208,231,0.9,42,141,183,452,60,7,182,160
983,6,2004,27,1,1,29,1,503,80,207,0.386,31,77,0.403,49,130,0.377,0.461,27,33,0.818,4,31,35,70,7,0,34,32
983,7,2005,28,1,1,79,32,1729,266,664,0.401,89,258,0.345,177,406,0.436,0.468,70,90,0.778,19,86,105,283,27,6,113,121
983,8,2006,29,1,1,36,0,800,127,333,0.381,40,101,0.396,87,232,0.375,0.441,48,52,0.923,8,36,44,106,12,4,40,55
983,9,2007,30,1,1,34,6,554,74,195,0.379,28,80,0.35,46,115,0.4,0.451,26,32,0.813,8,40,48,73,14,2,40,23
991,2,1986,23,1,1,82,82,2733,352,735,0.479,4,29,0.138,348,706,0.493,0.482,197,257,0.767,56,204,260,526,132,9,190,222
991,3,1987,24,1,1,82,82,2579,359,753,0.477,5,27,0.185,354,726,0.488,0.48,200,260,0.769,62,198,260,632,112,9,195,239
991,4,1988,25,1,1,18,0,252,20,54,0.37,0,2,0,20,52,0.385,0.37,9,14,0.643,5,18,23,41,20,1,19,23
991,4,1988,25,1,1,50,33,1557,264,484,0.545,3,16,0.188,261,468,0.558,0.549,103,139,0.741,44,107,151,354,61,4,108,154
991,4,1988,25,1,1,68,33,1809,284,538,0.528,3,18,0.167,281,520,0.54,0.531,112,153,0.732,49,125,174,395,81,5,127,177
991,5,1989,26,1,1,73,50,2220,345,714,0.483,25,94,0.266,320,620,0.516,0.501,129,158,0.816,70,119,189,405,142,5,160,187
991,6,1990,27,1,1,81,81,2818,496,1005,0.494,21,70,0.3,475,935,0.508,0.504,224,285,0.786,80,189,269,472,156,11,151,253
991,7,1991,28,1,1,80,80,2726,482,960,0.502,60,161,0.373,422,799,0.528,0.533,191,239,0.799,57,163,220,538,129,7,151,237
991,8,1992,29,1,1,71,71,2261,377,803,0.469,42,144,0.292,335,659,0.508,0.496,195,249,0.783,44,140,184,466,119,13,148,210
993,1,1994,23,1,1,82,26,2172,335,893,0.375,69,207,0.333,266,686,0.388,0.414,104,142,0.732,47,142,189,390,121,10,184,174
993,2,1995,24,1,1,42,26,944,119,318,0.374,36,108,0.333,83,210,0.395,0.431,40,55,0.727,24,51,75,159,51,7,79,94
993,3,1996,25,1,1,80,48,2138,239,628,0.381,117,289,0.405,122,339,0.36,0.474,84,120,0.7,44,150,194,188,84,18,80,185
993,4,1997,26,1,1,82,76,3023,421,1042,0.404,166,468,0.355,255,574,0.444,0.484,158,203,0.778,59,174,233,154,129,24,96,206
993,5,1998,27,1,1,71,67,2505,316,826,0.383,85,265,0.321,231,561,0.412,0.434,145,196,0.74,61,186,247,224,123,10,110,174
993,6,1999,28,1,1,49,49,1755,228,524,0.435,59,153,0.386,169,371,0.456,0.491,67,89,0.753,26,142,168,193,86,8,92,126
993,7,2000,29,1,1,82,82,2919,379,892,0.425,168,389,0.432,211,503,0.419,0.519,117,154,0.76,35,215,250,327,129,22,145,216
993,8,2001,30,1,1,82,5,2002,298,783,0.381,152,407,0.373,146,376,0.388,0.478,77,96,0.802,32,137,169,222,102,12,68,172
993,9,2002,31,1,1,82,47,1616,187,490,0.382,79,208,0.38,108,282,0.383,0.462,20,40,0.5,18,103,121,129,66,19,55,120
993,10,2003,32,1,1,29,0,673,106,302,0.351,34,107,0.318,72,195,0.369,0.407,34,47,0.723,15,44,59,71,35,5,57,50
993,13,2006,35,1,1,30,1,353,37,100,0.37,11,43,0.256,26,57,0.456,0.425,2,4,0.5,10,30,40,62,19,1,20,44
993,14,2007,36,1,1,52,0,745,94,244,0.385,38,119,0.319,56,125,0.448,0.463,30,33,0.909,9,38,47,93,34,7,35,56
993,15,2008,37,1,1,24,0,215,22,64,0.344,7,26,0.269,15,38,0.395,0.398,7,9,0.778,4,9,13,33,13,2,13,30
993,16,2009,38,1,1,28,0,266,27,82,0.329,16,48,0.333,11,34,0.324,0.427,3,5,0.6,2,10,12,37,20,1,19,28
993,17,2010,39,1,1,13,0,122,5,30,0.167,1,13,0.077,4,17,0.235,0.183,2,2,1,1,13,14,9,1,0,4,12
995,1,1994,22,1,1,19,19,499,54,146,0.37,2,16,0.125,52,130,0.4,0.377,24,30,0.8,6,28,34,115,13,1,48,28
995,2,1995,23,1,1,68,6,1105,103,284,0.363,21,76,0.276,82,208,0.394,0.4,58,76,0.763,14,56,70,226,29,0,110,79
995,3,1996,24,1,1,72,22,1059,65,230,0.283,22,76,0.289,43,154,0.279,0.33,68,85,0.8,12,63,75,216,28,3,86,121
995,4,1997,25,1,1,49,12,632,46,125,0.368,14,45,0.311,32,80,0.4,0.424,37,53,0.698,9,29,38,146,27,3,55,53
995,5,1998,26,1,1,34,3,417,47,115,0.409,4,15,0.267,43,100,0.43,0.426,30,37,0.811,7,29,36,80,13,0,42,36
995,5,1998,26,1,1,27,0,458,46,123,0.374,1,7,0.143,45,116,0.388,0.378,29,39,0.744,5,25,30,97,10,0,44,43
995,5,1998,26,1,1,61,3,875,93,238,0.391,5,22,0.227,88,216,0.407,0.401,59,76,0.776,12,54,66,177,23,0,86,79
997,1,1980,22,1,1,71,-1,923,94,241,0.39,3,17,0.176,91,224,0.406,0.396,28,38,0.737,14,44,58,159,39,5,73,83
997,2,1981,23,1,1,25,-1,542,76,153,0.497,0,1,0,76,152,0.5,0.497,22,27,0.815,12,27,39,117,13,1,31,35
997,2,1981,23,1,1,56,-1,1892,385,789,0.488,1,4,0.25,384,785,0.489,0.489,128,185,0.692,33,66,99,277,45,6,148,113
997,2,1981,23,1,1,81,-1,2434,461,942,0.489,1,5,0.2,460,937,0.491,0.49,150,212,0.708,45,93,138,394,58,7,179,148
997,3,1982,24,1,1,78,43,2409,325,672,0.484,3,10,0.3,322,662,0.486,0.486,153,200,0.765,53,97,150,590,70,11,171,169
997,4,1983,25,1,1,80,79,2716,401,832,0.482,4,12,0.333,397,820,0.484,0.484,168,245,0.686,41,118,159,487,74,4,195,215
997,5,1984,26,1,1,77,56,2041,348,699,0.498,2,11,0.182,346,688,0.503,0.499,110,154,0.714,32,64,96,413,38,1,145,126
997,6,1986,28,1,1,82,0,1208,140,273,0.513,2,6,0.333,138,267,0.517,0.516,63,92,0.685,10,55,65,342,38,4,83,67
997,7,1987,29,1,1,19,8,428,55,121,0.455,1,2,0.5,54,119,0.454,0.459,18,34,0.529,6,11,17,101,14,0,45,28
1022,1,2006,21,1,1,80,54,2406,345,883,0.391,97,271,0.358,248,612,0.405,0.446,161,222,0.725,77,188,265,446,102,8,182,181
1022,2,2007,22,1,1,78,75,2832,393,1024,0.384,103,312,0.33,290,712,0.407,0.434,204,256,0.797,51,216,267,545,118,10,230,180
1022,3,2008,23,1,1,79,79,2972,412,997,0.413,56,200,0.28,356,797,0.447,0.441,260,325,0.8,37,199,236,583,96,12,213,184
1022,4,2009,24,1,1,82,81,3086,442,1083,0.408,59,207,0.285,383,876,0.437,0.435,219,272,0.805,54,256,310,553,126,30,228,191
1022,5,2010,25,1,1,80,80,2643,388,846,0.459,60,156,0.385,328,690,0.475,0.494,132,173,0.763,53,235,288,446,123,22,168,172
1022,6,2011,26,1,1,54,54,2074,339,801,0.423,88,268,0.328,251,533,0.471,0.478,157,181,0.867,40,154,194,488,97,11,176,113
1022,6,2011,26,1,1,75,54,2737,427,1005,0.425,116,329,0.353,311,676,0.46,0.483,194,241,0.805,48,221,269,625,125,11,221,150
1022,7,2012,27,1,1,60,56,1906,261,642,0.407,62,203,0.305,199,439,0.453,0.455,100,124,0.806,27,122,149,390,78,10,170,122
1022,8,2013,28,1,1,68,68,2313,377,882,0.427,93,258,0.36,284,624,0.455,0.48,101,128,0.789,51,143,194,372,94,14,155,130
1022,9,2014,29,1,1,65,65,2017,240,608,0.395,62,195,0.318,178,413,0.431,0.446,88,122,0.721,54,143,197,365,78,27,129,157
1032,1,1997,22,1,1,80,3,921,104,262,0.397,22,73,0.301,82,189,0.434,0.439,79,120,0.658,25,72,97,119,41,5,71,87
1032,2,1998,23,1,1,82,36,1760,164,378,0.434,31,81,0.383,133,297,0.448,0.475,115,152,0.757,38,155,193,333,75,5,119,126
1032,3,1999,24,1,1,50,21,1131,99,263,0.376,38,97,0.392,61,166,0.367,0.449,60,79,0.759,21,70,91,197,61,1,77,95
1032,4,2000,25,1,1,78,22,1803,167,483,0.346,52,166,0.313,115,317,0.363,0.4,105,145,0.724,22,121,143,216,80,3,75,150
1032,5,2001,26,1,1,20,20,709,77,187,0.412,25,63,0.397,52,124,0.419,0.479,50,62,0.806,5,54,59,87,39,2,29,50
1032,6,2002,27,1,1,70,35,1974,274,666,0.411,144,349,0.413,130,317,0.41,0.52,94,111,0.847,15,131,146,181,66,9,62,121
1032,7,2003,28,1,1,82,82,2829,339,775,0.437,85,212,0.401,254,563,0.451,0.492,100,125,0.8,40,199,239,298,93,15,94,195
1032,9,2005,30,1,1,74,32,2222,297,755,0.393,108,291,0.371,189,464,0.407,0.465,175,203,0.862,38,180,218,301,76,4,129,176
1032,10,2006,31,1,1,82,36,2589,364,887,0.41,117,295,0.397,247,592,0.417,0.476,244,293,0.833,36,175,211,352,125,8,156,237
1032,12,2008,33,1,1,82,82,2249,339,777,0.436,112,276,0.406,227,501,0.453,0.508,166,188,0.883,24,146,170,239,86,3,90,188
1032,13,2009,34,1,1,82,82,2441,292,688,0.424,120,302,0.397,172,386,0.446,0.512,110,130,0.846,25,163,188,261,95,6,72,187
1032,14,2010,35,1,1,82,82,2227,212,558,0.38,78,224,0.348,134,334,0.401,0.45,113,132,0.856,25,145,170,201,90,9,78,202
1032,15,2011,36,1,1,82,82,2297,206,529,0.389,63,159,0.396,143,370,0.386,0.449,83,103,0.806,14,138,152,224,99,8,70,192
1032,16,2012,37,1,1,20,0,407,37,108,0.343,11,35,0.314,26,73,0.356,0.394,13,14,0.929,2,27,29,28,11,1,15,32
1032,16,2012,37,1,1,43,43,1101,92,240,0.383,24,74,0.324,68,166,0.41,0.433,44,53,0.83,10,82,92,142,40,3,58,85
1032,16,2012,37,1,1,63,43,1508,129,348,0.371,35,109,0.321,94,239,0.393,0.421,57,67,0.851,12,109,121,170,51,4,73,117
1032,17,2013,38,1,1,9,9,229,23,65,0.354,10,23,0.435,13,42,0.31,0.431,21,23,0.913,0,15,15,31,5,2,18,24
1040,1,2006,23,1,1,18,1,239,30,89,0.337,7,26,0.269,23,63,0.365,0.376,17,23,0.739,7,23,30,33,7,5,15,28
1045,1,1985,22,1,1,80,65,2486,433,922,0.47,0,4,0,433,918,0.472,0.47,260,339,0.767,148,175,323,247,99,8,197,232
1045,2,1986,23,1,1,80,77,2870,436,862,0.506,1,6,0.167,435,856,0.508,0.506,263,353,0.745,102,284,386,505,131,5,208,230
1045,3,1987,24,1,1,82,82,2549,370,727,0.509,2,10,0.2,368,717,0.513,0.51,238,302,0.788,109,225,334,473,109,18,167,222
1045,4,1988,25,1,1,80,80,2733,442,845,0.523,0,13,0,442,832,0.531,0.523,227,283,0.802,106,258,364,568,115,11,175,225
1045,5,1989,26,1,1,76,69,2552,419,814,0.515,3,23,0.13,416,791,0.526,0.517,243,304,0.799,85,225,310,494,77,12,192,212
1045,6,1990,27,1,1,82,82,2876,467,919,0.508,12,34,0.353,455,885,0.514,0.515,230,294,0.782,118,204,322,610,92,10,206,213
1045,7,1991,28,1,1,69,45,1929,356,671,0.531,4,18,0.222,352,653,0.539,0.534,161,221,0.729,83,131,214,369,76,13,137,116
1045,8,1992,29,1,1,82,6,1737,294,610,0.482,6,27,0.222,288,583,0.494,0.487,132,179,0.737,69,140,209,266,56,7,140,134
1045,9,1993,30,1,1,75,8,1503,280,554,0.505,7,36,0.194,273,518,0.527,0.512,143,197,0.726,63,106,169,224,63,9,121,126
1045,10,1994,31,1,1,55,5,1053,147,318,0.462,0,4,0,147,314,0.468,0.462,64,87,0.736,27,96,123,173,40,6,87,98
1045,11,1995,32,1,1,55,1,686,93,188,0.495,0,7,0,93,181,0.514,0.495,65,90,0.722,20,68,88,109,27,1,43,80
1045,12,1996,33,1,1,77,3,1747,227,524,0.433,3,28,0.107,224,496,0.452,0.436,133,177,0.751,49,121,170,255,41,5,122,115
1048,1,1983,22,1,1,43,6,494,92,216,0.426,4,14,0.286,88,202,0.436,0.435,38,45,0.844,16,26,42,67,19,9,40,56
1048,1,1983,22,1,1,33,11,754,134,311,0.431,6,11,0.545,128,300,0.427,0.441,112,135,0.83,40,55,95,71,39,8,66,78
1048,1,1983,22,1,1,76,17,1248,226,527,0.429,10,25,0.4,216,502,0.43,0.438,150,180,0.833,56,81,137,138,58,17,106,134
1048,2,1984,23,1,1,77,73,2555,484,1045,0.463,8,45,0.178,476,1000,0.476,0.467,315,386,0.816,87,184,271,269,103,31,196,216
1048,4,1986,25,1,1,82,82,2764,510,1007,0.506,39,119,0.328,471,888,0.53,0.526,351,441,0.796,76,221,297,746,157,16,290,199
1048,5,1987,26,1,1,82,82,3064,503,1030,0.488,73,190,0.384,430,840,0.512,0.524,462,537,0.86,56,212,268,848,146,18,280,199
1048,6,1988,27,1,1,18,18,680,132,301,0.439,1,20,0.05,131,281,0.466,0.44,116,139,0.835,26,65,91,178,27,2,67,46
1048,6,1988,27,1,1,59,55,1834,288,668,0.431,13,52,0.25,275,616,0.446,0.441,185,215,0.86,51,154,205,366,68,10,156,144
1048,6,1988,27,1,1,77,73,2514,420,969,0.433,14,72,0.194,406,897,0.453,0.441,301,354,0.85,77,219,296,544,95,12,223,190
1048,7,1989,28,1,1,82,82,2788,396,893,0.443,109,292,0.373,287,601,0.478,0.504,261,309,0.845,48,258,306,709,124,11,253,196
1048,8,1990,29,1,1,82,73,2630,362,803,0.451,89,234,0.38,273,569,0.48,0.506,187,232,0.806,46,152,198,600,94,11,204,159
1048,9,1991,30,1,1,82,4,1850,386,939,0.411,48,176,0.273,338,763,0.443,0.437,185,246,0.752,52,107,159,317,95,17,140,122
1048,10,1992,31,1,1,82,3,1662,286,704,0.406,37,123,0.301,249,581,0.429,0.433,135,170,0.794,34,116,150,239,57,21,128,128
1048,11,1993,32,1,1,52,10,867,124,305,0.407,16,56,0.286,108,249,0.434,0.433,81,102,0.794,14,72,86,132,32,6,68,59
1048,12,1994,33,1,1,53,2,737,70,209,0.335,8,36,0.222,62,173,0.358,0.354,52,78,0.667,10,60,70,101,12,8,61,71
1049,1,2010,20,1,1,81,81,2339,397,952,0.417,77,215,0.358,320,737,0.434,0.457,223,270,0.826,24,167,191,356,82,2,233,98
1049,2,2011,21,1,1,53,8,983,108,296,0.365,31,100,0.31,77,196,0.393,0.417,32,42,0.762,12,65,77,182,34,3,113,58
1049,3,2012,22,1,1,11,0,135,12,41,0.293,2,9,0.222,10,32,0.313,0.317,11,14,0.786,1,7,8,28,3,1,9,8
1049,3,2012,22,1,1,18,1,281,34,90,0.378,8,25,0.32,26,65,0.4,0.422,18,25,0.72,7,24,31,68,3,1,27,15
1049,3,2012,22,1,1,29,1,416,46,131,0.351,10,34,0.294,36,97,0.371,0.389,29,39,0.744,8,31,39,96,6,2,36,23
1063,1,1980,23,1,1,82,-1,2621,489,1058,0.462,4,23,0.174,485,1035,0.469,0.464,346,423,0.818,29,143,172,610,136,4,282,208
1063,2,1981,24,1,1,66,-1,2287,424,887,0.478,11,36,0.306,413,851,0.485,0.484,294,354,0.831,26,102,128,580,99,6,241,190
1063,3,1982,25,1,1,72,65,1952,285,649,0.439,7,32,0.219,278,617,0.451,0.445,136,166,0.819,24,81,105,451,63,1,194,160
1063,4,1983,26,1,1,7,7,163,20,35,0.571,0,1,0,20,34,0.588,0.571,7,10,0.7,0,7,7,38,6,0,21,22
1063,4,1983,26,1,1,70,56,1447,193,410,0.471,1,8,0.125,192,402,0.478,0.472,90,113,0.796,18,78,96,252,46,3,113,168
1063,4,1983,26,1,1,77,63,1610,213,445,0.479,1,9,0.111,212,436,0.486,0.48,97,123,0.789,18,85,103,290,52,3,134,190
1063,5,1984,27,1,1,81,55,2020,236,470,0.502,2,15,0.133,234,455,0.514,0.504,98,117,0.838,28,109,137,410,59,8,135,243
1063,6,1985,28,1,1,25,1,290,14,47,0.298,0,4,0,14,43,0.326,0.298,16,18,0.889,3,24,27,61,6,1,17,33
1071,1,1984,23,1,1,80,34,1424,260,580,0.448,22,84,0.262,238,496,0.48,0.467,122,155,0.787,39,81,120,172,54,9,108,193
1071,2,1985,24,1,1,79,1,1318,286,636,0.45,41,126,0.325,245,510,0.48,0.482,83,110,0.755,27,53,80,186,61,0,117,171
1071,3,1986,25,1,1,48,0,704,85,218,0.39,9,32,0.281,76,186,0.409,0.411,23,32,0.719,9,49,58,121,22,1,61,77
1083,1,2000,22,1,1,77,77,2776,497,1117,0.445,107,310,0.345,390,807,0.483,0.493,287,365,0.786,152,257,409,507,118,29,306,231
1083,2,2001,23,1,1,80,79,3194,550,1219,0.451,133,336,0.396,417,883,0.472,0.506,358,438,0.817,190,363,553,517,141,31,265,274
1083,3,2002,24,1,1,57,56,2343,420,1007,0.417,68,210,0.324,352,797,0.442,0.451,326,422,0.773,102,299,401,362,71,25,221,172
1083,4,2003,25,1,1,81,81,3318,571,1312,0.435,85,240,0.354,486,1072,0.453,0.468,476,595,0.8,159,340,499,502,141,41,299,251
1083,5,2004,26,1,1,79,79,3194,450,1117,0.403,73,250,0.292,377,867,0.435,0.436,337,435,0.775,116,317,433,493,139,35,294,257
1083,6,2005,27,1,1,78,78,2978,563,1330,0.423,38,127,0.299,525,1203,0.436,0.438,499,606,0.823,126,324,450,547,112,28,317,273
1083,7,2006,28,1,1,46,45,1734,249,575,0.433,18,70,0.257,231,505,0.457,0.449,231,290,0.797,60,159,219,262,51,11,156,142
1083,7,2006,28,1,1,70,60,2393,333,765,0.435,25,83,0.301,308,682,0.452,0.452,314,399,0.787,74,216,290,345,74,17,214,204
1083,9,2008,30,1,1,10,3,199,19,57,0.333,4,17,0.235,15,40,0.375,0.368,13,23,0.565,8,15,23,30,9,5,14,25
1088,1,2007,23,1,1,82,12,1879,300,691,0.434,68,185,0.368,232,506,0.458,0.483,164,192,0.854,49,169,218,232,53,21,152,184
1088,2,2008,24,1,1,39,31,1259,198,462,0.429,61,148,0.412,137,314,0.436,0.495,53,65,0.815,13,115,128,164,36,3,79,102
1088,4,2010,26,1,1,70,38,1667,256,619,0.414,63,182,0.346,193,437,0.442,0.464,129,145,0.89,16,114,130,228,33,10,94,123
1091,1,2012,22,1,1,61,7,1135,172,446,0.386,78,216,0.361,94,230,0.409,0.473,40,48,0.833,17,56,73,108,30,3,67,73
1116,1,2004,23,1,1,38,1,364,25,86,0.291,3,10,0.3,22,76,0.289,0.308,16,25,0.64,8,31,39,40,11,2,18,22
1116,2,2005,24,1,1,10,0,108,10,27,0.37,3,12,0.25,7,15,0.467,0.426,3,4,0.75,0,11,11,3,3,0,4,12
1116,2,2005,24,1,1,21,0,187,17,50,0.34,4,14,0.286,13,36,0.361,0.38,3,4,0.75,1,13,14,7,5,1,7,17
1117,1,2010,23,1,1,32,0,217,38,82,0.463,7,26,0.269,31,56,0.554,0.506,23,46,0.5,6,23,29,39,12,0,14,17
1117,2,2011,24,1,1,10,0,146,20,48,0.417,4,17,0.235,16,31,0.516,0.458,11,20,0.55,10,14,24,25,9,0,13,11
1117,2,2011,24,1,1,24,0,301,42,105,0.4,9,38,0.237,33,67,0.493,0.443,18,36,0.5,13,25,38,42,16,1,27,25
1120,1,1980,29,1,1,67,-1,1474,171,377,0.454,2,13,0.154,169,364,0.464,0.456,97,120,0.808,34,118,152,312,123,13,115,134
1120,2,1981,30,1,1,42,-1,476,71,145,0.49,1,4,0.25,70,141,0.496,0.493,36,42,0.857,9,38,47,70,39,5,38,61
1120,2,1981,30,1,1,35,-1,636,86,164,0.524,1,3,0.333,85,161,0.528,0.527,19,26,0.731,7,45,52,99,55,2,39,56
1120,2,1981,30,1,1,77,-1,1112,157,309,0.508,2,7,0.286,155,302,0.513,0.511,55,68,0.809,16,83,99,169,94,7,77,117
1120,3,1982,31,1,1,75,70,1793,185,373,0.496,0,5,0,185,368,0.503,0.496,51,65,0.785,37,152,189,261,121,28,126,173
1133,1,1980,22,1,1,78,-1,1106,155,356,0.435,6,19,0.316,149,337,0.442,0.444,18,26,0.692,50,88,138,145,54,4,73,80
1137,1,1999,23,1,1,24,0,205,15,51,0.294,6,23,0.261,9,28,0.321,0.353,15,20,0.75,3,18,21,18,5,1,12,18
1139,1,2013,24,1,1,19,0,149,16,49,0.327,3,15,0.2,13,34,0.382,0.357,5,10,0.5,5,10,15,31,10,0,16,5
1139,2,2014,25,1,1,71,0,1048,101,265,0.381,36,96,0.375,65,169,0.385,0.449,10,12,0.833,11,86,97,120,41,5,75,75
1154,1,1997,23,1,1,39,0,246,22,58,0.379,8,21,0.381,14,37,0.378,0.448,5,11,0.455,4,11,15,36,13,2,15,36
1154,2,1998,24,1,1,62,2,685,56,169,0.331,12,40,0.3,44,129,0.341,0.367,28,56,0.5,19,48,67,74,37,12,42,95
1166,1,2007,20,1,1,60,16,988,98,231,0.424,52,124,0.419,46,107,0.43,0.537,28,39,0.718,28,64,92,69,23,8,44,94
1166,2,2008,21,1,1,58,26,1765,201,465,0.432,118,268,0.44,83,197,0.421,0.559,85,105,0.81,30,104,134,145,47,14,76,163
1166,3,2009,22,1,1,75,0,1795,206,527,0.391,108,283,0.382,98,244,0.402,0.493,66,86,0.767,31,124,155,132,44,16,61,163
1166,4,2010,23,1,1,56,10,1068,125,268,0.466,71,149,0.477,54,119,0.454,0.599,34,49,0.694,13,60,73,70,25,7,36,79
1166,7,2013,26,1,1,46,3,919,84,247,0.34,56,163,0.344,28,84,0.333,0.453,26,37,0.703,5,55,60,82,30,4,31,89
1187,2,1981,25,1,1,82,-1,1506,285,511,0.558,4,11,0.364,281,500,0.562,0.562,98,110,0.891,27,61,88,108,72,5,62,126
1204,4,2012,23,1,1,9,9,310,63,140,0.45,10,40,0.25,53,100,0.53,0.486,49,65,0.754,2,23,25,31,13,4,24,20
1225,1,1989,23,1,1,71,48,1924,361,830,0.435,5,22,0.227,356,808,0.441,0.438,119,162,0.735,80,158,238,506,144,9,258,170
1225,2,1990,24,1,1,44,44,1529,241,517,0.466,5,21,0.238,236,496,0.476,0.471,88,113,0.779,59,136,195,442,108,5,206,120
1225,3,1991,25,1,1,68,65,2105,265,587,0.451,9,39,0.231,256,548,0.467,0.459,51,74,0.689,69,140,209,587,103,12,210,192
1225,4,1992,26,1,1,78,53,2049,275,595,0.462,15,51,0.294,260,544,0.478,0.475,44,54,0.815,34,150,184,538,138,14,187,181
1225,5,1993,27,1,1,74,8,1624,210,476,0.441,11,42,0.262,199,434,0.459,0.453,55,74,0.743,27,112,139,353,106,9,129,168
1225,6,1994,28,1,1,78,8,1533,253,563,0.449,17,62,0.274,236,501,0.471,0.464,65,76,0.855,42,100,142,291,119,12,136,139
1225,7,1995,29,1,1,33,2,470,78,166,0.47,4,16,0.25,74,150,0.493,0.482,45,55,0.818,8,27,35,93,29,3,44,66
1225,8,1996,30,1,1,47,1,596,88,181,0.486,8,24,0.333,80,157,0.51,0.508,48,58,0.828,12,40,52,69,39,3,45,91
1225,9,1997,31,1,1,28,0,365,39,110,0.355,14,46,0.304,25,64,0.391,0.418,18,22,0.818,8,30,38,45,16,0,27,39
1225,10,1998,32,1,1,22,2,359,43,93,0.462,7,19,0.368,36,74,0.486,0.5,12,14,0.857,8,40,48,84,17,2,24,30
1289,1,2014,25,1,1,15,2,244,25,54,0.463,3,12,0.25,22,42,0.524,0.491,9,12,0.75,3,19,22,30,10,1,14,37
1290,1,2001,22,1,1,33,8,630,78,192,0.406,27,69,0.391,51,123,0.415,0.477,15,18,0.833,10,26,36,64,9,5,24,35
1290,2,2002,23,1,1,45,6,607,88,244,0.361,46,123,0.374,42,121,0.347,0.455,22,27,0.815,12,32,44,81,10,7,37,23
1324,1,2000,20,1,1,82,0,1523,182,433,0.42,25,111,0.225,157,322,0.488,0.449,97,153,0.634,48,117,165,309,97,19,140,201
1324,2,2001,21,1,1,82,82,3192,409,957,0.427,85,274,0.31,324,683,0.474,0.472,228,337,0.677,129,279,408,598,170,36,226,267
1324,3,2002,22,1,1,82,82,3318,559,1341,0.417,170,478,0.356,389,863,0.451,0.48,196,338,0.58,93,256,349,698,172,47,246,241
1324,4,2003,23,1,1,50,47,1889,332,798,0.416,99,283,0.35,233,515,0.452,0.478,93,131,0.71,56,130,186,320,91,22,140,148
1324,5,2004,24,1,1,67,66,2686,554,1402,0.395,187,582,0.321,367,820,0.448,0.462,237,352,0.673,66,221,287,501,158,27,215,178
1324,6,2005,25,1,1,18,13,593,111,303,0.366,44,137,0.321,67,166,0.404,0.439,74,96,0.771,16,51,67,129,31,4,38,52
1324,6,2005,25,1,1,28,19,988,180,449,0.401,74,217,0.341,106,232,0.457,0.483,111,147,0.755,16,92,108,233,50,10,93,74
1324,6,2005,25,1,1,46,32,1581,291,752,0.387,118,354,0.333,173,398,0.435,0.465,185,243,0.761,32,143,175,362,81,14,131,126
1324,7,2006,26,1,1,54,48,1971,335,861,0.389,102,324,0.315,233,537,0.434,0.448,195,289,0.675,45,191,236,480,89,14,159,165
1324,8,2007,27,1,1,63,62,2221,452,1030,0.439,85,280,0.304,367,750,0.489,0.48,275,369,0.745,51,225,276,509,135,29,193,181
1324,9,2008,28,1,1,82,82,3196,650,1526,0.426,173,525,0.33,477,1001,0.477,0.483,318,424,0.75,96,289,385,623,191,43,232,247
1324,10,2009,29,1,1,65,60,2248,355,959,0.37,99,328,0.302,256,631,0.406,0.422,159,210,0.757,46,192,238,501,108,35,193,193
1324,11,2010,30,1,1,75,73,2523,412,1015,0.406,82,296,0.277,330,719,0.459,0.446,239,291,0.821,52,214,266,598,126,43,211,210
1324,12,2011,31,1,1,15,9,380,75,178,0.421,36,87,0.414,39,91,0.429,0.522,22,27,0.815,6,30,36,92,16,6,39,29
1324,12,2011,31,1,1,43,35,1269,214,515,0.416,45,152,0.296,169,363,0.466,0.459,79,104,0.76,29,91,120,299,62,22,107,114
1324,12,2011,31,1,1,58,44,1649,289,693,0.417,81,239,0.339,208,454,0.458,0.475,101,131,0.771,35,121,156,391,78,28,146,143
1324,13,2012,32,1,1,29,14,595,68,184,0.37,26,85,0.306,42,99,0.424,0.44,16,24,0.667,13,43,56,135,34,3,76,61
1326,1,1980,24,1,1,13,-1,225,33,56,0.589,0,1,0,33,55,0.6,0.589,10,12,0.833,4,11,15,45,10,1,11,21
1326,1,1980,24,1,1,18,-1,268,35,63,0.556,0,1,0,35,62,0.565,0.556,13,16,0.813,4,13,17,50,13,1,14,28
1326,2,1981,25,1,1,56,-1,1686,230,410,0.561,3,17,0.176,227,393,0.578,0.565,163,204,0.799,29,122,151,385,52,11,123,156
1326,3,1982,26,1,1,82,82,2614,397,771,0.515,14,49,0.286,383,722,0.53,0.524,185,230,0.804,35,191,226,509,73,6,159,218
1326,4,1983,27,1,1,79,78,2323,359,628,0.572,11,43,0.256,348,585,0.595,0.58,186,220,0.845,34,164,198,565,80,11,143,176
1326,5,1984,28,1,1,81,81,2665,345,651,0.53,7,38,0.184,338,613,0.551,0.535,199,238,0.836,41,146,187,561,94,13,166,218
1326,6,1985,29,1,1,82,82,2539,310,614,0.505,47,115,0.409,263,499,0.527,0.543,158,178,0.888,39,154,193,581,91,10,123,219
1326,7,1986,30,1,1,82,43,1971,267,502,0.532,32,89,0.36,235,413,0.569,0.564,198,228,0.868,26,120,146,467,57,15,110,174
1326,8,1987,31,1,1,82,6,1582,199,436,0.456,32,106,0.302,167,330,0.506,0.493,147,171,0.86,27,87,114,373,63,10,114,159
1326,9,1988,32,1,1,75,12,1480,208,415,0.501,30,74,0.405,178,341,0.522,0.537,91,108,0.843,18,84,102,303,51,18,91,149
1326,10,1989,33,1,1,78,4,1395,183,379,0.483,32,102,0.314,151,277,0.545,0.525,99,123,0.805,14,94,108,242,48,18,92,151
1326,11,1990,34,1,1,73,2,1292,179,365,0.49,35,104,0.337,144,261,0.552,0.538,77,100,0.77,12,81,93,242,47,9,86,151
1326,12,1991,35,1,1,80,6,1426,159,373,0.426,22,85,0.259,137,288,0.476,0.456,91,118,0.771,13,105,118,230,45,17,77,212
1326,13,1992,36,1,1,33,0,429,38,86,0.442,5,18,0.278,33,68,0.485,0.471,11,15,0.733,4,29,33,66,11,3,27,57
1334,8,2000,29,1,1,79,15,1817,217,464,0.468,82,167,0.491,135,297,0.455,0.556,67,77,0.87,17,117,134,141,24,3,70,109
1334,9,2001,30,1,1,15,11,431,57,119,0.479,20,38,0.526,37,81,0.457,0.563,19,21,0.905,10,20,30,49,6,0,25,29
1334,9,2001,30,1,1,51,7,1261,139,314,0.443,58,133,0.436,81,181,0.448,0.535,35,41,0.854,18,91,109,61,29,1,56,92
1334,9,2001,30,1,1,66,18,1692,196,433,0.453,78,171,0.456,118,262,0.45,0.543,54,62,0.871,28,111,139,110,35,1,81,121
1335,1,1980,24,1,1,82,-1,2912,496,1159,0.428,4,42,0.095,492,1117,0.44,0.43,304,352,0.864,102,124,226,440,110,23,202,178
1335,2,1981,25,1,1,76,-1,2536,426,917,0.465,4,33,0.121,422,884,0.477,0.467,238,299,0.796,56,114,170,480,95,14,167,179
1335,5,1984,28,1,1,75,72,2079,354,800,0.443,0,8,0,354,792,0.447,0.443,217,256,0.848,53,86,139,326,62,6,134,146
1335,6,1985,29,1,1,76,30,1920,337,791,0.426,12,46,0.261,325,745,0.436,0.434,255,300,0.85,35,84,119,426,43,4,152,136
1353,1,1987,23,1,1,81,14,1682,334,764,0.437,14,47,0.298,320,717,0.446,0.446,153,191,0.801,56,113,169,290,67,3,120,118
1353,2,1988,24,1,1,65,61,2179,405,835,0.485,19,61,0.311,386,774,0.499,0.496,198,221,0.896,66,138,204,480,88,2,154,95
1353,3,1989,25,1,1,32,30,1083,177,400,0.443,0,4,0,177,396,0.447,0.443,100,112,0.893,32,69,101,224,55,0,111,64
1353,4,1990,26,1,1,81,81,2865,465,950,0.489,22,66,0.333,443,884,0.501,0.501,210,244,0.861,48,199,247,601,121,9,214,159
1353,5,1991,27,1,1,4,4,124,26,41,0.634,1,4,0.25,25,37,0.676,0.646,10,11,0.909,0,16,16,28,3,0,8,4
1353,6,1992,28,1,1,82,82,2815,394,902,0.437,36,101,0.356,358,801,0.447,0.457,164,186,0.882,42,185,227,567,89,5,183,158
1353,7,1993,29,1,1,74,10,1598,258,590,0.437,26,84,0.31,232,506,0.458,0.459,113,142,0.796,33,103,136,339,80,4,121,91
1353,8,1994,30,1,1,72,12,1343,177,423,0.418,37,105,0.352,140,318,0.44,0.462,84,100,0.84,28,95,123,263,63,5,111,74
1353,9,1995,31,1,1,50,9,1170,125,270,0.463,25,73,0.342,100,197,0.508,0.509,50,55,0.909,28,85,113,205,52,1,86,74
1369,1,1994,22,1,1,64,6,759,129,342,0.377,23,57,0.404,106,285,0.372,0.411,61,81,0.753,25,43,68,78,28,3,61,69
1369,2,1995,23,1,1,80,28,1774,279,685,0.407,48,163,0.294,231,522,0.443,0.442,229,292,0.784,35,117,152,225,45,7,157,200
1369,3,1996,24,1,1,82,10,2018,315,686,0.459,139,316,0.44,176,370,0.476,0.56,247,327,0.755,41,102,143,350,54,16,191,239
1369,4,1997,25,1,1,73,3,1053,148,383,0.386,52,160,0.325,96,223,0.43,0.454,122,148,0.824,15,80,95,158,27,3,96,142
1369,5,1998,26,1,1,77,18,1410,180,451,0.399,50,132,0.379,130,319,0.408,0.455,79,99,0.798,21,85,106,196,52,4,96,150
1370,1,1997,23,1,1,61,1,867,119,256,0.465,52,112,0.464,67,144,0.465,0.566,42,51,0.824,31,68,99,99,36,6,68,71
1370,2,1998,24,1,1,74,9,1647,311,794,0.392,41,156,0.263,270,638,0.423,0.418,110,149,0.738,38,132,170,169,73,12,105,88
1370,2,1998,24,1,1,77,9,1681,314,798,0.393,42,157,0.268,272,641,0.424,0.42,111,151,0.735,38,134,172,172,73,12,109,96
1370,3,1999,25,1,1,36,13,630,92,253,0.364,16,66,0.242,76,187,0.406,0.395,46,71,0.648,11,43,54,95,16,6,45,47
1370,4,2000,26,1,1,46,1,682,120,279,0.43,9,40,0.225,111,239,0.464,0.446,47,59,0.797,36,52,88,55,35,5,32,58
1370,7,2003,29,1,1,67,39,1873,233,560,0.416,120,304,0.395,113,256,0.441,0.523,68,87,0.782,41,191,232,146,72,10,69,124
1370,10,2006,32,1,1,23,0,378,71,160,0.444,20,47,0.426,51,113,0.451,0.506,18,25,0.72,13,38,51,33,13,1,19,28
1370,10,2006,32,1,1,24,0,385,71,161,0.441,20,47,0.426,51,114,0.447,0.503,20,27,0.741,14,39,53,33,13,1,19,28
1390,1,2003,24,1,1,50,0,515,70,170,0.412,22,61,0.361,48,109,0.44,0.476,21,26,0.808,9,34,43,85,14,2,53,66
1390,2,2004,25,1,1,23,0,143,21,49,0.429,3,10,0.3,18,39,0.462,0.459,4,6,0.667,4,12,16,18,9,0,13,22
1390,2,2004,25,1,1,20,0,151,16,49,0.327,7,20,0.35,9,29,0.31,0.398,7,8,0.875,3,7,10,20,8,0,13,22
1390,2,2004,25,1,1,43,0,294,37,98,0.378,10,30,0.333,27,68,0.397,0.429,11,14,0.786,7,19,26,38,17,0,26,44
1390,3,2005,26,1,1,67,46,2074,305,748,0.408,84,242,0.347,221,506,0.437,0.464,188,225,0.836,34,145,179,346,76,4,144,200
1390,3,2005,26,1,1,71,46,2090,306,756,0.405,85,245,0.347,221,511,0.432,0.461,190,228,0.833,34,146,180,347,76,4,145,201
1390,4,2006,27,1,1,19,0,234,17,46,0.37,10,20,0.5,7,26,0.269,0.478,18,18,1,5,11,16,40,11,1,18,40
1390,5,2007,28,1,1,50,3,444,54,151,0.358,16,61,0.262,38,90,0.422,0.411,42,53,0.792,7,36,43,70,14,1,27,55
1390,6,2008,29,1,1,67,8,1040,124,296,0.419,36,108,0.333,88,188,0.468,0.48,68,82,0.829,13,84,97,172,32,3,55,108
1398,1,2006,23,1,1,23,0,246,29,69,0.42,25,57,0.439,4,12,0.333,0.601,5,6,0.833,4,17,21,16,7,0,10,22
1398,2,2007,24,1,1,26,0,288,34,80,0.425,18,50,0.36,16,30,0.533,0.538,12,15,0.8,3,15,18,35,4,0,13,27
1398,3,2008,25,1,1,66,21,1356,159,430,0.37,74,233,0.318,85,197,0.431,0.456,64,71,0.901,26,89,115,251,35,4,55,107
1398,4,2009,26,1,1,55,0,719,74,179,0.413,46,118,0.39,28,61,0.459,0.542,12,15,0.8,6,80,86,122,26,5,21,42
1399,1,1982,23,1,1,33,0,221,29,79,0.367,0,4,0,29,75,0.387,0.367,15,23,0.652,6,9,15,34,8,2,17,40
1406,1,1990,22,1,1,33,0,362,44,109,0.404,1,9,0.111,43,100,0.43,0.408,26,30,0.867,13,27,40,75,19,2,37,30
1406,2,1991,23,1,1,10,0,144,13,33,0.394,0,0,-1,13,33,0.394,0.394,8,9,0.889,0,11,11,19,2,0,13,12
1406,2,1991,23,1,1,12,0,149,14,34,0.412,0,0,-1,14,34,0.412,0.412,8,9,0.889,0,12,12,19,2,0,13,15
1414,1,2003,24,1,1,42,3,647,104,271,0.384,25,84,0.298,79,187,0.422,0.43,37,46,0.804,13,59,72,40,26,3,42,54
1414,6,2008,29,1,1,17,0,244,47,98,0.48,13,33,0.394,34,65,0.523,0.546,3,7,0.429,6,22,28,32,0,0,19,24
1414,6,2008,29,1,1,36,0,424,59,160,0.369,17,39,0.436,42,121,0.347,0.422,18,19,0.947,9,38,47,65,21,2,35,38
1414,6,2008,29,1,1,53,0,668,106,258,0.411,30,72,0.417,76,186,0.409,0.469,21,26,0.808,15,60,75,97,21,2,54,62
1414,7,2009,30,1,1,50,6,816,101,256,0.395,25,75,0.333,76,181,0.42,0.443,34,39,0.872,8,59,67,118,35,6,70,74
1418,1,1988,22,1,1,44,0,364,44,109,0.404,0,7,0,44,102,0.431,0.404,17,21,0.81,5,20,25,87,16,1,42,33
1421,1,2001,20,1,1,76,1,1237,148,362,0.409,28,80,0.35,120,282,0.426,0.448,125,179,0.698,8,81,89,177,41,11,94,107
1421,2,2002,21,1,1,14,0,155,22,57,0.386,4,14,0.286,18,43,0.419,0.421,10,12,0.833,0,3,3,12,4,3,10,20
1421,4,2004,23,1,1,58,24,1137,137,352,0.389,8,46,0.174,129,306,0.422,0.401,78,94,0.83,17,62,79,130,45,6,65,108
1421,5,2005,24,1,1,74,0,1184,139,345,0.403,19,75,0.253,120,270,0.444,0.43,85,109,0.78,11,79,90,132,39,11,65,120
1421,6,2006,25,1,1,50,7,1137,178,405,0.44,13,43,0.302,165,362,0.456,0.456,101,121,0.835,11,67,78,109,49,4,82,116
1421,8,2008,27,1,1,72,1,1334,198,423,0.468,22,65,0.338,176,358,0.492,0.494,163,193,0.845,7,94,101,133,36,5,61,131
1421,9,2009,28,1,1,77,18,2074,261,598,0.436,99,235,0.421,162,363,0.446,0.519,127,154,0.825,24,131,155,270,71,8,105,135
1421,10,2010,29,1,1,53,8,971,129,324,0.398,59,157,0.376,70,167,0.419,0.489,47,61,0.77,8,46,54,135,34,0,59,82
1421,11,2011,30,1,1,80,22,1757,206,519,0.397,81,234,0.346,125,285,0.439,0.475,78,94,0.83,12,105,117,243,54,4,91,119
1423,1,2007,22,1,1,42,0,359,48,126,0.381,12,50,0.24,36,76,0.474,0.429,11,15,0.733,11,26,37,15,15,4,15,21
1423,2,2008,23,1,1,74,0,876,132,335,0.394,42,122,0.344,90,213,0.423,0.457,48,52,0.923,17,66,83,53,30,12,59,80
1423,3,2009,24,1,1,20,0,227,30,88,0.341,10,37,0.27,20,51,0.392,0.398,14,15,0.933,3,22,25,13,2,5,6,23
1423,3,2009,24,1,1,27,0,300,42,110,0.382,14,46,0.304,28,64,0.438,0.445,17,19,0.895,6,26,32,25,5,5,13,27
1427,1,1990,23,1,1,81,66,2470,463,938,0.494,5,31,0.161,458,907,0.505,0.496,224,326,0.687,70,136,206,619,145,10,246,187
1427,2,1991,24,1,1,73,73,2562,532,1055,0.504,4,31,0.129,528,1024,0.516,0.506,284,414,0.686,78,131,209,624,121,5,270,178
1427,3,1992,25,1,1,37,0,654,101,222,0.455,1,9,0.111,100,213,0.469,0.457,68,100,0.68,12,45,57,153,21,9,60,68
1427,3,1992,25,1,1,42,2,752,117,253,0.462,1,10,0.1,116,243,0.477,0.464,73,107,0.682,13,50,63,172,25,9,68,78
1427,4,1993,26,1,1,79,36,1932,264,530,0.498,6,29,0.207,258,501,0.515,0.504,84,150,0.56,65,97,162,508,49,10,161,166
1427,5,1994,27,1,1,78,78,2789,425,919,0.462,13,56,0.232,412,863,0.477,0.47,177,276,0.641,70,123,193,683,89,11,233,171
1427,6,1995,28,1,1,65,43,2048,365,769,0.475,20,82,0.244,345,687,0.502,0.488,204,296,0.689,48,122,170,446,80,2,162,152
1427,7,1996,29,1,1,10,4,234,36,84,0.429,1,7,0.143,35,77,0.455,0.435,25,40,0.625,6,17,23,39,2,0,29,16
1427,7,1996,29,1,1,69,62,2101,309,601,0.514,39,103,0.379,270,498,0.542,0.547,135,179,0.754,49,108,157,397,61,5,165,147
1427,7,1996,29,1,1,79,66,2335,345,685,0.504,40,110,0.364,305,575,0.53,0.533,160,219,0.731,55,125,180,436,63,5,194,163
1427,8,1997,30,1,1,79,79,2316,306,610,0.502,38,114,0.333,268,496,0.54,0.533,114,171,0.667,57,136,193,427,78,10,153,191
1427,9,1998,31,1,1,80,11,1699,255,515,0.495,14,46,0.304,241,469,0.514,0.509,115,172,0.669,52,83,135,319,55,7,110,156
1427,10,1999,32,1,1,30,19,842,96,219,0.438,0,11,0,96,208,0.462,0.438,55,87,0.632,16,42,58,124,27,3,61,54
1427,11,2000,33,1,1,20,2,309,45,90,0.5,5,16,0.313,40,74,0.541,0.528,25,28,0.893,13,16,29,34,17,0,24,26
1427,12,2001,34,1,1,59,7,1094,122,303,0.403,8,40,0.2,114,263,0.433,0.416,86,115,0.748,21,53,74,144,36,4,79,93
1428,1,2010,23,1,1,56,12,1087,179,391,0.458,68,175,0.389,111,216,0.514,0.545,55,68,0.809,40,68,108,112,42,3,55,116
1428,3,2012,25,1,1,38,9,656,94,290,0.324,27,117,0.231,67,173,0.387,0.371,22,26,0.846,16,56,72,77,29,1,56,55
1428,4,2013,26,1,1,22,0,376,49,114,0.43,21,54,0.389,28,60,0.467,0.522,16,16,1,11,37,48,58,31,1,25,42
1428,4,2013,26,1,1,49,0,913,139,352,0.395,61,162,0.377,78,190,0.411,0.482,60,68,0.882,23,67,90,93,40,2,56,103
1428,4,2013,26,1,1,71,0,1289,188,466,0.403,82,216,0.38,106,250,0.424,0.491,76,84,0.905,34,104,138,151,71,3,81,145
1428,5,2014,27,1,1,24,0,265,32,86,0.372,19,59,0.322,13,27,0.481,0.483,5,8,0.625,4,22,26,19,6,2,16,34
1428,5,2014,27,1,1,27,17,410,41,104,0.394,12,43,0.279,29,61,0.475,0.452,20,26,0.769,14,47,61,49,13,3,18,47
1428,5,2014,27,1,1,51,17,675,73,190,0.384,31,102,0.304,42,88,0.477,0.466,25,34,0.735,18,69,87,68,19,5,34,81
1434,1,2011,26,1,1,24,0,292,51,125,0.408,3,10,0.3,48,115,0.417,0.42,16,17,0.941,5,15,20,51,20,2,29,30
1435,1,2009,22,1,1,55,1,728,88,224,0.393,20,54,0.37,68,170,0.4,0.438,50,65,0.769,33,70,103,111,29,3,73,87
1435,2,2010,23,1,1,80,2,1442,222,491,0.452,74,188,0.394,148,303,0.488,0.527,117,159,0.736,38,133,171,241,48,8,126,131
1435,3,2011,24,1,1,22,3,378,59,125,0.472,28,54,0.519,31,71,0.437,0.584,24,36,0.667,12,44,56,55,14,4,21,35
1435,3,2011,24,1,1,48,2,856,133,316,0.421,28,101,0.277,105,215,0.488,0.465,59,97,0.608,24,62,86,149,36,6,96,90
1435,3,2011,24,1,1,70,5,1234,192,441,0.435,56,155,0.361,136,286,0.476,0.499,83,133,0.624,36,106,142,204,50,10,117,125
1435,4,2012,25,1,1,66,28,1752,277,600,0.462,68,202,0.337,209,398,0.525,0.518,153,190,0.805,53,115,168,351,85,10,157,166
1435,5,2013,26,1,1,77,77,2581,401,906,0.443,88,276,0.319,313,630,0.497,0.491,244,326,0.748,60,178,238,569,124,26,212,214
1436,1,1999,24,1,1,34,0,441,47,129,0.364,16,49,0.327,31,80,0.388,0.426,8,8,1,3,29,32,52,12,4,31,61
1436,2,2000,25,1,1,72,5,1293,158,413,0.383,59,163,0.362,99,250,0.396,0.454,45,53,0.849,23,80,103,162,41,1,66,79
1436,3,2001,26,1,1,48,41,1305,124,327,0.379,40,105,0.381,84,222,0.378,0.44,14,19,0.737,12,57,69,185,32,3,68,99
1436,4,2002,27,1,1,61,0,774,78,182,0.429,31,73,0.425,47,109,0.431,0.514,23,29,0.793,14,58,72,101,32,2,33,49
1453,11,1996,32,1,1,67,40,2193,255,598,0.426,121,298,0.406,134,300,0.447,0.528,162,197,0.822,28,110,138,265,43,3,97,106
1455,1,2005,22,1,1,82,73,2177,172,488,0.352,94,265,0.355,78,223,0.35,0.449,49,67,0.731,23,190,213,398,82,3,119,205
1455,2,2006,23,1,1,74,38,2155,215,538,0.4,100,278,0.36,115,260,0.442,0.493,117,143,0.818,28,192,220,373,70,3,117,152
1455,3,2007,24,1,1,78,30,1906,197,483,0.408,88,245,0.359,109,238,0.458,0.499,76,101,0.752,23,146,169,310,69,6,105,150
1455,4,2008,25,1,1,66,18,1490,133,344,0.387,54,155,0.348,79,189,0.418,0.465,65,80,0.813,19,97,116,263,48,2,71,92
1455,5,2009,26,1,1,79,78,2906,287,681,0.421,127,325,0.391,160,356,0.449,0.515,179,209,0.856,45,201,246,566,72,7,221,126
1455,6,2010,27,1,1,67,59,2072,168,451,0.373,90,258,0.349,78,193,0.404,0.472,68,95,0.716,28,150,178,378,59,3,110,83
1455,7,2011,28,1,1,51,5,774,49,129,0.38,13,52,0.25,36,77,0.468,0.43,14,25,0.56,9,43,52,118,16,2,61,30
1455,8,2012,29,1,1,63,9,1226,85,203,0.419,50,119,0.42,35,84,0.417,0.542,17,21,0.81,14,88,102,151,35,9,81,71
1455,9,2013,30,1,1,46,9,820,47,123,0.382,33,91,0.363,14,32,0.438,0.516,6,13,0.462,11,57,68,133,20,1,40,56
1460,1,1981,22,1,1,40,-1,458,33,101,0.327,0,1,0,33,100,0.33,0.327,5,9,0.556,8,27,35,54,18,2,37,54
1460,2,1982,23,1,1,79,9,1056,121,268,0.451,3,11,0.273,118,257,0.459,0.457,27,37,0.73,14,70,84,157,20,4,72,143
1460,3,1983,24,1,1,82,24,1433,163,360,0.453,0,13,0,163,347,0.47,0.453,43,54,0.796,38,69,107,200,66,5,96,203
1471,1,2012,24,1,1,9,1,180,19,48,0.396,1,8,0.125,18,40,0.45,0.406,28,36,0.778,2,17,19,18,11,2,20,19
1484,1,1997,22,1,1,65,2,684,74,175,0.423,23,55,0.418,51,120,0.425,0.489,42,51,0.824,16,47,63,138,20,0,63,92
1484,2,1998,23,1,1,76,9,1664,268,584,0.459,81,195,0.415,187,389,0.481,0.528,74,86,0.86,32,128,160,262,63,4,98,145
1484,3,1999,24,1,1,40,40,1269,114,314,0.363,49,131,0.374,65,183,0.355,0.441,38,46,0.826,32,82,114,219,37,2,83,98
1484,4,2000,25,1,1,56,27,1532,173,363,0.477,60,149,0.403,113,214,0.528,0.559,75,85,0.882,34,87,121,272,37,3,102,122
1484,5,2001,26,1,1,70,70,2387,386,792,0.487,89,219,0.406,297,573,0.518,0.544,231,258,0.895,46,177,223,509,72,5,205,158
1484,6,2002,27,1,1,82,82,2837,525,1088,0.483,156,343,0.455,369,745,0.495,0.554,260,293,0.887,50,204,254,634,53,4,229,164
1484,7,2003,28,1,1,82,82,2711,518,1114,0.465,111,269,0.413,407,845,0.482,0.515,308,339,0.909,63,171,234,598,85,6,192,134
1484,8,2004,29,1,1,78,78,2612,397,845,0.47,104,257,0.405,293,588,0.498,0.531,230,251,0.916,59,173,232,687,67,8,209,139
1484,9,2005,30,1,1,75,75,2573,430,857,0.502,94,218,0.431,336,639,0.526,0.557,211,238,0.887,57,192,249,861,74,6,245,136
1484,10,2006,31,1,1,79,79,2796,541,1056,0.512,150,342,0.439,391,714,0.548,0.583,257,279,0.921,47,286,333,826,61,12,276,120
1484,11,2007,32,1,1,76,76,2682,517,971,0.532,156,343,0.455,361,628,0.575,0.613,222,247,0.899,30,239,269,884,57,6,287,117
1484,12,2008,33,1,1,81,81,2780,485,962,0.504,179,381,0.47,306,581,0.527,0.597,222,245,0.906,28,254,282,898,53,5,295,113
1484,13,2009,34,1,1,74,74,2484,428,851,0.503,108,246,0.439,320,605,0.529,0.566,196,210,0.933,19,204,223,717,55,10,248,108
1484,14,2010,35,1,1,81,81,2660,499,985,0.507,124,291,0.426,375,694,0.54,0.57,211,225,0.938,34,234,268,892,42,12,295,108
1484,15,2011,36,1,1,75,75,2497,399,811,0.492,81,205,0.395,318,606,0.525,0.542,227,249,0.912,40,220,260,855,48,4,265,87
1484,16,2012,37,1,1,62,62,1961,295,555,0.532,55,141,0.39,240,414,0.58,0.581,127,142,0.894,26,160,186,664,38,8,229,53
1484,17,2013,38,1,1,50,50,1627,236,475,0.497,57,130,0.438,179,345,0.519,0.557,107,116,0.922,26,116,142,333,30,5,126,70
1484,18,2014,39,1,1,15,10,313,36,94,0.383,8,24,0.333,28,70,0.4,0.426,22,24,0.917,4,25,29,86,7,2,31,18
1496,1,2009,23,1,1,13,5,171,24,54,0.444,0,3,0,24,51,0.471,0.444,5,14,0.357,6,18,24,13,9,2,15,24
1498,1,2005,22,1,1,79,21,1612,286,628,0.455,44,141,0.312,242,487,0.497,0.49,73,107,0.682,52,141,193,237,78,3,117,199
1498,2,2006,23,1,1,62,33,1784,347,719,0.483,70,165,0.424,277,554,0.5,0.531,141,181,0.779,39,141,180,302,70,9,148,174
1498,3,2007,24,1,1,77,77,2331,376,875,0.43,65,194,0.335,311,681,0.457,0.467,183,221,0.828,50,186,236,330,73,5,184,225
1498,4,2008,25,1,1,69,62,1961,283,603,0.469,64,154,0.416,219,449,0.488,0.522,125,151,0.828,28,215,243,383,63,4,141,167
1498,5,2009,26,1,1,42,42,1309,267,531,0.503,82,181,0.453,185,350,0.529,0.58,86,97,0.887,20,125,145,226,51,3,83,123
1498,6,2010,27,1,1,65,64,1860,317,706,0.449,86,226,0.381,231,480,0.481,0.51,98,116,0.845,26,168,194,353,48,2,139,147
1498,7,2011,28,1,1,76,76,2319,374,838,0.446,119,297,0.401,255,541,0.471,0.517,130,162,0.802,37,189,226,456,75,3,194,209
1498,8,2012,29,1,1,57,57,1706,259,606,0.427,87,231,0.377,172,375,0.459,0.499,71,88,0.807,29,152,181,325,38,5,135,130
1498,9,2013,30,1,1,56,56,1977,306,780,0.392,121,355,0.341,185,425,0.435,0.47,89,102,0.873,23,186,209,413,71,6,154,161
1498,10,2014,31,1,1,68,68,2179,294,747,0.394,136,391,0.348,158,356,0.444,0.485,96,112,0.857,29,202,231,476,52,5,166,146
1498,11,2015,32,1,1,10,10,255,24,71,0.338,16,46,0.348,8,25,0.32,0.451,3,4,0.75,4,19,23,39,6,1,14,22
1518,1,1981,22,1,1,27,-1,493,65,149,0.436,0,1,0,65,148,0.439,0.436,35,59,0.593,13,36,49,80,28,2,63,52
1518,1,1981,22,1,1,40,-1,616,107,210,0.51,0,3,0,107,207,0.517,0.51,36,67,0.537,24,37,61,69,32,1,53,89
1518,1,1981,22,1,1,67,-1,1109,172,359,0.479,0,4,0,172,355,0.485,0.479,71,126,0.563,37,73,110,149,60,3,116,141
1553,1,2012,19,1,1,51,51,1558,350,747,0.469,73,183,0.399,277,564,0.491,0.517,171,196,0.872,44,147,191,275,54,20,160,110
1553,2,2013,20,1,1,59,59,2048,484,1070,0.452,109,279,0.391,375,791,0.474,0.503,248,290,0.855,34,182,216,350,89,21,191,146
1553,3,2014,21,1,1,71,71,2496,532,1237,0.43,123,344,0.358,409,893,0.458,0.48,291,338,0.861,52,207,259,433,108,23,190,163
1553,4,2015,22,1,1,8,8,307,59,129,0.457,18,44,0.409,41,85,0.482,0.527,43,49,0.878,5,19,24,40,11,2,12,14
1556,1,1992,24,1,1,52,21,1280,160,355,0.451,59,136,0.434,101,219,0.461,0.534,107,128,0.836,27,71,98,194,33,1,92,79
1556,2,1993,25,1,1,70,23,1769,221,478,0.462,54,144,0.375,167,334,0.5,0.519,114,149,0.765,31,109,140,328,49,6,129,101
1560,1,2005,23,1,1,62,5,809,85,198,0.429,3,9,0.333,82,189,0.434,0.437,47,67,0.701,19,65,84,103,39,7,58,140
1560,2,2006,24,1,1,73,66,978,116,264,0.439,4,10,0.4,112,254,0.441,0.447,24,33,0.727,31,65,96,74,24,7,23,147
1560,3,2007,25,1,1,53,18,539,64,143,0.448,5,16,0.313,59,127,0.465,0.465,24,35,0.686,15,36,51,45,24,4,31,62
1560,4,2008,26,1,1,75,20,1437,149,378,0.394,35,107,0.327,114,271,0.421,0.44,85,117,0.726,38,80,118,160,45,7,75,166
1561,1,1997,21,1,1,76,74,3045,625,1504,0.416,155,455,0.341,470,1049,0.448,0.467,382,544,0.702,115,197,312,567,157,24,337,233
1561,9,2005,29,1,1,75,75,3174,771,1818,0.424,104,338,0.308,667,1480,0.451,0.453,656,786,0.835,51,248,299,596,180,9,344,140
1561,10,2006,30,1,1,72,72,3103,815,1822,0.447,72,223,0.323,743,1599,0.465,0.467,675,829,0.814,44,188,232,532,140,10,248,121
1561,11,2007,31,1,1,15,15,640,151,366,0.413,12,53,0.226,139,313,0.444,0.429,154,174,0.885,7,34,41,109,33,1,66,21
1561,13,2009,33,1,1,54,50,1970,330,794,0.416,26,91,0.286,304,703,0.432,0.432,253,322,0.786,27,138,165,263,85,5,136,83
1561,13,2009,33,1,1,57,53,2093,348,834,0.417,28,99,0.283,320,735,0.435,0.434,271,347,0.781,30,143,173,283,88,6,146,86
1568,1,2012,21,1,1,64,0,779,88,220,0.4,12,42,0.286,76,178,0.427,0.427,42,59,0.712,12,80,92,131,28,2,48,50
1568,2,2013,22,1,1,7,2,141,16,40,0.4,4,13,0.308,12,27,0.444,0.45,1,2,0.5,3,13,16,23,6,0,8,10
1568,2,2013,22,1,1,20,1,268,41,84,0.488,14,35,0.4,27,49,0.551,0.571,8,14,0.571,0,24,24,44,9,0,24,28
1568,2,2013,22,1,1,31,3,416,58,126,0.46,18,49,0.367,40,77,0.519,0.532,9,16,0.563,3,37,40,68,15,0,34,39
1568,3,2014,23,1,1,73,11,1490,209,501,0.417,62,184,0.337,147,317,0.464,0.479,64,74,0.865,21,139,160,271,50,2,89,100
1575,1,1981,23,1,1,82,-1,1469,272,532,0.511,12,51,0.235,260,481,0.541,0.523,107,119,0.899,44,88,132,160,76,5,95,120
1575,2,1982,24,1,1,82,72,2845,486,945,0.514,39,100,0.39,447,845,0.529,0.535,152,169,0.899,78,183,261,384,143,9,125,185
1575,3,1983,25,1,1,82,9,1836,328,634,0.517,23,76,0.303,305,558,0.547,0.535,129,148,0.872,41,124,165,278,64,8,90,130
1575,4,1984,26,1,1,82,45,2402,357,713,0.501,23,70,0.329,334,643,0.519,0.517,95,114,0.833,49,137,186,353,123,6,116,181
1575,5,1985,27,1,1,65,52,2018,282,582,0.485,23,85,0.271,259,497,0.521,0.504,127,140,0.907,33,146,179,380,85,3,111,128
1575,6,1986,28,1,1,82,79,2426,286,592,0.483,58,141,0.411,228,451,0.506,0.532,73,90,0.811,41,137,178,446,81,11,117,201
1575,7,1987,29,1,1,76,0,1250,164,341,0.481,14,46,0.304,150,295,0.508,0.501,34,41,0.829,25,88,113,197,59,7,58,136
1604,1,1997,19,1,1,67,64,2324,355,871,0.408,102,288,0.354,253,583,0.434,0.466,245,337,0.727,54,130,184,522,67,19,210,159
1604,2,1998,20,1,1,82,81,3112,513,1237,0.415,95,304,0.313,418,933,0.448,0.453,329,450,0.731,58,172,230,704,104,7,256,222
1604,3,1999,21,1,1,18,18,661,124,304,0.408,8,39,0.205,116,265,0.438,0.421,63,87,0.724,17,45,62,167,29,5,55,44
1604,3,1999,21,1,1,31,31,1234,254,579,0.439,58,158,0.367,196,421,0.466,0.489,159,191,0.832,20,60,80,270,30,3,109,81
1604,3,1999,21,1,1,49,49,1895,378,883,0.428,66,197,0.335,312,686,0.455,0.465,222,278,0.799,37,105,142,437,59,8,164,125
1604,4,2000,22,1,1,74,74,2881,569,1317,0.432,66,233,0.283,503,1084,0.464,0.457,436,536,0.813,61,179,240,622,112,15,270,195
1604,5,2001,23,1,1,67,67,2557,563,1277,0.441,110,335,0.328,453,942,0.481,0.484,362,458,0.79,53,152,205,506,79,5,197,150
1604,6,2002,24,1,1,82,80,3187,625,1413,0.442,71,248,0.286,554,1165,0.476,0.467,353,452,0.781,75,191,266,666,77,13,284,186
1604,7,2003,25,1,1,81,81,3240,671,1530,0.439,89,296,0.301,582,1234,0.472,0.468,375,467,0.803,53,210,263,654,108,20,263,200
1604,8,2004,26,1,1,34,34,1415,262,606,0.432,37,118,0.314,225,488,0.461,0.463,147,185,0.795,19,98,117,281,64,5,97,74
1604,8,2004,26,1,1,47,47,1839,336,780,0.431,50,156,0.321,286,624,0.458,0.463,209,251,0.833,39,107,146,438,65,4,152,98
1604,8,2004,26,1,1,81,81,3254,598,1386,0.431,87,274,0.318,511,1112,0.46,0.463,356,436,0.817,58,205,263,719,129,9,249,172
1604,9,2005,27,1,1,82,82,3281,604,1308,0.462,115,325,0.354,489,983,0.497,0.506,458,549,0.834,50,198,248,668,122,6,233,186
1604,10,2006,28,1,1,60,60,2193,349,774,0.451,33,104,0.317,316,670,0.472,0.472,246,326,0.755,25,150,175,382,63,4,157,143
1604,11,2007,29,1,1,74,74,2748,395,952,0.415,123,345,0.357,272,607,0.448,0.48,297,386,0.769,36,177,213,403,71,10,179,185
1604,12,2008,30,1,1,24,19,805,111,265,0.419,28,74,0.378,83,191,0.435,0.472,83,116,0.716,17,42,59,113,21,2,48,57
1604,13,2009,31,1,1,23,4,414,38,111,0.342,6,25,0.24,32,86,0.372,0.369,6,13,0.462,2,26,28,75,10,3,37,34
1613,1,2013,21,1,1,48,3,702,56,151,0.371,23,73,0.315,33,78,0.423,0.447,8,14,0.571,4,38,42,143,22,4,57,48
1613,2,2014,22,1,1,54,45,1564,170,419,0.406,71,178,0.399,99,241,0.411,0.49,19,36,0.528,15,140,155,477,48,4,150,76
1624,2,1991,24,1,1,74,26,1334,214,507,0.422,27,88,0.307,187,419,0.446,0.449,68,100,0.68,53,78,131,65,37,31,49,104
1629,1,2005,21,1,1,45,0,455,45,117,0.385,5,25,0.2,40,92,0.435,0.406,36,55,0.655,29,29,58,22,16,3,24,35
1642,1,1993,22,1,1,82,4,1503,171,375,0.456,43,110,0.391,128,265,0.483,0.513,39,68,0.574,26,92,118,273,59,7,85,148
1642,2,1994,23,1,1,82,6,1472,167,402,0.415,41,119,0.345,126,283,0.445,0.466,58,84,0.69,26,75,101,215,46,4,97,114
1642,3,1995,24,1,1,82,50,1744,172,408,0.422,72,177,0.407,100,231,0.433,0.51,58,83,0.699,21,61,82,276,51,4,106,123
1642,4,1996,25,1,1,82,20,1705,153,364,0.42,75,189,0.397,78,175,0.446,0.523,41,68,0.603,21,69,90,302,64,10,89,144
1642,5,1997,26,1,1,80,38,1952,149,370,0.403,83,221,0.376,66,149,0.443,0.515,29,46,0.63,29,105,134,329,60,8,90,159
1642,6,1998,27,1,1,79,32,1835,131,349,0.375,63,180,0.35,68,169,0.402,0.466,38,51,0.745,19,95,114,349,65,10,113,164
1642,7,1999,28,1,1,9,0,126,7,19,0.368,2,10,0.2,5,9,0.556,0.421,4,5,0.8,0,3,3,23,7,0,11,13
1645,8,1996,30,1,1,75,57,2467,410,1052,0.39,146,460,0.317,264,592,0.446,0.459,251,332,0.756,39,190,229,330,96,12,215,182
1645,13,2001,35,1,1,19,0,285,31,98,0.316,13,47,0.277,18,51,0.353,0.383,6,10,0.6,1,28,29,20,9,3,17,31
1645,13,2001,35,1,1,24,6,375,42,125,0.336,21,64,0.328,21,61,0.344,0.42,15,22,0.682,3,34,37,29,12,0,18,33
1645,13,2001,35,1,1,43,6,660,73,223,0.327,34,111,0.306,39,112,0.348,0.404,21,32,0.656,4,62,66,49,21,3,35,64
1652,1,2014,22,1,1,45,10,897,113,300,0.377,22,59,0.373,91,241,0.378,0.413,32,43,0.744,18,61,79,120,22,9,39,69
1653,1,1991,22,1,1,64,55,2145,294,724,0.406,72,197,0.365,222,527,0.421,0.456,255,331,0.77,54,124,178,253,81,11,159,169
1653,2,1993,24,1,1,49,9,787,129,309,0.417,29,84,0.345,100,225,0.444,0.464,54,82,0.659,20,33,53,72,21,3,51,59
1654,1,2010,22,1,1,26,2,363,52,133,0.391,5,24,0.208,47,109,0.431,0.41,25,33,0.758,10,28,38,81,13,2,28,33
1654,1,2010,22,1,1,55,0,906,102,235,0.434,17,47,0.362,85,188,0.452,0.47,27,39,0.692,11,80,91,185,27,8,57,82
1654,1,2010,22,1,1,81,2,1269,154,368,0.418,22,71,0.31,132,297,0.444,0.448,52,72,0.722,21,108,129,266,40,10,85,115
1654,2,2011,23,1,1,82,0,1200,134,333,0.402,37,96,0.385,97,237,0.409,0.458,43,59,0.729,25,96,121,238,35,6,77,96
1654,3,2012,24,1,1,9,0,137,14,39,0.359,6,17,0.353,8,22,0.364,0.436,4,4,1,3,10,13,22,5,0,11,13
1654,4,2013,25,1,1,37,0,391,36,115,0.313,15,46,0.326,21,69,0.304,0.378,17,21,0.81,5,13,18,73,10,0,31,19
1654,4,2013,25,1,1,64,0,963,106,281,0.377,34,96,0.354,72,185,0.389,0.438,45,62,0.726,9,37,46,182,22,1,79,55
1654,5,2014,26,1,1,8,0,112,11,29,0.379,4,12,0.333,7,17,0.412,0.448,4,8,0.5,2,13,15,12,4,2,12,4
1654,5,2014,26,1,1,23,0,215,21,72,0.292,8,25,0.32,13,47,0.277,0.347,2,3,0.667,7,17,24,40,5,1,17,13
1654,5,2014,26,1,1,31,0,327,32,101,0.317,12,37,0.324,20,64,0.313,0.376,6,11,0.545,9,30,39,52,9,3,29,17
1686,1,1980,26,1,1,31,-1,516,66,171,0.386,2,7,0.286,64,164,0.39,0.392,37,53,0.698,20,29,49,65,21,5,43,45
1686,1,1980,26,1,1,36,-1,1012,162,356,0.455,3,14,0.214,159,342,0.465,0.459,95,119,0.798,12,38,50,162,25,14,88,78
1686,1,1980,26,1,1,67,-1,1528,228,527,0.433,5,21,0.238,223,506,0.441,0.437,132,172,0.767,32,67,99,227,46,19,131,123
1686,2,1981,27,1,1,54,-1,680,78,202,0.386,1,8,0.125,77,194,0.397,0.389,48,59,0.814,10,38,48,84,20,9,79,62
1686,3,1982,28,1,1,20,17,349,52,125,0.416,1,5,0.2,51,120,0.425,0.42,29,36,0.806,6,11,17,39,8,3,22,44
1706,12,2006,33,1,1,14,0,121,3,12,0.25,0,2,0,3,10,0.3,0.25,1,2,0.5,3,17,20,11,5,0,2,7
1711,1,2004,24,1,1,33,0,391,27,82,0.329,1,10,0.1,26,72,0.361,0.335,33,43,0.767,5,29,34,59,16,1,29,39
1711,2,2005,25,1,1,53,47,1382,143,408,0.35,18,72,0.25,125,336,0.372,0.373,112,146,0.767,20,93,113,236,63,12,99,138
1711,3,2006,26,1,1,66,32,1232,120,340,0.353,24,82,0.293,96,258,0.372,0.388,106,133,0.797,11,67,78,151,42,9,76,131
1711,4,2007,27,1,1,22,7,339,32,83,0.386,7,22,0.318,25,61,0.41,0.428,22,25,0.88,1,21,22,45,7,2,23,30
1711,4,2007,27,1,1,26,2,379,41,105,0.39,9,23,0.391,32,82,0.39,0.433,47,53,0.887,3,18,21,45,17,3,23,21
1711,4,2007,27,1,1,48,9,718,73,188,0.388,16,45,0.356,57,143,0.399,0.431,69,78,0.885,4,39,43,90,24,5,46,51
1714,1,1987,22,1,1,71,50,1972,143,301,0.475,0,7,0,143,294,0.486,0.475,87,141,0.617,101,230,331,583,125,45,155,238
1714,2,1988,23,1,1,82,82,2453,235,496,0.474,9,24,0.375,226,472,0.479,0.483,145,205,0.707,117,221,338,702,169,47,189,238
1714,3,1989,24,1,1,75,74,2341,199,485,0.41,15,70,0.214,184,415,0.443,0.426,119,189,0.63,143,245,388,696,156,42,211,236
1714,6,1992,27,1,1,72,30,1652,177,405,0.437,27,98,0.276,150,307,0.489,0.47,54,84,0.643,92,160,252,359,129,29,112,218
1714,7,1993,28,1,1,73,25,1977,213,459,0.464,25,65,0.385,188,394,0.477,0.491,95,134,0.709,84,222,306,384,173,33,139,240
1714,8,1994,29,1,1,73,8,1887,177,396,0.447,52,133,0.391,125,263,0.475,0.513,31,55,0.564,50,233,283,387,216,22,126,201
1714,9,1995,30,1,1,80,18,2070,166,397,0.418,53,155,0.342,113,242,0.467,0.485,34,58,0.586,65,237,302,421,165,53,126,275
1714,10,1996,31,1,1,55,14,1261,100,238,0.42,46,121,0.38,54,117,0.462,0.517,29,41,0.707,41,169,210,197,95,18,75,143
1714,11,1997,32,1,1,37,2,798,61,149,0.409,28,84,0.333,33,65,0.508,0.503,19,29,0.655,15,103,118,140,58,6,32,78
1725,1,2001,22,1,1,22,0,287,62,120,0.517,2,6,0.333,60,114,0.526,0.525,24,34,0.706,20,11,31,22,13,1,24,32
1725,1,2001,22,1,1,33,0,308,47,96,0.49,0,6,0,47,90,0.522,0.49,18,24,0.75,20,28,48,16,12,3,23,48
1725,1,2001,22,1,1,55,0,595,109,216,0.505,2,12,0.167,107,204,0.525,0.509,42,58,0.724,40,39,79,38,25,4,47,80
1739,1,2014,25,1,1,31,1,292,30,86,0.349,5,20,0.25,25,66,0.379,0.378,8,12,0.667,5,22,27,63,4,1,31,31
1760,1,2006,22,1,1,19,0,118,6,18,0.333,0,0,-1,6,18,0.333,0.333,4,4,1,0,14,14,24,4,1,11,13
1761,1,2006,18,1,1,23,0,203,28,76,0.368,5,20,0.25,23,56,0.411,0.401,18,24,0.75,18,20,38,16,7,2,9,20
1773,1,2000,23,1,1,82,36,2093,339,755,0.449,10,49,0.204,329,706,0.466,0.456,226,292,0.774,85,195,280,476,84,17,166,194
1773,2,2001,24,1,1,82,82,2848,452,999,0.452,17,64,0.266,435,935,0.465,0.461,375,450,0.833,94,266,360,657,119,28,265,229
1773,3,2002,25,1,1,81,81,3023,474,1045,0.454,22,87,0.253,452,958,0.472,0.464,365,447,0.817,108,271,379,882,126,34,245,228
1773,4,2003,26,1,1,80,80,2913,377,928,0.406,23,108,0.213,354,820,0.432,0.419,311,391,0.795,84,232,316,537,99,11,206,203
1773,5,2004,27,1,1,82,82,2838,430,941,0.457,12,65,0.185,418,876,0.477,0.463,342,411,0.832,127,239,366,501,142,25,215,194
1773,6,2005,28,1,1,82,82,2852,427,895,0.477,6,39,0.154,421,856,0.492,0.48,253,302,0.838,100,238,338,569,121,8,220,204
1773,7,2006,29,1,1,82,82,2937,404,872,0.463,5,27,0.185,399,845,0.472,0.466,313,424,0.738,92,259,351,674,106,18,256,213
1773,8,2007,30,1,1,23,23,822,117,248,0.472,4,16,0.25,113,232,0.487,0.48,62,85,0.729,25,79,104,209,37,4,70,58
1773,8,2007,30,1,1,57,56,2144,307,661,0.464,1,19,0.053,306,642,0.477,0.465,160,198,0.808,72,176,248,416,73,6,152,126
1773,8,2007,30,1,1,80,79,2966,424,909,0.466,5,35,0.143,419,874,0.479,0.469,222,283,0.784,97,255,352,625,110,10,222,184
1773,9,2008,31,1,1,82,82,3016,569,1156,0.492,3,34,0.088,566,1122,0.504,0.494,257,333,0.772,95,229,324,565,105,6,206,181
1773,10,2009,32,1,1,82,82,2976,492,1041,0.473,15,53,0.283,477,988,0.483,0.48,338,409,0.826,123,245,368,534,109,14,199,196
1773,11,2010,33,1,1,82,66,2500,404,908,0.445,16,80,0.2,388,828,0.469,0.454,322,392,0.821,81,185,266,445,93,9,173,169
1773,12,2011,34,1,1,81,81,2650,388,844,0.46,4,37,0.108,384,807,0.476,0.462,249,292,0.853,97,205,302,566,114,12,197,171
1773,14,2013,36,1,1,82,11,2151,303,632,0.479,17,64,0.266,286,568,0.504,0.493,163,194,0.84,60,178,238,484,73,11,172,159
1773,16,2015,38,1,1,9,0,116,13,24,0.542,0,1,0,13,23,0.565,0.542,7,10,0.7,3,11,14,26,3,0,8,14
1782,1,2011,22,1,1,64,0,783,135,328,0.412,47,133,0.353,88,195,0.451,0.483,36,47,0.766,19,32,51,109,27,1,62,63
1782,2,2012,23,1,1,16,3,261,63,130,0.485,24,56,0.429,39,74,0.527,0.577,15,15,1,4,24,28,39,10,1,26,14
1782,3,2013,24,1,1,58,2,656,113,241,0.469,52,130,0.4,61,111,0.55,0.577,16,19,0.842,9,41,50,62,26,4,39,55
1782,4,2014,25,1,1,81,2,1527,309,666,0.464,135,318,0.425,174,348,0.5,0.565,73,82,0.89,34,135,169,149,68,9,63,114
1788,1,1986,25,1,1,76,2,1131,167,347,0.481,10,37,0.27,157,310,0.506,0.496,73,93,0.785,43,88,131,269,65,1,108,165
1788,2,1987,26,1,1,11,0,122,13,42,0.31,0,5,0,13,37,0.351,0.31,1,4,0.25,1,9,10,13,6,1,12,8
1788,2,1987,26,1,1,63,52,1478,205,440,0.466,11,34,0.324,194,406,0.478,0.478,61,86,0.709,28,102,130,335,66,6,145,166
1788,2,1987,26,1,1,74,52,1600,218,482,0.452,11,39,0.282,207,443,0.467,0.464,62,90,0.689,29,111,140,348,72,7,157,174
1788,3,1988,27,1,1,11,0,202,25,48,0.521,1,5,0.2,24,43,0.558,0.531,14,23,0.609,8,13,21,38,15,0,16,26
1788,3,1988,27,1,1,61,6,868,83,173,0.48,3,11,0.273,80,162,0.494,0.488,27,32,0.844,22,53,75,190,44,3,77,107
1788,3,1988,27,1,1,72,6,1070,108,221,0.489,4,16,0.25,104,205,0.507,0.498,41,55,0.745,30,66,96,228,59,3,93,133
1789,3,1995,23,1,1,45,16,871,123,305,0.403,14,49,0.286,109,256,0.426,0.426,69,95,0.726,38,79,117,69,15,6,77,85
1800,1,1999,23,1,1,49,37,1456,172,405,0.425,53,148,0.358,119,257,0.463,0.49,90,110,0.818,22,89,111,121,44,23,79,98
1819,1,2012,22,1,1,38,0,331,43,113,0.381,17,45,0.378,26,68,0.382,0.456,7,7,1,4,29,33,34,11,3,21,33
1824,1,1981,23,1,1,71,-1,1406,212,478,0.444,4,27,0.148,208,451,0.461,0.448,69,92,0.75,43,125,168,228,61,17,108,179
1824,2,1983,25,1,1,37,3,642,81,190,0.426,6,23,0.261,75,167,0.449,0.442,42,56,0.75,15,40,55,73,22,1,46,72
1831,1,2012,21,1,1,19,0,169,18,42,0.429,4,9,0.444,14,33,0.424,0.476,6,9,0.667,2,14,16,21,2,0,19,16
1831,2,2013,22,1,1,48,17,683,73,188,0.388,24,66,0.364,49,122,0.402,0.452,24,37,0.649,24,33,57,76,21,2,45,58
1831,3,2014,23,1,1,12,0,193,29,67,0.433,10,24,0.417,19,43,0.442,0.507,15,21,0.714,3,10,13,31,8,0,19,21
1831,3,2014,23,1,1,27,0,313,39,96,0.406,12,38,0.316,27,58,0.466,0.469,17,26,0.654,7,19,26,44,13,0,27,33
1840,1,1995,23,1,1,41,6,395,50,129,0.388,9,25,0.36,41,104,0.394,0.422,58,85,0.682,21,37,58,18,11,15,27,45
1844,1,1986,27,1,1,12,0,160,21,53,0.396,2,7,0.286,19,46,0.413,0.415,11,15,0.733,9,16,25,19,6,3,18,26
1844,1,1986,27,1,1,60,0,852,95,239,0.397,5,25,0.2,90,214,0.421,0.408,54,74,0.73,25,65,90,89,50,12,61,106
1844,1,1986,27,1,1,72,0,1012,116,292,0.397,7,32,0.219,109,260,0.419,0.409,65,89,0.73,34,81,115,108,56,15,79,132
1844,2,1987,28,1,1,64,0,698,91,207,0.44,1,14,0.071,90,193,0.466,0.442,49,69,0.71,29,66,95,90,42,3,57,96
1862,1,1992,23,1,1,50,0,478,76,183,0.415,5,26,0.192,71,157,0.452,0.429,46,61,0.754,21,33,54,92,30,7,50,52
1862,2,1993,24,1,1,79,78,2437,438,936,0.468,31,119,0.261,407,817,0.498,0.485,231,296,0.78,95,189,284,603,174,7,207,177
1862,3,1994,25,1,1,82,76,2533,477,1019,0.468,69,168,0.411,408,851,0.479,0.502,234,288,0.813,91,170,261,546,197,12,206,189
1862,4,1995,26,1,1,75,32,2158,338,814,0.415,90,240,0.375,248,574,0.432,0.471,211,267,0.79,48,166,214,482,113,12,194,139
1862,5,1996,27,1,1,9,0,193,24,66,0.364,6,23,0.261,18,43,0.419,0.409,8,12,0.667,5,9,14,35,6,0,12,16
1862,5,1996,27,1,1,64,14,1480,220,521,0.422,39,122,0.32,181,399,0.454,0.46,106,131,0.809,21,134,155,292,129,9,120,124
1862,5,1996,27,1,1,73,14,1673,244,587,0.416,45,145,0.31,199,442,0.45,0.454,114,143,0.797,26,143,169,327,135,9,132,140
1862,6,1997,28,1,1,12,0,114,15,33,0.455,4,10,0.4,11,23,0.478,0.515,11,12,0.917,1,10,11,24,9,2,11,9
1862,7,1998,29,1,1,82,1,1395,177,419,0.422,28,91,0.308,149,328,0.454,0.456,125,156,0.801,39,117,156,219,103,13,104,173
1862,8,1999,30,1,1,15,8,401,45,114,0.395,8,22,0.364,37,92,0.402,0.43,21,26,0.808,3,32,35,66,22,2,29,35
1862,9,2000,31,1,1,40,15,693,79,205,0.385,16,42,0.381,63,163,0.387,0.424,51,80,0.638,15,62,77,108,47,5,58,67
1864,2,1981,32,1,1,76,-1,2014,528,1074,0.492,4,17,0.235,524,1057,0.496,0.493,206,215,0.958,33,54,87,222,111,6,129,209
1864,3,1982,33,1,1,64,0,1204,277,648,0.427,1,16,0.063,276,632,0.437,0.428,100,110,0.909,20,41,61,163,43,1,82,142
1864,4,1983,34,1,1,64,0,1423,337,754,0.447,4,14,0.286,333,740,0.45,0.45,138,150,0.92,34,40,74,158,59,4,89,163
1873,1,2004,24,1,1,82,18,2021,389,915,0.425,67,229,0.293,322,686,0.469,0.462,168,235,0.715,45,159,204,205,81,28,149,158
1873,5,2008,28,1,1,19,2,347,57,139,0.41,6,27,0.222,51,112,0.455,0.432,22,37,0.595,13,23,36,64,13,1,31,19
1873,5,2008,28,1,1,23,17,527,97,228,0.425,14,36,0.389,83,192,0.432,0.456,46,61,0.754,10,37,47,80,25,3,53,31
1873,5,2008,28,1,1,42,19,874,154,367,0.42,20,63,0.317,134,304,0.441,0.447,68,98,0.694,23,60,83,144,38,4,84,50
1876,1,2014,24,1,1,51,0,373,56,129,0.434,5,12,0.417,51,117,0.436,0.453,23,39,0.59,13,31,44,49,19,1,34,46
1924,1,1989,23,1,1,26,0,157,20,46,0.435,8,17,0.471,12,29,0.414,0.522,6,9,0.667,3,14,17,24,7,0,6,12
1924,2,1990,24,1,1,78,5,1664,192,432,0.444,73,144,0.507,119,288,0.413,0.529,63,73,0.863,12,86,98,248,45,7,74,59
1924,3,1991,25,1,1,57,4,905,99,223,0.444,28,62,0.452,71,161,0.441,0.507,45,53,0.849,5,32,37,131,29,4,40,52
1924,4,1992,26,1,1,48,20,847,121,237,0.511,32,74,0.432,89,163,0.546,0.578,45,54,0.833,14,64,78,110,27,10,31,29
1924,6,1994,28,1,1,82,0,2036,287,577,0.497,52,124,0.419,235,453,0.519,0.542,83,97,0.856,26,105,131,210,75,3,57,97
1924,7,1995,29,1,1,82,0,1839,261,495,0.527,89,170,0.524,172,325,0.529,0.617,63,81,0.778,20,99,119,151,44,3,48,114
1924,8,1996,30,1,1,82,0,1919,244,482,0.506,122,237,0.515,122,245,0.498,0.633,78,84,0.929,25,85,110,192,63,2,42,109
1924,9,1997,31,1,1,82,0,1861,249,467,0.533,110,237,0.464,139,230,0.604,0.651,54,67,0.806,29,101,130,175,67,3,43,98
1924,10,1998,32,1,1,50,0,1119,137,302,0.454,57,130,0.438,80,172,0.465,0.548,45,49,0.918,14,63,77,96,26,5,27,71
1924,11,1999,33,1,1,44,0,734,68,174,0.391,25,80,0.313,43,94,0.457,0.463,31,35,0.886,6,38,44,49,23,3,22,28
1924,12,2000,34,1,1,32,0,268,32,74,0.432,16,31,0.516,16,43,0.372,0.541,9,11,0.818,3,16,19,12,4,0,7,14
1924,13,2001,35,1,1,55,1,650,67,159,0.421,33,77,0.429,34,82,0.415,0.525,14,15,0.933,6,29,35,57,16,1,21,30
1924,14,2002,36,1,1,65,0,775,102,217,0.47,26,66,0.394,76,151,0.503,0.53,39,40,0.975,6,54,60,63,13,1,24,49
1924,15,2003,37,1,1,75,0,952,110,256,0.43,49,124,0.395,61,132,0.462,0.525,30,34,0.882,12,48,60,70,27,3,35,49
1930,1,1995,21,1,1,79,79,2668,330,857,0.385,70,257,0.272,260,600,0.433,0.426,192,275,0.698,152,278,430,607,151,24,250,146
1930,2,1996,22,1,1,81,81,3034,493,1293,0.381,133,396,0.336,360,897,0.401,0.433,229,331,0.692,203,350,553,783,175,26,328,155
1930,3,1997,23,1,1,22,22,791,75,203,0.369,21,65,0.323,54,138,0.391,0.421,46,69,0.667,30,60,90,200,45,8,66,42
1930,3,1997,23,1,1,33,23,1173,138,326,0.423,40,100,0.4,98,226,0.434,0.485,66,96,0.688,34,125,159,296,79,12,76,72
1930,3,1997,23,1,1,55,45,1964,213,529,0.403,61,165,0.37,152,364,0.418,0.46,112,165,0.679,64,185,249,496,124,20,142,114
1930,4,1998,24,1,1,82,82,3118,357,859,0.416,73,233,0.313,284,626,0.454,0.458,167,209,0.799,108,402,510,745,162,26,261,142
1930,5,1999,25,1,1,50,50,2060,310,698,0.444,45,123,0.366,265,575,0.461,0.476,181,239,0.757,87,252,339,539,114,19,150,108
1930,6,2000,26,1,1,67,67,2616,350,855,0.409,56,166,0.337,294,689,0.427,0.442,203,245,0.829,96,387,483,678,134,28,226,148
1930,7,2001,27,1,1,77,76,3065,451,1097,0.411,69,232,0.297,382,865,0.442,0.443,328,403,0.814,91,403,494,753,166,23,286,171
1930,8,2002,28,1,1,82,82,3056,445,1138,0.391,117,364,0.321,328,774,0.424,0.442,201,247,0.814,130,465,595,808,175,20,286,136
1930,9,2003,29,1,1,80,80,2989,515,1244,0.414,126,370,0.341,389,874,0.445,0.465,339,403,0.841,110,394,504,711,179,25,296,127
1930,10,2004,30,1,1,67,66,2450,368,959,0.384,94,293,0.321,274,666,0.411,0.433,206,249,0.827,85,343,428,618,122,14,214,110
1930,11,2005,31,1,1,66,65,2435,340,855,0.398,129,358,0.36,211,497,0.425,0.473,142,192,0.74,94,394,488,545,123,9,167,110
1930,12,2006,32,1,1,80,80,2975,366,905,0.404,139,395,0.352,227,510,0.445,0.481,194,244,0.795,86,494,580,672,150,29,192,157
1930,13,2007,33,1,1,80,80,2933,369,908,0.406,124,361,0.343,245,547,0.448,0.475,179,230,0.778,135,520,655,736,127,23,213,146
1930,14,2008,34,1,1,29,29,1011,104,244,0.426,35,76,0.461,69,168,0.411,0.498,44,54,0.815,36,152,188,276,62,11,81,75
1930,14,2008,34,1,1,51,51,1895,201,549,0.366,84,236,0.356,117,313,0.374,0.443,91,111,0.82,58,354,412,530,74,15,185,90
1930,14,2008,34,1,1,80,80,2906,305,793,0.385,119,312,0.381,186,481,0.387,0.46,135,165,0.818,94,506,600,806,136,26,266,165
1930,15,2009,35,1,1,81,81,2886,257,618,0.416,131,323,0.406,126,295,0.427,0.522,86,105,0.819,85,415,500,702,160,39,185,168
1930,16,2010,36,1,1,80,80,2881,284,671,0.423,176,414,0.425,108,257,0.42,0.554,80,99,0.808,48,397,445,724,145,35,195,142
1930,17,2011,37,1,1,80,80,2653,215,596,0.361,133,391,0.34,82,205,0.4,0.472,67,77,0.87,35,316,351,655,134,29,179,119
1930,18,2012,38,1,1,48,48,1379,99,273,0.363,79,223,0.354,20,50,0.4,0.507,22,28,0.786,15,183,198,264,82,10,91,83
1966,1,2012,20,1,1,66,60,2129,319,769,0.415,105,276,0.38,214,493,0.434,0.483,104,137,0.759,33,178,211,251,49,10,171,154
1966,2,2013,21,1,1,75,75,2365,357,878,0.407,120,327,0.367,237,551,0.43,0.475,165,225,0.733,54,193,247,303,58,8,205,157
1966,3,2014,22,1,1,72,69,2400,461,1092,0.422,110,338,0.325,351,754,0.466,0.473,259,323,0.802,46,209,255,352,69,17,188,146
1966,4,2015,23,1,1,9,9,291,55,125,0.44,13,35,0.371,42,90,0.467,0.492,40,46,0.87,7,48,55,60,12,1,35,17
1972,1,1998,22,1,1,80,76,2483,261,592,0.441,0,7,0,261,585,0.446,0.441,201,251,0.801,67,186,253,656,196,18,194,271
1972,2,1999,23,1,1,39,38,1186,134,315,0.425,0,5,0,134,310,0.432,0.425,105,141,0.745,16,115,131,302,70,7,105,115
1972,3,2000,24,1,1,65,46,1754,230,558,0.412,2,10,0.2,228,548,0.416,0.414,140,184,0.761,38,155,193,458,107,21,157,185
1972,4,2001,25,1,1,47,43,1364,137,356,0.385,1,10,0.1,136,346,0.393,0.386,49,60,0.817,22,139,161,286,95,3,84,138
1972,4,2001,25,1,1,53,43,1457,139,371,0.375,1,10,0.1,138,361,0.382,0.376,54,66,0.818,23,145,168,311,101,4,91,155
1972,5,2002,26,1,1,53,11,1151,141,334,0.422,2,8,0.25,139,326,0.426,0.425,87,115,0.757,11,98,109,302,79,7,111,135
1972,6,2003,27,1,1,55,4,928,97,228,0.425,2,8,0.25,95,220,0.432,0.43,20,37,0.541,15,66,81,233,69,2,94,123
1972,7,2004,28,1,1,21,1,420,46,105,0.438,1,3,0.333,45,102,0.441,0.443,30,38,0.789,3,45,48,98,29,0,25,56
1972,7,2004,28,1,1,32,12,598,58,138,0.42,1,5,0.2,57,133,0.429,0.424,19,27,0.704,11,50,61,102,52,0,44,50
1972,7,2004,28,1,1,56,13,1037,105,246,0.427,2,8,0.25,103,238,0.433,0.431,49,65,0.754,14,98,112,204,84,1,72,107
1972,8,2005,29,1,1,66,61,1944,248,587,0.422,3,20,0.15,245,567,0.432,0.425,167,196,0.852,21,149,170,591,131,5,147,192
1972,9,2006,30,1,1,69,67,2351,308,772,0.399,3,13,0.231,305,759,0.402,0.401,252,314,0.803,35,188,223,610,157,4,164,202
1972,10,2007,31,1,1,45,25,1273,152,363,0.419,1,18,0.056,151,345,0.438,0.42,103,128,0.805,14,101,115,296,67,3,95,113
1972,11,2008,32,1,1,74,39,1674,138,342,0.404,0,6,0,138,336,0.411,0.404,62,71,0.873,15,127,142,328,100,11,71,160
1972,12,2009,33,1,1,74,0,938,66,189,0.349,0,6,0,66,183,0.361,0.349,48,64,0.75,13,75,88,190,68,4,66,98
2008,1,1980,24,1,1,24,-1,100,12,34,0.353,0,1,0,12,33,0.364,0.353,5,7,0.714,3,11,14,16,7,1,5,8
2045,1,2014,21,1,1,48,0,489,52,137,0.38,12,38,0.316,40,99,0.404,0.423,16,25,0.64,11,31,42,71,26,1,39,46
2045,2,2015,22,1,1,10,9,266,23,60,0.383,5,12,0.417,18,48,0.375,0.425,10,11,0.909,3,18,21,28,15,0,10,20
2058,1,2010,22,1,1,65,8,1318,201,390,0.515,34,83,0.41,167,307,0.544,0.559,106,140,0.757,42,82,124,203,48,2,82,89
2058,2,2011,23,1,1,80,31,2103,346,688,0.503,69,171,0.404,277,517,0.536,0.553,172,225,0.764,67,142,209,377,80,4,137,133
2058,3,2012,24,1,1,61,61,2124,374,767,0.488,73,200,0.365,301,567,0.531,0.535,178,216,0.824,54,173,227,401,82,6,149,94
2058,4,2013,25,1,1,73,71,2513,448,971,0.461,85,232,0.366,363,739,0.491,0.505,235,311,0.756,36,162,198,501,107,8,182,135
2058,5,2014,26,1,1,62,61,2222,347,806,0.431,72,202,0.356,275,604,0.455,0.475,324,406,0.798,40,175,215,543,100,10,200,113
2058,6,2015,27,1,1,7,7,246,35,80,0.438,6,16,0.375,29,64,0.453,0.475,35,46,0.761,5,14,19,55,9,0,19,9
2060,1,2008,23,1,1,56,6,865,95,237,0.401,7,34,0.206,88,203,0.433,0.416,38,48,0.792,12,45,57,113,29,0,56,73
2060,2,2009,24,1,1,55,1,560,52,139,0.374,9,29,0.31,43,110,0.391,0.406,49,60,0.817,6,52,58,86,11,3,29,43
2060,3,2010,25,1,1,12,1,135,21,45,0.467,4,12,0.333,17,33,0.515,0.511,20,27,0.741,3,11,14,16,4,0,12,8
2060,3,2010,25,1,1,26,1,234,35,75,0.467,5,16,0.313,30,59,0.508,0.5,38,49,0.776,3,14,17,26,11,1,17,16
2060,4,2011,26,1,1,40,0,632,78,167,0.467,6,30,0.2,72,137,0.526,0.485,41,54,0.759,9,43,52,70,28,0,33,51
2060,4,2011,26,1,1,51,0,726,81,186,0.435,6,36,0.167,75,150,0.5,0.452,47,64,0.734,12,51,63,84,32,0,43,61
2062,1,1980,22,1,1,77,-1,2123,330,656,0.503,3,19,0.158,327,637,0.513,0.505,180,221,0.814,57,127,184,417,127,28,205,197
2062,2,1981,23,1,1,79,-1,1686,258,548,0.471,2,17,0.118,256,531,0.482,0.473,124,149,0.832,30,104,134,384,97,15,189,160
2062,3,1982,24,1,1,79,61,2150,370,793,0.467,9,31,0.29,361,762,0.474,0.472,115,135,0.852,49,119,168,457,150,15,153,182
2062,4,1983,25,1,1,79,76,2602,439,1059,0.415,42,175,0.24,397,884,0.449,0.434,247,297,0.832,64,131,195,530,165,14,198,215
2062,5,1984,26,1,1,82,27,2009,349,731,0.477,11,71,0.155,338,660,0.512,0.485,238,286,0.832,31,86,117,459,107,12,184,199
2062,6,1985,27,1,1,42,0,536,88,209,0.421,8,37,0.216,80,172,0.465,0.44,44,57,0.772,8,29,37,102,23,4,51,61
2062,7,1986,28,1,1,74,12,1190,212,458,0.463,24,67,0.358,188,391,0.481,0.489,135,158,0.854,6,61,67,234,58,8,88,126
2062,8,1987,29,1,1,53,11,1175,147,358,0.411,18,57,0.316,129,301,0.429,0.436,100,119,0.84,14,47,61,224,53,10,64,126
2073,1,1980,27,1,1,30,-1,364,29,91,0.319,0,3,0,29,88,0.33,0.319,9,17,0.529,11,22,33,67,15,4,33,65
2073,1,1980,27,1,1,31,-1,803,84,214,0.393,22,56,0.393,62,158,0.392,0.444,35,53,0.66,29,61,90,174,84,13,68,107
2073,1,1980,27,1,1,61,-1,1167,113,305,0.37,22,59,0.373,91,246,0.37,0.407,44,70,0.629,40,83,123,241,99,17,101,172
2073,2,1981,28,1,1,82,-1,1829,113,323,0.35,2,13,0.154,111,310,0.358,0.353,113,156,0.724,65,155,220,362,166,29,173,260
2073,3,1982,29,1,1,81,7,1467,88,246,0.358,18,59,0.305,70,187,0.374,0.394,84,119,0.706,35,120,155,312,116,20,123,221
2087,1,1989,25,1,1,82,0,781,40,133,0.301,1,14,0.071,39,119,0.328,0.305,57,73,0.781,23,64,87,215,27,5,88,88
2087,2,1991,27,1,1,55,8,1399,119,268,0.444,71,154,0.461,48,114,0.421,0.576,86,103,0.835,18,93,111,299,57,4,75,141
2087,3,1992,28,1,1,62,5,712,74,192,0.385,45,131,0.344,29,61,0.475,0.503,38,47,0.809,11,52,63,143,31,3,42,58
2087,4,1993,29,1,1,73,0,881,110,259,0.425,66,154,0.429,44,105,0.419,0.552,42,50,0.84,20,69,89,169,40,7,48,81
2087,5,1994,30,1,1,18,0,169,13,34,0.382,8,18,0.444,5,16,0.313,0.5,11,13,0.846,5,8,13,39,7,1,11,16
2087,6,1995,31,1,1,24,0,188,11,38,0.289,5,23,0.217,6,15,0.4,0.355,23,27,0.852,6,20,26,44,4,0,21,28
2090,1,1982,23,1,1,75,74,2252,329,657,0.501,4,8,0.5,325,649,0.501,0.504,208,256,0.813,75,138,213,362,80,14,185,158
2090,2,1983,24,1,1,65,38,1437,202,446,0.453,0,5,0,202,441,0.458,0.453,124,171,0.725,46,126,172,332,51,6,134,121
2090,3,1984,25,1,1,43,3,687,78,188,0.415,1,5,0.2,77,183,0.421,0.418,75,87,0.862,20,26,46,168,30,6,72,59
2090,4,1985,26,1,1,32,1,278,34,82,0.415,0,1,0,34,81,0.42,0.415,21,31,0.677,4,22,26,80,15,3,32,25
2090,5,1986,27,1,1,27,0,222,26,52,0.5,0,3,0,26,49,0.531,0.5,15,19,0.789,0,10,10,54,9,3,42,27
2110,1,2013,22,1,1,82,82,3167,553,1288,0.429,185,503,0.368,368,785,0.469,0.501,271,321,0.844,42,215,257,531,74,19,243,172
2110,2,2014,23,1,1,82,82,2937,553,1304,0.424,218,554,0.394,335,750,0.447,0.508,371,426,0.871,35,253,288,457,64,22,193,197
2110,3,2015,24,1,1,10,10,350,66,141,0.468,33,71,0.465,33,70,0.471,0.585,41,44,0.932,9,43,52,66,9,2,28,24
2111,1,1997,21,1,1,64,0,981,100,229,0.437,9,22,0.409,91,207,0.44,0.456,42,65,0.646,32,62,94,155,39,12,102,107
2111,2,2000,24,1,1,79,15,1081,155,373,0.416,19,55,0.345,136,318,0.428,0.441,52,62,0.839,25,105,130,170,49,13,92,129
2111,3,2002,26,1,1,13,0,176,15,54,0.278,1,8,0.125,14,46,0.304,0.287,10,11,0.909,9,16,25,26,9,2,2,11
2111,4,2005,29,1,1,17,4,227,22,52,0.423,5,8,0.625,17,44,0.386,0.471,15,17,0.882,3,9,12,45,12,2,14,28
2113,1,2011,22,1,1,29,0,285,28,72,0.389,1,5,0.2,27,67,0.403,0.396,19,25,0.76,12,22,34,42,33,9,18,31
2113,2,2012,23,1,1,35,25,940,171,383,0.446,24,75,0.32,147,308,0.477,0.478,146,183,0.798,18,89,107,216,55,9,126,78
2113,3,2013,24,1,1,82,82,2640,396,897,0.441,87,257,0.339,309,640,0.483,0.49,216,275,0.785,32,215,247,497,134,29,236,205
2113,4,2014,25,1,1,71,33,2054,295,662,0.446,82,229,0.358,213,433,0.492,0.508,218,265,0.823,34,153,187,294,68,27,176,166
2113,5,2015,26,1,1,9,9,283,35,79,0.443,10,26,0.385,25,53,0.472,0.506,37,40,0.925,4,22,26,43,7,2,25,26
2134,3,2001,26,1,1,23,10,457,69,152,0.454,13,23,0.565,56,129,0.434,0.497,19,33,0.576,25,49,74,34,21,12,27,46
2135,1,2004,23,1,1,82,11,1617,223,517,0.431,25,85,0.294,198,432,0.458,0.456,101,117,0.863,24,131,155,305,62,2,174,200
2135,2,2005,24,1,1,31,15,518,57,135,0.422,20,45,0.444,37,90,0.411,0.496,27,33,0.818,7,32,39,123,22,3,47,78
2148,1,1980,26,1,1,80,-1,2763,388,830,0.467,12,42,0.286,376,788,0.477,0.475,222,289,0.768,61,159,220,602,138,3,184,196
2148,2,1981,27,1,1,66,-1,1919,222,506,0.439,4,24,0.167,218,482,0.452,0.443,107,145,0.738,34,120,154,464,83,2,185,140
2148,3,1982,28,1,1,79,53,1940,263,618,0.426,2,22,0.091,261,596,0.438,0.427,138,176,0.784,40,126,166,551,95,6,156,105
2148,4,1983,29,1,1,35,0,386,62,131,0.473,0,5,0,62,126,0.492,0.473,21,42,0.5,8,21,29,102,25,1,47,18
2148,5,1984,30,1,1,63,39,1807,275,595,0.462,19,69,0.275,256,526,0.487,0.478,120,157,0.764,23,157,180,673,92,5,147,123
2148,6,1985,31,1,1,47,21,1158,206,446,0.462,21,66,0.318,185,380,0.487,0.485,103,129,0.798,21,64,85,318,62,2,102,78
2148,7,1986,32,1,1,65,65,2120,365,818,0.446,45,146,0.308,320,672,0.476,0.474,231,298,0.775,33,110,143,571,77,5,149,124
2148,8,1987,33,1,1,43,40,1358,285,624,0.457,46,126,0.365,239,498,0.48,0.494,137,174,0.787,29,96,125,290,71,6,89,82
2148,9,1988,34,1,1,81,22,1766,281,631,0.445,51,151,0.338,230,480,0.479,0.486,130,162,0.802,29,130,159,392,88,3,125,102
2148,10,1989,35,1,1,74,8,842,119,299,0.398,18,68,0.265,101,231,0.437,0.428,54,77,0.701,22,57,79,260,60,1,66,53
2148,11,1990,36,1,1,49,18,938,109,291,0.375,26,87,0.299,83,204,0.407,0.419,42,55,0.764,19,71,90,238,45,2,85,59
2150,1,2007,20,1,1,10,0,175,14,38,0.368,3,8,0.375,11,30,0.367,0.408,25,28,0.893,12,19,31,32,14,1,12,20
2150,2,2008,21,1,1,82,9,2089,256,592,0.432,36,140,0.257,220,452,0.487,0.463,243,348,0.698,41,209,250,296,92,22,127,185
2150,3,2009,22,1,1,28,0,608,77,162,0.475,8,29,0.276,69,133,0.519,0.5,52,65,0.8,13,65,78,97,21,9,38,57
2150,3,2009,22,1,1,49,21,1071,112,272,0.412,17,69,0.246,95,203,0.468,0.443,129,161,0.801,13,98,111,178,48,8,79,89
2150,3,2009,22,1,1,77,21,1679,189,434,0.435,25,98,0.255,164,336,0.488,0.464,181,226,0.801,26,163,189,275,69,17,117,146
2150,4,2010,23,1,1,68,0,1651,184,464,0.397,37,136,0.272,147,328,0.448,0.436,215,260,0.827,91,156,247,305,60,9,116,173
2150,5,2011,24,1,1,75,71,2563,345,809,0.426,129,343,0.376,216,466,0.464,0.506,192,251,0.765,89,220,309,500,102,23,158,207
2150,6,2012,25,1,1,47,38,1510,210,513,0.409,79,211,0.374,131,302,0.434,0.486,171,198,0.864,37,176,213,310,73,14,130,133
2150,7,2013,26,1,1,68,52,2020,250,623,0.401,101,279,0.362,149,344,0.433,0.482,190,239,0.795,56,265,321,435,94,24,157,218
2150,8,2014,27,1,1,79,79,2862,457,1080,0.423,190,500,0.38,267,580,0.46,0.511,313,385,0.813,88,281,369,586,121,15,194,267
2150,9,2015,28,1,1,10,10,332,63,130,0.485,13,42,0.31,50,88,0.568,0.535,44,58,0.759,9,39,48,58,12,1,17,32
2152,1,1999,21,1,1,15,0,188,28,65,0.431,7,16,0.438,21,49,0.429,0.485,12,21,0.571,2,4,6,25,5,0,11,28
2152,2,2000,22,1,1,8,0,146,19,39,0.487,4,8,0.5,15,31,0.484,0.538,6,8,0.75,2,10,12,17,3,0,9,17
2152,3,2001,23,1,1,38,1,468,50,117,0.427,11,34,0.324,39,83,0.47,0.474,19,24,0.792,5,27,32,45,19,0,27,54
2152,4,2002,24,1,1,71,0,1458,222,520,0.427,63,141,0.447,159,379,0.42,0.488,48,63,0.762,14,108,122,246,49,0,96,120
2152,5,2003,25,1,1,75,24,1986,248,573,0.433,60,176,0.341,188,397,0.474,0.485,91,104,0.875,22,127,149,263,47,1,77,151
2152,6,2004,26,1,1,76,69,2332,309,714,0.433,80,209,0.383,229,505,0.453,0.489,101,131,0.771,26,161,187,317,61,5,124,185
2152,7,2005,27,1,1,21,3,479,48,122,0.393,15,45,0.333,33,77,0.429,0.455,14,18,0.778,0,40,40,58,8,0,24,48
2152,7,2005,27,1,1,49,46,1528,247,532,0.464,40,110,0.364,207,422,0.491,0.502,128,147,0.871,14,95,109,264,25,0,81,120
2152,7,2005,27,1,1,70,49,2007,295,654,0.451,55,155,0.355,240,499,0.481,0.493,142,165,0.861,14,135,149,322,33,0,105,168
2152,8,2006,28,1,1,51,10,1234,192,418,0.459,58,127,0.457,134,291,0.46,0.529,118,138,0.855,13,69,82,157,26,3,75,113
2152,9,2007,29,1,1,56,17,1488,218,524,0.416,56,161,0.348,162,363,0.446,0.469,144,163,0.883,19,85,104,201,24,0,85,101
2152,10,2008,30,1,1,17,0,172,27,57,0.474,9,17,0.529,18,40,0.45,0.553,1,4,0.25,0,13,13,15,0,1,5,28
2152,10,2008,30,1,1,33,3,564,86,196,0.439,30,69,0.435,56,127,0.441,0.515,24,28,0.857,9,32,41,59,11,0,22,38
2152,10,2008,30,1,1,50,3,736,113,253,0.447,39,86,0.453,74,167,0.443,0.524,25,32,0.781,9,45,54,74,11,1,27,66
2152,11,2009,31,1,1,14,0,129,17,43,0.395,6,17,0.353,11,26,0.423,0.465,2,3,0.667,0,11,11,14,2,0,2,13
2152,11,2009,31,1,1,30,0,392,54,119,0.454,21,45,0.467,33,74,0.446,0.542,12,16,0.75,6,29,35,46,6,0,21,41
2152,11,2009,31,1,1,44,0,521,71,162,0.438,27,62,0.435,44,100,0.44,0.522,14,19,0.737,6,40,46,60,8,0,23,54
2194,1,2014,21,1,1,80,44,2487,392,936,0.419,74,226,0.327,318,710,0.448,0.458,248,318,0.78,43,286,329,327,129,37,256,210
2201,1,2002,23,1,1,20,0,139,17,46,0.37,2,13,0.154,15,33,0.455,0.391,6,9,0.667,0,8,8,21,3,0,11,16
2206,1,1998,25,1,1,16,0,214,14,42,0.333,0,0,-1,14,42,0.333,0.333,18,25,0.72,6,15,21,32,6,0,16,16
2206,1,1998,25,1,1,19,0,216,23,56,0.411,0,1,0,23,55,0.418,0.411,31,45,0.689,3,15,18,33,7,0,28,15
2206,1,1998,25,1,1,35,0,430,37,98,0.378,0,1,0,37,97,0.381,0.378,49,70,0.7,9,30,39,65,13,0,44,31
2206,2,2000,27,1,1,40,0,290,22,49,0.449,0,0,-1,22,49,0.449,0.449,28,37,0.757,4,27,31,46,10,0,10,27
2206,3,2001,28,1,1,19,0,161,5,27,0.185,0,0,-1,5,27,0.185,0.185,12,19,0.632,3,20,23,25,5,0,9,14
2206,3,2001,28,1,1,51,4,764,71,165,0.43,1,3,0.333,70,162,0.432,0.433,51,70,0.729,13,59,72,121,25,1,40,70
2206,3,2001,28,1,1,70,4,925,76,192,0.396,1,3,0.333,75,189,0.397,0.398,63,89,0.708,16,79,95,146,30,1,49,84
2206,4,2002,29,1,1,29,0,577,40,100,0.4,0,0,-1,40,100,0.4,0.4,78,97,0.804,7,49,56,98,26,1,26,33
2206,4,2002,29,1,1,52,17,1146,97,253,0.383,1,2,0.5,96,251,0.382,0.385,109,130,0.838,18,110,128,193,36,1,80,64
2206,4,2002,29,1,1,81,17,1723,137,353,0.388,1,2,0.5,136,351,0.387,0.39,187,227,0.824,25,159,184,291,62,2,106,97
2206,5,2003,30,1,1,29,1,770,82,186,0.441,1,1,1,81,185,0.438,0.444,66,87,0.759,13,70,83,110,32,1,36,51
2206,5,2003,30,1,1,53,4,1127,117,255,0.459,1,5,0.2,116,250,0.464,0.461,68,91,0.747,12,87,99,181,37,4,36,71
2206,5,2003,30,1,1,82,5,1897,199,441,0.451,2,6,0.333,197,435,0.453,0.454,134,178,0.753,25,157,182,291,69,5,72,122
2206,6,2004,31,1,1,82,7,1401,95,257,0.37,4,9,0.444,91,248,0.367,0.377,147,176,0.835,23,147,170,234,51,8,81,119
2206,7,2005,32,1,1,26,0,158,11,31,0.355,0,0,-1,11,31,0.355,0.355,6,9,0.667,3,16,19,19,5,0,6,16
2206,9,2007,34,1,1,53,23,919,81,187,0.433,0,2,0,81,185,0.438,0.433,37,45,0.822,8,66,74,130,21,1,47,76
2206,11,2009,36,1,1,50,21,850,61,150,0.407,0,1,0,61,149,0.409,0.407,80,96,0.833,13,62,75,117,19,4,34,79
2206,12,2010,37,1,1,25,0,263,18,45,0.4,0,1,0,18,44,0.409,0.4,8,8,1,3,22,25,20,9,0,6,16
2232,1,1992,22,1,1,72,0,894,115,272,0.423,0,10,0,115,262,0.439,0.423,102,127,0.803,32,65,97,140,40,4,92,101
2232,2,1993,23,1,1,77,1,1579,285,606,0.47,1,8,0.125,284,598,0.475,0.471,239,311,0.768,52,108,160,335,81,10,185,182
2232,3,1994,24,1,1,66,4,1382,223,503,0.443,6,29,0.207,217,474,0.458,0.449,179,236,0.758,25,98,123,356,81,9,204,147
2232,4,1995,25,1,1,42,32,1144,170,395,0.43,30,72,0.417,140,323,0.433,0.468,137,175,0.783,19,94,113,290,61,6,134,101
2232,5,1996,26,1,1,31,31,1084,190,444,0.428,26,98,0.265,164,346,0.474,0.457,154,182,0.846,29,103,132,242,62,1,114,68
2232,6,1997,27,1,1,20,11,597,79,219,0.361,9,38,0.237,70,181,0.387,0.381,62,73,0.849,13,47,60,127,35,3,67,56
2232,6,1997,27,1,1,34,31,1185,193,474,0.407,22,74,0.297,171,400,0.428,0.43,134,170,0.788,15,71,86,325,59,3,150,83
2232,6,1997,27,1,1,54,42,1782,272,693,0.392,31,112,0.277,241,581,0.415,0.415,196,243,0.807,28,118,146,452,94,6,217,139
2232,7,1998,28,1,1,12,10,292,33,98,0.337,3,6,0.5,30,92,0.326,0.352,25,36,0.694,8,26,34,42,20,1,38,17
2232,8,1999,29,1,1,25,0,468,75,174,0.431,0,4,0,75,170,0.441,0.431,72,88,0.818,9,27,36,81,20,1,49,41
2232,9,2000,30,1,1,29,22,665,96,230,0.417,4,11,0.364,92,219,0.42,0.426,63,78,0.808,7,35,42,168,31,3,76,44
2232,10,2001,31,1,1,74,11,1260,181,426,0.425,12,31,0.387,169,395,0.428,0.439,105,137,0.766,30,107,137,293,65,1,135,114
2232,11,2002,32,1,1,16,0,252,25,68,0.368,1,4,0.25,24,64,0.375,0.375,11,15,0.733,7,16,23,49,13,0,20,32
2232,12,2003,33,1,1,28,4,440,52,129,0.403,0,5,0,52,124,0.419,0.403,41,55,0.745,11,40,51,81,25,0,40,35
2232,13,2004,34,1,1,26,0,220,22,52,0.423,0,0,-1,22,52,0.423,0.423,5,6,0.833,4,14,18,27,12,1,16,20
2239,1,2000,21,1,1,53,0,394,43,98,0.439,0,2,0,43,96,0.448,0.439,22,37,0.595,17,34,51,48,20,0,44,32
2239,2,2001,22,1,1,58,6,1141,126,267,0.472,12,36,0.333,114,231,0.494,0.494,78,92,0.848,25,77,102,151,48,0,80,83
2239,3,2002,23,1,1,41,0,518,52,135,0.385,12,34,0.353,40,101,0.396,0.43,36,51,0.706,8,42,50,54,21,3,24,38
2239,3,2002,23,1,1,69,1,790,82,214,0.383,13,41,0.317,69,173,0.399,0.414,54,74,0.73,11,62,73,83,30,4,40,61
2239,4,2003,24,1,1,80,46,1976,162,388,0.418,8,37,0.216,154,351,0.439,0.428,65,87,0.747,48,187,235,259,68,16,131,168
2239,5,2004,25,1,1,59,13,1211,104,298,0.349,4,26,0.154,100,272,0.368,0.356,45,68,0.662,15,87,102,184,41,11,87,90
2239,6,2005,26,1,1,80,4,1533,175,392,0.446,2,12,0.167,173,380,0.455,0.449,115,155,0.742,26,108,134,279,48,13,104,126
2239,7,2006,27,1,1,71,18,1376,171,403,0.424,1,16,0.063,170,387,0.439,0.426,98,150,0.653,17,117,134,190,47,14,110,125
2240,1,2012,25,1,1,44,5,424,50,150,0.333,10,38,0.263,40,112,0.357,0.367,16,27,0.593,12,25,37,55,15,0,46,46
2240,2,2013,26,1,1,25,11,447,75,187,0.401,18,57,0.316,57,130,0.438,0.449,28,41,0.683,7,25,32,64,12,2,37,32
2240,2,2013,26,1,1,39,11,655,99,250,0.396,25,74,0.338,74,176,0.42,0.446,42,62,0.677,8,41,49,92,13,2,50,46
2248,1,2002,19,1,1,77,72,2267,268,639,0.419,61,189,0.323,207,450,0.46,0.467,108,160,0.675,33,164,197,334,89,7,151,166
2248,2,2003,20,1,1,82,82,2774,484,1043,0.464,82,243,0.337,402,800,0.503,0.503,219,290,0.755,33,183,216,432,71,4,198,174
2248,3,2004,21,1,1,75,75,2577,423,946,0.447,62,199,0.312,361,747,0.483,0.48,191,272,0.702,43,194,237,411,61,7,179,148
2248,4,2005,22,1,1,80,80,2735,539,1118,0.482,43,156,0.276,496,962,0.516,0.501,210,323,0.65,47,251,298,491,98,4,215,167
2248,5,2006,23,1,1,80,80,2715,623,1136,0.548,11,36,0.306,612,1100,0.556,0.553,253,358,0.707,38,223,261,460,83,4,249,161
2248,6,2007,24,1,1,77,77,2499,570,1096,0.52,15,38,0.395,555,1058,0.525,0.527,274,350,0.783,34,216,250,420,82,6,191,137
2248,7,2008,25,1,1,69,68,2312,515,1043,0.494,17,66,0.258,498,977,0.51,0.502,248,347,0.715,30,191,221,411,55,8,164,93
2248,8,2009,26,1,1,72,71,2456,639,1263,0.506,19,65,0.292,620,1198,0.518,0.513,284,363,0.782,27,196,223,496,67,4,186,110
2248,9,2010,27,1,1,56,50,1728,349,716,0.487,10,34,0.294,339,682,0.497,0.494,186,246,0.756,7,128,135,317,29,8,149,96
2248,10,2011,28,1,1,78,78,2528,555,1069,0.519,25,70,0.357,530,999,0.531,0.531,233,303,0.769,30,208,238,513,90,3,200,135
2248,11,2012,29,1,1,60,60,1923,427,890,0.48,14,61,0.23,413,829,0.498,0.488,227,284,0.799,22,149,171,463,57,5,153,75
2248,12,2013,30,1,1,66,66,2174,519,995,0.522,24,68,0.353,495,927,0.534,0.534,279,330,0.845,18,180,198,499,54,6,170,92
2248,13,2014,31,1,1,68,68,1997,456,914,0.499,25,67,0.373,431,847,0.509,0.513,197,243,0.811,17,138,155,388,36,9,151,86
2248,14,2015,32,1,1,9,9,300,61,120,0.508,9,14,0.643,52,106,0.491,0.546,25,31,0.806,3,16,19,48,2,0,26,12
2269,1,2006,20,1,1,78,78,2808,407,947,0.43,50,177,0.282,357,770,0.464,0.456,394,465,0.847,61,339,400,611,175,6,183,218
2269,2,2007,21,1,1,64,64,2353,381,871,0.437,50,143,0.35,331,728,0.455,0.466,292,357,0.818,54,226,280,569,118,3,161,154
2269,3,2008,22,1,1,80,80,3006,630,1291,0.488,92,249,0.369,538,1042,0.516,0.524,332,390,0.851,62,259,321,925,217,4,201,185
2269,4,2009,23,1,1,78,78,3002,631,1255,0.503,64,176,0.364,567,1079,0.525,0.528,455,524,0.868,69,363,432,861,216,10,231,212
2269,5,2010,24,1,1,45,45,1712,314,637,0.493,52,127,0.409,262,510,0.514,0.534,161,190,0.847,20,171,191,480,96,8,112,118
2269,6,2011,25,1,1,80,80,2880,430,928,0.463,71,183,0.388,359,745,0.482,0.502,337,384,0.878,38,289,327,782,188,5,177,196
2269,7,2012,26,1,1,60,60,2181,425,890,0.478,79,213,0.371,346,677,0.511,0.522,260,302,0.861,42,171,213,543,152,4,124,138
2269,8,2013,27,1,1,70,70,2335,412,856,0.481,76,232,0.328,336,624,0.538,0.526,286,323,0.885,53,209,262,678,169,10,159,143
2269,9,2014,28,1,1,62,62,2171,406,870,0.467,78,212,0.368,328,658,0.498,0.511,295,345,0.855,38,230,268,663,154,4,145,157
2269,10,2015,29,1,1,8,8,290,53,110,0.482,11,30,0.367,42,80,0.525,0.532,27,33,0.818,3,39,42,81,19,4,12,23
2279,10,1989,31,1,1,57,7,1138,202,445,0.454,4,24,0.167,198,421,0.47,0.458,84,103,0.816,18,56,74,107,38,8,57,96
2279,11,1990,32,1,1,72,25,1283,191,422,0.453,5,20,0.25,186,402,0.463,0.459,73,90,0.811,24,53,77,137,33,5,54,115
2280,1,1984,23,1,1,49,0,458,61,137,0.445,4,22,0.182,57,115,0.496,0.46,16,26,0.615,4,29,33,149,10,2,32,47
2280,2,1985,24,1,1,78,1,1259,196,385,0.509,10,34,0.294,186,351,0.53,0.522,84,100,0.84,19,49,68,215,45,3,81,117
2280,3,1986,25,1,1,75,3,1570,153,328,0.466,15,50,0.3,138,278,0.496,0.489,74,92,0.804,18,76,94,274,55,2,63,172
2280,4,1987,26,1,1,82,64,2689,386,793,0.487,52,140,0.371,334,653,0.511,0.52,106,131,0.809,22,117,139,467,66,8,105,207
2280,5,1988,27,1,1,81,30,1888,287,582,0.493,33,95,0.347,254,487,0.522,0.521,33,45,0.733,16,88,104,303,49,1,64,154
2280,6,1989,28,1,1,78,20,1738,246,513,0.48,44,133,0.331,202,380,0.532,0.522,31,36,0.861,13,81,94,308,53,6,71,162
2280,7,1990,29,1,1,82,82,2365,365,708,0.516,33,92,0.359,332,616,0.539,0.539,56,68,0.824,27,92,119,335,83,6,85,176
2280,8,1991,30,1,1,82,82,1971,317,578,0.548,42,96,0.438,275,482,0.571,0.585,34,41,0.829,15,76,91,297,62,3,69,136
2280,9,1992,31,1,1,79,79,1946,257,487,0.528,12,44,0.273,245,443,0.553,0.54,29,37,0.784,21,75,96,241,49,9,44,142
2280,10,1993,32,1,1,59,8,1030,105,233,0.451,19,41,0.463,86,192,0.448,0.491,17,20,0.85,9,39,48,136,38,2,31,99
2280,11,1994,33,1,1,27,0,343,30,68,0.441,9,22,0.409,21,46,0.457,0.507,1,2,0.5,3,17,20,33,7,2,6,18
2282,1,1991,22,1,1,82,82,2244,259,575,0.45,1,13,0.077,258,562,0.459,0.451,69,97,0.711,108,135,243,528,165,15,180,249
2282,2,1992,23,1,1,81,79,2549,331,734,0.451,3,23,0.13,328,711,0.461,0.453,99,148,0.669,123,172,295,506,147,21,174,248
2282,3,1993,24,1,1,82,78,2548,476,963,0.494,7,34,0.206,469,929,0.505,0.498,151,196,0.77,95,186,281,399,177,21,148,250
2282,4,1994,25,1,1,82,82,2881,584,1159,0.504,15,54,0.278,569,1105,0.515,0.51,166,279,0.595,105,164,269,494,188,19,173,227
2282,5,1995,26,1,1,82,82,3015,685,1345,0.509,70,232,0.302,615,1113,0.553,0.535,249,348,0.716,108,173,281,583,204,13,201,206
2282,6,1996,27,1,1,81,81,3162,618,1276,0.484,98,299,0.328,520,977,0.532,0.523,229,306,0.748,104,235,339,608,231,19,260,221
2282,7,1997,28,1,1,82,82,3213,706,1482,0.476,119,380,0.313,587,1102,0.533,0.517,254,355,0.715,106,272,378,583,197,13,215,208
2282,8,1998,29,1,1,82,82,3145,579,1278,0.453,134,397,0.338,445,881,0.505,0.505,279,375,0.744,77,299,376,679,185,18,229,195
2282,9,1999,30,1,1,50,50,2008,401,923,0.434,83,281,0.295,318,642,0.495,0.479,199,276,0.721,62,182,244,436,109,12,154,115
2282,10,2000,31,1,1,82,82,3425,747,1666,0.448,177,520,0.34,570,1146,0.497,0.502,311,423,0.735,100,429,529,732,153,18,224,178
2282,11,2001,32,1,1,79,79,3244,725,1591,0.456,102,272,0.375,623,1319,0.472,0.488,271,354,0.766,73,288,361,642,127,26,209,184
2282,12,2002,33,1,1,82,82,3301,737,1578,0.467,74,236,0.314,663,1342,0.494,0.49,267,335,0.797,80,316,396,737,131,26,209,179
2282,13,2003,34,1,1,28,28,1085,221,474,0.466,20,68,0.294,201,406,0.495,0.487,88,118,0.746,23,63,86,206,40,8,56,64
2282,13,2003,34,1,1,52,52,2123,444,992,0.448,34,114,0.298,410,878,0.467,0.465,162,234,0.692,56,192,248,457,93,12,131,117
2282,13,2003,34,1,1,80,80,3208,665,1466,0.454,54,182,0.297,611,1284,0.476,0.472,250,352,0.71,79,255,334,663,133,20,187,181
2282,14,2004,35,1,1,82,82,2825,482,1024,0.471,55,165,0.333,427,859,0.497,0.498,180,252,0.714,72,270,342,449,96,19,151,169
2282,15,2005,36,1,1,77,77,2541,339,725,0.468,42,129,0.326,297,596,0.498,0.497,153,201,0.761,48,188,236,469,88,12,148,121
2282,16,2006,37,1,1,81,25,2305,230,547,0.42,66,230,0.287,164,317,0.517,0.481,100,126,0.794,34,199,233,257,71,10,102,169
2282,17,2007,38,1,1,68,28,1503,144,366,0.393,32,123,0.26,112,243,0.461,0.437,38,57,0.667,18,114,132,201,43,3,66,117
2290,1,2001,26,1,1,53,0,851,92,222,0.414,55,139,0.396,37,83,0.446,0.538,28,31,0.903,10,53,63,71,22,2,34,57
2327,13,1995,35,1,1,27,6,673,111,254,0.437,23,70,0.329,88,184,0.478,0.482,93,106,0.877,12,52,64,40,22,2,24,38
2329,1,1980,23,1,1,50,-1,577,91,179,0.508,9,36,0.25,82,143,0.573,0.534,37,46,0.804,26,19,45,94,25,4,51,52
2330,1,2004,21,1,1,53,22,748,96,231,0.416,35,105,0.333,61,126,0.484,0.491,52,75,0.693,48,71,119,27,32,12,40,100
2340,2,2005,22,1,1,43,8,515,78,174,0.448,15,40,0.375,63,134,0.47,0.491,46,66,0.697,19,50,69,44,25,0,41,76
2340,3,2006,23,1,1,56,1,596,66,183,0.361,13,56,0.232,53,127,0.417,0.396,46,66,0.697,14,60,74,53,20,4,43,91
2355,1,1986,22,1,1,79,3,1214,212,447,0.474,13,42,0.31,199,405,0.491,0.489,125,155,0.806,35,82,117,198,81,1,106,136
2355,2,1987,23,1,1,80,80,2714,376,770,0.488,13,60,0.217,363,710,0.511,0.497,280,334,0.838,70,267,337,715,159,9,255,192
2355,3,1988,24,1,1,82,82,2991,462,890,0.519,24,69,0.348,438,821,0.533,0.533,274,324,0.846,65,313,378,831,150,16,244,204
2355,4,1989,25,1,1,81,81,3102,540,1146,0.471,79,219,0.361,461,927,0.497,0.506,272,324,0.84,85,282,367,770,146,8,248,187
2355,5,1990,26,1,1,80,80,2781,448,969,0.462,89,238,0.374,359,731,0.491,0.508,421,472,0.892,59,213,272,726,151,4,245,150
2355,6,1991,27,1,1,81,81,2665,486,944,0.515,130,313,0.415,356,631,0.564,0.584,279,339,0.823,52,230,282,649,158,12,189,151
2355,7,1992,28,1,1,82,82,2784,521,1129,0.461,128,324,0.395,393,805,0.488,0.518,315,368,0.856,51,204,255,477,127,12,188,155
2355,8,1993,29,1,1,81,81,2883,503,1108,0.454,143,345,0.414,360,763,0.472,0.519,327,388,0.843,58,258,316,419,101,10,199,122
2355,9,1994,30,1,1,77,34,2074,348,836,0.416,110,282,0.39,238,554,0.43,0.482,204,234,0.872,45,170,215,401,79,18,166,132
2355,10,1995,31,1,1,35,9,770,105,267,0.393,44,114,0.386,61,153,0.399,0.476,58,82,0.707,18,63,81,133,30,2,58,60
2355,11,1996,32,1,1,82,40,2072,269,608,0.442,71,226,0.314,198,382,0.518,0.501,164,209,0.785,36,176,212,452,89,15,173,154
2355,12,1997,33,1,1,82,20,1568,187,449,0.416,67,200,0.335,120,249,0.482,0.491,127,166,0.765,31,145,176,295,54,11,128,104
2355,13,1998,34,1,1,82,8,1786,259,577,0.449,92,233,0.395,167,344,0.485,0.529,167,195,0.856,37,131,168,271,63,16,104,103
2355,14,1999,35,1,1,50,1,1365,172,370,0.465,58,141,0.411,114,229,0.498,0.543,123,148,0.831,13,127,140,146,48,11,74,97
2355,15,2000,36,1,1,68,8,1613,207,463,0.447,90,207,0.435,117,256,0.457,0.544,137,170,0.806,24,167,191,221,50,9,100,79
2355,16,2001,37,1,1,80,42,1678,197,440,0.448,87,205,0.424,110,235,0.468,0.547,92,116,0.793,24,177,201,251,52,11,104,88
2355,17,2002,38,1,1,72,0,1294,136,321,0.424,59,142,0.415,77,179,0.43,0.516,68,83,0.819,12,152,164,205,45,16,85,89
2369,1,2014,22,1,1,75,11,1132,78,253,0.308,28,106,0.264,50,147,0.34,0.364,29,45,0.644,20,85,105,241,68,5,87,97
2370,1,1989,24,1,1,10,0,107,8,25,0.32,0,0,-1,8,25,0.32,0.32,5,9,0.556,3,11,14,22,4,0,11,9
2370,1,1989,24,1,1,13,0,124,9,31,0.29,0,2,0,9,29,0.31,0.29,5,9,0.556,3,12,15,26,4,0,11,11
2374,1,2010,23,1,1,56,2,865,145,354,0.41,60,174,0.345,85,180,0.472,0.494,60,75,0.8,12,76,88,106,35,3,59,53
2374,2,2011,24,1,1,50,0,795,114,320,0.356,41,149,0.275,73,171,0.427,0.42,54,81,0.667,16,56,72,111,29,1,53,61
2374,3,2012,25,1,1,44,1,568,59,174,0.339,26,88,0.295,33,86,0.384,0.414,28,35,0.8,13,48,61,86,20,2,32,30
2374,4,2013,26,1,1,57,22,1278,161,413,0.39,70,200,0.35,91,213,0.427,0.475,49,62,0.79,20,94,114,205,33,3,64,73
2374,5,2015,28,1,1,6,0,124,29,59,0.492,9,22,0.409,20,37,0.541,0.568,11,16,0.688,1,9,10,17,3,0,8,5
2376,1,1987,22,1,1,67,0,1217,173,424,0.408,23,70,0.329,150,354,0.424,0.435,95,114,0.833,33,84,117,202,43,4,105,75
2376,2,1988,23,1,1,80,79,2626,493,974,0.506,72,148,0.486,421,826,0.51,0.543,221,252,0.877,54,126,180,480,99,12,184,119
2376,3,1989,24,1,1,75,74,2728,529,1006,0.526,93,211,0.441,436,795,0.548,0.572,263,292,0.901,48,178,226,631,115,7,212,98
2376,4,1990,25,1,1,73,73,2706,489,1066,0.459,152,374,0.406,337,692,0.487,0.53,300,338,0.888,66,185,251,666,114,5,214,89
2376,5,1991,26,1,1,16,16,571,97,195,0.497,18,53,0.34,79,142,0.556,0.544,59,62,0.952,8,37,45,166,42,2,56,23
2376,6,1992,27,1,1,72,72,2138,438,897,0.488,101,261,0.387,337,636,0.53,0.545,270,285,0.947,38,135,173,535,94,12,159,113
2376,7,1993,28,1,1,75,74,2380,477,986,0.484,122,293,0.416,355,693,0.512,0.546,289,305,0.948,37,164,201,602,89,11,196,105
2376,8,1994,29,1,1,76,73,2386,480,1005,0.478,118,297,0.397,362,708,0.511,0.536,238,268,0.888,39,189,228,589,103,11,189,93
2376,9,1995,30,1,1,48,34,1375,253,612,0.413,103,253,0.407,150,359,0.418,0.498,148,162,0.914,25,87,112,335,35,4,142,50
2376,10,1996,31,1,1,7,1,127,18,60,0.3,10,30,0.333,8,30,0.267,0.383,10,10,1,1,6,7,18,6,0,10,7
2376,11,1997,32,1,1,70,49,1876,263,589,0.447,112,283,0.396,151,306,0.493,0.542,155,171,0.906,36,143,179,342,67,3,161,100
2376,12,1998,33,1,1,63,33,1430,229,531,0.431,52,155,0.335,177,376,0.471,0.48,87,103,0.845,24,105,129,297,53,5,162,92
2377,1,2006,22,1,1,29,0,150,21,58,0.362,6,27,0.222,15,31,0.484,0.414,12,12,1,5,10,15,11,6,0,10,10
2377,2,2007,23,1,1,58,1,563,67,172,0.39,21,65,0.323,46,107,0.43,0.451,37,55,0.673,15,56,71,48,28,4,33,64
2377,3,2008,24,1,1,61,3,588,88,204,0.431,26,75,0.347,62,129,0.481,0.495,26,38,0.684,8,38,46,78,32,3,30,83
2377,4,2009,25,1,1,52,17,738,77,203,0.379,19,61,0.311,58,142,0.408,0.426,34,45,0.756,12,57,69,108,39,5,61,74
2377,5,2010,26,1,1,60,4,806,98,242,0.405,18,63,0.286,80,179,0.447,0.442,41,59,0.695,28,46,74,123,40,13,56,109
2377,7,2012,28,1,1,36,8,517,49,130,0.377,13,44,0.295,36,86,0.419,0.427,20,25,0.8,18,38,56,67,34,3,46,72
2377,8,2013,29,1,1,39,0,510,39,120,0.325,10,39,0.256,29,81,0.358,0.367,17,24,0.708,13,31,44,73,26,3,34,61
2377,10,2015,31,1,1,8,0,168,11,39,0.282,3,19,0.158,8,20,0.4,0.321,9,11,0.818,3,12,15,35,11,0,8,22
2382,1,2013,35,1,1,78,18,1263,100,220,0.455,53,134,0.396,47,86,0.547,0.575,22,25,0.88,41,102,143,236,69,2,86,127
2382,2,2014,36,1,1,66,27,1283,88,191,0.461,65,140,0.464,23,51,0.451,0.631,11,12,0.917,36,93,129,228,67,2,60,132
2382,3,2015,37,1,1,8,0,162,14,29,0.483,9,21,0.429,5,8,0.625,0.638,4,6,0.667,3,10,13,16,11,0,8,10
2390,2,2007,23,1,1,79,79,2651,320,705,0.454,63,180,0.35,257,525,0.49,0.499,243,279,0.871,18,190,208,417,86,9,187,202
2390,5,2010,26,1,1,82,43,2243,323,671,0.481,82,199,0.412,241,472,0.511,0.542,203,241,0.842,30,192,222,413,60,6,163,151
2390,6,2011,27,1,1,13,13,347,48,122,0.393,4,24,0.167,44,98,0.449,0.41,40,46,0.87,6,36,42,59,14,0,34,25
2390,7,2012,28,1,1,45,39,1530,266,583,0.456,39,112,0.348,227,471,0.482,0.49,129,148,0.872,23,153,176,285,31,9,106,93
2390,9,2014,30,1,1,80,31,2252,286,698,0.41,63,185,0.341,223,513,0.435,0.455,125,149,0.839,22,201,223,324,56,22,133,133
2390,10,2015,31,1,1,9,0,221,34,64,0.531,0,6,0,34,58,0.586,0.531,14,16,0.875,1,21,22,23,12,1,16,19
2392,1,1998,24,1,1,68,53,2042,310,791,0.392,21,81,0.259,289,710,0.407,0.405,149,183,0.814,78,224,302,317,105,11,184,160
2392,2,1999,25,1,1,50,12,941,141,348,0.405,10,27,0.37,131,321,0.408,0.42,61,79,0.772,43,92,135,167,39,3,75,75
2392,3,2000,26,1,1,73,10,1034,140,346,0.405,13,46,0.283,127,300,0.423,0.423,76,98,0.776,50,103,153,172,48,7,58,114
2392,4,2001,27,1,1,79,7,1648,231,526,0.439,39,104,0.375,192,422,0.455,0.476,65,88,0.739,74,172,246,161,87,7,103,139
2392,5,2002,28,1,1,81,3,1750,334,754,0.443,79,219,0.361,255,535,0.477,0.495,149,184,0.81,82,169,251,164,73,11,93,145
2392,6,2003,29,1,1,59,26,1676,340,732,0.464,89,235,0.379,251,497,0.505,0.525,126,149,0.846,57,162,219,182,71,3,106,126
2392,9,2006,32,1,1,71,15,1775,286,748,0.382,129,332,0.389,157,416,0.377,0.469,107,146,0.733,44,179,223,195,61,1,101,155
2392,11,2008,34,1,1,26,5,498,88,210,0.419,28,82,0.341,60,128,0.469,0.486,24,32,0.75,10,61,71,63,13,2,28,37
2392,12,2009,35,1,1,71,10,1484,193,485,0.398,60,197,0.305,133,288,0.462,0.46,86,101,0.851,42,158,200,143,62,4,66,100
2402,1,1988,23,1,1,58,0,760,64,171,0.374,6,25,0.24,58,146,0.397,0.392,23,32,0.719,17,42,59,179,20,5,58,81
2403,1,1988,22,1,1,82,80,3249,438,1013,0.432,32,126,0.254,406,887,0.458,0.448,206,266,0.774,120,276,396,868,205,6,258,244
2403,2,1989,23,1,1,72,72,2477,479,1025,0.467,81,240,0.338,398,785,0.507,0.507,180,258,0.698,106,235,341,619,139,7,226,163
2403,3,1990,24,1,1,82,69,2428,327,749,0.437,35,131,0.267,292,618,0.472,0.46,120,165,0.727,106,212,318,604,109,4,211,121
2403,4,1991,25,1,1,72,21,1595,250,508,0.492,13,51,0.255,237,457,0.519,0.505,117,160,0.731,62,135,197,452,60,9,135,81
2403,5,1992,26,1,1,81,81,2461,367,747,0.491,11,43,0.256,356,704,0.506,0.499,171,222,0.77,95,210,305,694,112,13,211,153
2403,6,1993,27,1,1,82,81,3117,459,945,0.486,22,82,0.268,437,863,0.506,0.497,241,300,0.803,129,259,388,724,136,12,220,158
2403,7,1994,28,1,1,79,79,2711,331,732,0.452,36,127,0.283,295,605,0.488,0.477,167,211,0.791,107,241,348,678,120,6,232,115
2403,8,1995,29,1,1,82,67,2402,239,566,0.422,27,87,0.31,212,479,0.443,0.446,119,153,0.778,73,233,306,616,105,16,210,148
2403,9,1996,30,1,1,81,81,2643,296,626,0.473,64,149,0.43,232,477,0.486,0.524,150,191,0.785,66,241,307,635,100,5,201,153
2403,10,1997,31,1,1,30,30,1053,97,227,0.427,18,57,0.316,79,170,0.465,0.467,59,77,0.766,20,104,124,294,46,3,102,57
2403,10,1997,31,1,1,52,52,2001,192,452,0.425,48,121,0.397,144,331,0.435,0.478,109,136,0.801,71,200,271,641,51,9,172,104
2403,10,1997,31,1,1,82,82,3054,289,679,0.426,66,178,0.371,223,501,0.445,0.474,168,213,0.789,91,304,395,935,97,12,274,161
2403,11,1998,32,1,1,82,82,2413,249,598,0.416,43,137,0.314,206,461,0.447,0.452,137,180,0.761,67,255,322,713,84,2,174,132
2403,12,1999,33,1,1,49,49,1382,138,329,0.419,32,103,0.311,106,226,0.469,0.468,65,79,0.823,33,151,184,386,42,3,99,58
2403,13,2000,34,1,1,81,81,2190,246,570,0.432,89,221,0.403,157,349,0.45,0.51,79,98,0.806,63,233,296,650,76,10,174,111
2403,14,2001,35,1,1,29,28,786,74,180,0.411,13,42,0.31,61,138,0.442,0.447,9,17,0.529,21,99,120,163,21,0,58,56
2403,14,2001,35,1,1,54,54,1802,170,403,0.422,57,165,0.345,113,238,0.475,0.493,64,76,0.842,42,143,185,498,63,7,117,83
2403,14,2001,35,1,1,83,82,2588,244,583,0.419,70,207,0.338,174,376,0.463,0.479,73,93,0.785,63,242,305,661,84,7,175,139
2403,15,2002,36,1,1,82,82,2367,260,592,0.439,79,195,0.405,181,397,0.456,0.506,87,110,0.791,56,253,309,605,74,1,150,162
2403,16,2003,37,1,1,82,0,1467,147,369,0.398,27,95,0.284,120,274,0.438,0.435,61,80,0.763,34,142,176,375,48,3,152,90
2403,17,2004,38,1,1,42,3,577,34,100,0.34,7,41,0.171,27,59,0.458,0.375,28,39,0.718,10,60,70,119,17,1,53,41
2407,1,2012,21,1,1,45,0,501,51,159,0.321,13,62,0.21,38,97,0.392,0.362,25,29,0.862,14,39,53,71,25,1,36,31
2407,2,2013,22,1,1,70,0,993,149,325,0.458,24,104,0.231,125,221,0.566,0.495,52,62,0.839,21,145,166,122,29,13,53,84
2407,3,2014,23,1,1,80,36,2277,403,916,0.44,83,245,0.339,320,671,0.477,0.485,158,177,0.893,43,270,313,331,85,9,168,142
2407,4,2015,24,1,1,7,7,294,56,126,0.444,13,43,0.302,43,83,0.518,0.496,32,39,0.821,3,25,28,57,5,2,25,20
2415,1,2000,24,1,1,49,5,663,103,203,0.507,9,24,0.375,94,179,0.525,0.53,30,39,0.769,25,45,70,30,29,3,31,112
2415,1,2000,24,1,1,52,5,681,108,212,0.509,9,24,0.375,99,188,0.527,0.531,30,41,0.732,25,46,71,32,30,3,33,113
2426,2,2004,25,1,1,58,50,1760,185,477,0.388,51,150,0.34,134,327,0.41,0.441,74,101,0.733,44,131,175,281,93,20,115,132
2426,3,2005,26,1,1,50,41,1656,189,457,0.414,56,151,0.371,133,306,0.435,0.475,59,82,0.72,20,141,161,303,84,17,98,107
2426,4,2006,27,1,1,75,49,2102,226,566,0.399,40,133,0.301,186,433,0.43,0.435,95,138,0.688,60,173,233,293,108,21,127,189
2428,1,2006,29,1,1,75,15,1557,170,429,0.396,86,236,0.364,84,193,0.435,0.497,121,133,0.91,19,134,153,227,40,4,116,108
2428,2,2007,30,1,1,26,2,309,37,101,0.366,12,44,0.273,25,57,0.439,0.426,27,31,0.871,5,16,21,61,13,1,31,22
2434,1,2012,22,1,1,51,28,893,130,291,0.447,3,20,0.15,127,271,0.469,0.452,34,39,0.872,8,60,68,170,33,6,60,85
2434,2,2013,23,1,1,12,1,150,14,38,0.368,0,0,-1,14,38,0.368,0.368,2,4,0.5,3,8,11,16,6,1,2,4
2435,1,2005,30,1,1,15,0,104,15,45,0.333,0,9,0,15,36,0.417,0.333,12,13,0.923,3,6,9,9,5,1,7,6
2440,1,2010,20,1,1,82,82,2671,451,1216,0.371,145,388,0.374,306,828,0.37,0.431,223,273,0.817,49,233,282,470,105,18,200,191
2440,2,2011,21,1,1,63,61,2169,361,926,0.39,98,303,0.323,263,623,0.422,0.443,199,246,0.809,42,192,234,305,95,21,146,131
2440,3,2012,22,1,1,66,66,2331,469,1121,0.418,129,388,0.332,340,733,0.464,0.476,193,239,0.808,49,177,226,365,104,22,146,114
2440,4,2013,23,1,1,80,80,2897,497,1247,0.399,173,461,0.375,324,786,0.412,0.468,230,281,0.819,59,187,246,521,125,10,203,155
2440,5,2014,24,1,1,80,79,2728,423,1135,0.373,154,457,0.337,269,678,0.397,0.441,241,321,0.751,59,185,244,609,101,8,215,157
2440,6,2015,25,1,1,10,10,287,55,122,0.451,19,44,0.432,36,78,0.462,0.529,33,41,0.805,4,25,29,60,11,2,20,18
2441,1,1993,24,1,1,8,0,136,25,42,0.595,5,9,0.556,20,33,0.606,0.655,14,18,0.778,2,9,11,23,4,0,7,18
2441,2,1994,25,1,1,76,2,1097,138,342,0.404,56,151,0.371,82,191,0.429,0.485,100,120,0.833,16,73,89,218,65,0,74,62
2441,3,1995,26,1,1,80,24,1722,190,425,0.447,75,204,0.368,115,221,0.52,0.535,134,153,0.876,26,122,148,373,95,2,120,133
2443,1,2011,27,1,1,62,1,858,106,259,0.409,6,30,0.2,100,229,0.437,0.421,37,41,0.902,9,61,70,162,29,2,51,54
2448,1,2012,29,1,1,15,0,119,11,35,0.314,4,15,0.267,7,20,0.35,0.371,1,3,0.333,1,8,9,22,8,0,7,11
2451,1,2011,21,1,1,38,0,277,46,101,0.455,5,12,0.417,41,89,0.461,0.48,13,22,0.591,11,25,36,45,5,1,38,31
2451,2,2012,22,1,1,8,0,119,19,42,0.452,1,3,0.333,18,39,0.462,0.464,6,6,1,1,11,12,11,4,0,5,9
2451,2,2012,22,1,1,9,0,124,20,43,0.465,1,3,0.333,19,40,0.475,0.477,6,6,1,1,12,13,11,5,0,6,9
2455,1,1998,23,1,1,77,62,2266,226,609,0.371,42,128,0.328,184,481,0.383,0.406,80,110,0.727,51,120,171,329,64,6,120,188
2455,2,1999,24,1,1,49,2,885,91,225,0.404,5,19,0.263,86,206,0.417,0.416,57,82,0.695,16,59,75,107,35,7,65,67
2455,3,2000,25,1,1,18,4,214,26,61,0.426,1,5,0.2,25,56,0.446,0.434,9,15,0.6,6,6,12,13,10,2,8,17
2455,3,2000,25,1,1,38,2,423,36,103,0.35,1,6,0.167,35,97,0.361,0.354,19,24,0.792,15,24,39,59,23,2,24,41
2455,3,2000,25,1,1,56,6,637,62,164,0.378,2,11,0.182,60,153,0.392,0.384,28,39,0.718,21,30,51,72,33,4,32,58
2455,4,2001,26,1,1,28,0,232,27,81,0.333,1,2,0.5,26,79,0.329,0.34,11,16,0.688,7,14,21,44,6,1,14,21
2455,4,2001,26,1,1,25,0,279,26,71,0.366,0,3,0,26,68,0.382,0.366,12,17,0.706,3,20,23,34,17,5,20,41
2455,4,2001,26,1,1,53,0,511,53,152,0.349,1,5,0.2,52,147,0.354,0.352,23,33,0.697,10,34,44,78,23,6,34,62
2455,6,2003,28,1,1,66,2,842,103,231,0.446,13,35,0.371,90,196,0.459,0.474,51,74,0.689,13,65,78,86,37,5,41,93
2455,7,2004,29,1,1,73,7,1598,167,411,0.406,41,122,0.336,126,289,0.436,0.456,75,94,0.798,28,102,130,202,64,8,75,138
2455,8,2005,30,1,1,63,36,1747,203,456,0.445,41,108,0.38,162,348,0.466,0.49,85,113,0.752,32,147,179,302,59,15,96,144
2455,9,2006,31,1,1,75,53,1981,267,603,0.443,51,155,0.329,216,448,0.482,0.485,106,141,0.752,31,137,168,324,63,22,115,132
2455,10,2007,32,1,1,40,0,562,60,146,0.411,11,29,0.379,49,117,0.419,0.449,21,29,0.724,13,35,48,78,16,1,31,68
2455,10,2007,32,1,1,27,17,739,82,197,0.416,14,44,0.318,68,153,0.444,0.452,25,32,0.781,9,44,53,123,17,2,45,51
2455,10,2007,32,1,1,67,17,1301,142,343,0.414,25,73,0.342,117,270,0.433,0.45,46,61,0.754,22,79,101,201,33,3,76,119
2455,11,2008,33,1,1,27,11,410,40,88,0.455,15,30,0.5,25,58,0.431,0.54,9,11,0.818,5,34,39,60,10,1,34,29
2455,11,2008,33,1,1,42,41,1121,115,267,0.431,27,63,0.429,88,204,0.431,0.481,26,32,0.813,17,81,98,202,42,8,50,86
2455,11,2008,33,1,1,69,52,1531,155,355,0.437,42,93,0.452,113,262,0.431,0.496,35,43,0.814,22,115,137,262,52,9,84,115
2455,12,2009,34,1,1,80,12,1481,154,381,0.404,52,133,0.391,102,248,0.411,0.472,61,81,0.753,29,118,147,200,46,5,82,111
2455,13,2010,35,1,1,31,0,406,49,111,0.441,13,39,0.333,36,72,0.5,0.5,19,20,0.95,8,40,48,63,11,1,26,32
2456,1,1989,23,1,1,43,0,291,29,83,0.349,1,9,0.111,28,74,0.378,0.355,9,16,0.563,11,13,24,73,21,3,18,34
2456,2,1990,24,1,1,53,10,575,55,142,0.387,1,4,0.25,54,138,0.391,0.391,29,40,0.725,21,22,43,162,26,1,48,55
2456,3,1991,25,1,1,21,4,217,29,68,0.426,0,4,0,29,64,0.453,0.426,21,32,0.656,9,12,21,77,14,2,27,22
2456,3,1991,25,1,1,47,10,742,101,209,0.483,1,5,0.2,100,204,0.49,0.486,38,55,0.691,13,43,56,153,33,2,47,40
2456,3,1991,25,1,1,68,14,959,130,277,0.469,1,9,0.111,129,268,0.481,0.471,59,87,0.678,22,55,77,230,47,4,74,62
2456,4,1992,26,1,1,20,14,463,55,108,0.509,1,5,0.2,54,103,0.524,0.514,24,32,0.75,5,30,35,100,21,3,45,43
2456,4,1992,26,1,1,49,1,772,103,222,0.464,3,10,0.3,100,212,0.472,0.471,42,69,0.609,8,37,45,166,40,6,65,46
2456,4,1992,26,1,1,69,15,1235,158,330,0.479,4,15,0.267,154,315,0.489,0.485,66,101,0.653,13,67,80,266,61,9,110,89
2456,5,1993,27,1,1,75,49,2030,256,510,0.502,0,8,0,256,502,0.51,0.502,144,182,0.791,20,126,146,561,85,16,145,141
2456,6,1994,28,1,1,82,70,2332,356,724,0.492,0,12,0,356,712,0.5,0.492,178,253,0.704,41,135,176,433,113,8,172,160
2456,7,1995,29,1,1,82,82,3011,448,863,0.519,3,22,0.136,445,841,0.529,0.521,202,295,0.685,49,159,208,670,114,13,207,154
2456,8,1996,30,1,1,82,82,3084,438,887,0.494,6,31,0.194,432,856,0.505,0.497,189,262,0.721,37,169,206,789,119,21,195,179
2456,9,1997,31,1,1,76,76,2472,327,685,0.477,6,26,0.231,321,659,0.487,0.482,140,203,0.69,32,115,147,513,96,15,146,158
2456,10,1998,32,1,1,75,73,2674,321,671,0.478,2,13,0.154,319,658,0.485,0.48,122,168,0.726,30,120,150,591,84,18,165,140
2456,11,1999,33,1,1,50,50,1672,218,461,0.473,1,12,0.083,217,449,0.483,0.474,50,88,0.568,22,96,118,369,51,11,112,101
2456,12,2000,34,1,1,82,82,2571,402,850,0.473,1,9,0.111,401,841,0.477,0.474,114,155,0.735,33,125,158,491,76,18,140,150
2456,13,2001,35,1,1,55,20,1290,134,300,0.447,1,6,0.167,133,294,0.452,0.448,41,60,0.683,21,64,85,237,33,4,60,90
2456,14,2002,36,1,1,17,0,152,21,49,0.429,0,0,-1,21,49,0.429,0.429,12,17,0.706,0,5,5,28,5,1,9,17
2456,14,2002,36,1,1,51,13,1200,186,383,0.486,0,5,0,186,378,0.492,0.486,109,146,0.747,14,50,64,258,35,8,67,69
2456,14,2002,36,1,1,68,13,1352,207,432,0.479,0,5,0,207,427,0.485,0.479,121,163,0.742,14,55,69,286,40,9,76,86
2456,15,2003,37,1,1,48,0,430,63,150,0.42,0,2,0,63,148,0.426,0.42,30,39,0.769,10,21,31,64,15,1,29,26
2456,16,2004,38,1,1,46,1,637,80,199,0.402,0,3,0,80,196,0.408,0.402,52,78,0.667,3,30,33,111,26,3,51,34
2464,2,1981,26,1,1,79,-1,2615,532,1220,0.436,11,51,0.216,521,1169,0.446,0.441,411,501,0.82,160,203,363,291,136,61,208,244
2464,4,1983,28,1,1,77,74,2551,398,861,0.462,5,31,0.161,393,830,0.473,0.465,292,369,0.791,92,243,335,388,97,39,204,204
2464,6,1985,30,1,1,80,77,2976,493,1066,0.462,7,26,0.269,486,1040,0.467,0.466,261,306,0.853,91,226,317,543,96,39,212,224
2464,7,1986,31,1,1,78,78,2732,482,1060,0.455,6,42,0.143,476,1018,0.468,0.458,243,297,0.818,69,199,268,456,110,35,173,206
2464,8,1987,32,1,1,79,78,2933,423,953,0.444,7,62,0.113,416,891,0.467,0.448,209,251,0.833,45,216,261,594,87,38,177,201
2464,9,1988,33,1,1,77,74,2670,352,803,0.438,12,46,0.261,340,757,0.449,0.446,255,298,0.856,62,178,240,598,93,29,195,204
2464,10,1989,34,1,1,72,72,2309,277,638,0.434,7,50,0.14,270,588,0.459,0.44,160,195,0.821,31,159,190,472,94,21,175,211
2464,11,1990,35,1,1,75,65,2036,206,475,0.434,1,24,0.042,205,451,0.455,0.435,118,140,0.843,48,153,201,485,81,14,117,179
2468,1,1990,23,1,1,48,2,272,20,84,0.238,1,6,0.167,19,78,0.244,0.244,13,17,0.765,8,20,28,64,17,2,26,49
2496,2,1981,24,1,1,81,-1,2311,419,785,0.534,1,5,0.2,418,780,0.536,0.534,214,270,0.793,193,173,366,341,78,20,216,198
2509,2,2000,24,1,1,56,0,662,66,201,0.328,39,118,0.331,27,83,0.325,0.425,17,23,0.739,17,45,62,94,30,5,28,46
2514,1,1999,22,1,1,11,0,131,14,44,0.318,10,29,0.345,4,15,0.267,0.432,11,13,0.846,2,11,13,13,7,0,5,7
2514,1,1999,22,1,1,13,0,213,29,75,0.387,15,33,0.455,14,42,0.333,0.487,3,4,0.75,4,27,31,29,6,0,12,16
2514,1,1999,22,1,1,24,0,344,43,119,0.361,25,62,0.403,18,57,0.316,0.466,14,17,0.824,6,38,44,42,13,0,17,23
2514,2,2000,23,1,1,13,1,196,25,54,0.463,11,23,0.478,14,31,0.452,0.565,7,9,0.778,0,16,16,39,6,0,15,13
2514,2,2000,23,1,1,42,0,416,55,154,0.357,30,91,0.33,25,63,0.397,0.455,25,39,0.641,12,27,39,57,12,1,25,21
2514,2,2000,23,1,1,55,1,612,80,208,0.385,41,114,0.36,39,94,0.415,0.483,32,48,0.667,12,43,55,96,18,1,40,34
2514,3,2001,24,1,1,71,10,1415,170,416,0.409,84,231,0.364,86,185,0.465,0.51,37,52,0.712,16,108,124,224,36,1,76,58
2514,4,2002,25,1,1,67,0,1083,114,284,0.401,69,186,0.371,45,98,0.459,0.523,43,59,0.729,13,90,103,140,23,1,61,83
2514,5,2003,26,1,1,49,1,709,80,210,0.381,44,121,0.364,36,89,0.404,0.486,20,27,0.741,11,59,70,80,18,4,23,42
2514,6,2004,27,1,1,82,26,2016,210,524,0.401,98,273,0.359,112,251,0.446,0.494,55,72,0.764,15,155,170,478,30,4,103,92
2514,7,2005,28,1,1,82,66,2576,331,726,0.456,225,521,0.432,106,205,0.517,0.611,68,86,0.791,14,217,231,350,44,5,98,121
2514,8,2006,29,1,1,82,7,2089,190,491,0.387,140,371,0.377,50,120,0.417,0.53,32,50,0.64,14,119,133,169,37,1,55,112
2514,9,2007,30,1,1,60,0,1173,137,355,0.386,89,231,0.385,48,124,0.387,0.511,30,44,0.682,9,57,66,94,16,2,36,53
2514,11,2009,32,1,1,18,0,108,11,34,0.324,11,28,0.393,0,6,0,0.485,0,0,-1,0,6,6,7,3,0,6,4
2516,1,2011,22,1,1,18,0,135,14,45,0.311,0,4,0,14,41,0.341,0.311,14,17,0.824,6,19,25,19,5,3,10,7
2516,2,2012,23,1,1,33,1,268,29,73,0.397,1,8,0.125,28,65,0.431,0.404,29,37,0.784,9,35,44,42,10,5,28,28
2516,3,2013,24,1,1,29,3,338,40,109,0.367,1,9,0.111,39,100,0.39,0.372,35,53,0.66,18,27,45,83,14,2,38,29
2550,1,1980,25,1,1,82,-1,2657,437,1017,0.43,12,48,0.25,425,969,0.439,0.436,201,258,0.779,62,208,270,557,223,27,258,238
2550,2,1981,26,1,1,14,-1,239,30,73,0.411,3,10,0.3,27,63,0.429,0.432,24,32,0.75,5,13,18,46,24,1,23,29
2550,2,1981,26,1,1,60,-1,987,120,279,0.43,3,12,0.25,117,267,0.438,0.435,63,95,0.663,25,55,80,195,74,7,120,136
2550,2,1981,26,1,1,74,-1,1226,150,352,0.426,6,22,0.273,144,330,0.436,0.435,87,127,0.685,30,68,98,241,98,8,143,165
2550,3,1982,27,1,1,58,0,608,89,208,0.428,1,9,0.111,88,199,0.442,0.43,43,54,0.796,4,39,43,131,62,1,66,98
2550,4,1983,28,1,1,35,0,333,40,132,0.303,3,16,0.188,37,116,0.319,0.314,11,17,0.647,8,18,26,80,31,1,54,52
2550,5,1984,29,1,1,13,0,183,13,41,0.317,0,3,0,13,38,0.342,0.317,7,10,0.7,3,10,13,39,21,0,18,32
2550,5,1984,29,1,1,16,0,210,17,49,0.347,0,3,0,17,46,0.37,0.347,8,12,0.667,3,14,17,44,25,0,26,37
2556,1,2012,20,1,1,29,1,266,22,70,0.314,3,15,0.2,19,55,0.345,0.336,11,17,0.647,5,20,25,34,7,3,12,16
2556,2,2013,21,1,1,28,9,388,51,110,0.464,6,21,0.286,45,89,0.506,0.491,18,21,0.857,12,40,52,53,15,4,21,25
2556,4,2015,23,1,1,9,0,159,29,57,0.509,3,12,0.25,26,45,0.578,0.535,9,13,0.692,3,14,17,17,6,2,7,16
2571,1,1989,23,1,1,21,7,368,60,151,0.397,0,2,0,60,149,0.403,0.397,24,32,0.75,11,23,34,43,22,5,20,37
2574,1,1980,28,1,1,78,-1,2754,418,895,0.467,90,239,0.377,328,656,0.5,0.517,130,162,0.802,76,112,188,335,147,25,141,246
2574,2,1981,29,1,1,80,-1,2312,310,591,0.525,44,115,0.383,266,476,0.559,0.562,146,185,0.789,58,93,151,440,118,23,111,212
2574,3,1982,30,1,1,41,40,1274,165,328,0.503,23,63,0.365,142,265,0.536,0.538,90,110,0.818,26,70,96,229,47,9,82,113
2581,1,2009,23,1,1,51,5,771,110,267,0.412,13,40,0.325,97,227,0.427,0.436,56,81,0.691,22,65,87,106,36,0,73,84
2584,1,2013,22,1,1,38,0,221,32,87,0.368,6,13,0.462,26,74,0.351,0.402,15,27,0.556,2,16,18,21,13,0,25,25
2584,2,2014,23,1,1,23,3,270,31,91,0.341,3,12,0.25,28,79,0.354,0.357,24,30,0.8,3,12,15,36,12,1,31,29
2588,1,2013,19,1,1,48,0,392,43,113,0.381,4,23,0.174,39,90,0.433,0.398,9,16,0.563,3,41,44,63,9,7,35,47
2590,1,2010,21,1,1,71,3,719,90,227,0.396,7,32,0.219,83,195,0.426,0.412,41,49,0.837,5,62,67,122,34,11,50,82
2590,2,2011,22,1,1,70,7,963,133,304,0.438,18,48,0.375,115,256,0.449,0.467,77,97,0.794,11,91,102,138,45,25,64,82
2590,3,2012,23,1,1,66,66,2183,320,672,0.476,51,149,0.342,269,523,0.514,0.514,140,185,0.757,21,138,159,321,106,37,134,145
2590,4,2013,24,1,1,80,78,2628,439,974,0.451,89,248,0.359,350,726,0.482,0.496,199,226,0.881,25,155,180,579,117,28,230,181
2590,5,2014,25,1,1,79,79,2542,456,1040,0.438,74,225,0.329,382,815,0.469,0.474,318,376,0.846,34,174,208,528,89,17,232,158
2590,6,2015,26,1,1,9,9,294,46,105,0.438,5,19,0.263,41,86,0.477,0.462,38,47,0.809,3,15,18,67,13,4,31,19
2594,1,2000,22,1,1,81,27,1888,249,600,0.415,46,157,0.293,203,443,0.458,0.453,113,140,0.807,24,142,166,346,90,10,156,133
2594,4,2003,25,1,1,81,81,3081,488,1141,0.428,160,431,0.371,328,710,0.462,0.498,259,292,0.887,37,242,279,600,126,14,249,175
2594,5,2004,26,1,1,81,78,3018,499,1196,0.417,146,421,0.347,353,775,0.455,0.478,215,260,0.827,49,287,336,437,124,16,229,192
2594,6,2005,27,1,1,80,57,2401,372,743,0.501,103,245,0.42,269,498,0.54,0.57,146,173,0.844,38,150,188,429,109,15,147,177
2594,7,2006,28,1,1,80,80,2798,516,1099,0.47,171,416,0.411,345,683,0.505,0.547,168,210,0.8,31,127,158,306,100,27,135,196
2594,15,2014,36,1,1,35,0,570,55,152,0.362,39,103,0.379,16,49,0.327,0.49,10,15,0.667,4,33,37,56,13,0,27,48
2597,4,1983,25,1,1,82,81,2856,749,1567,0.478,21,91,0.231,728,1476,0.493,0.485,434,542,0.801,91,209,300,484,143,17,321,281
2597,5,1984,26,1,1,31,5,601,92,237,0.388,3,15,0.2,89,222,0.401,0.395,84,108,0.778,21,25,46,142,21,3,59,78
2597,5,1984,26,1,1,30,30,897,170,388,0.438,4,27,0.148,166,361,0.46,0.443,130,173,0.751,29,54,83,210,29,9,97,93
2597,5,1984,26,1,1,61,35,1498,262,625,0.419,7,42,0.167,255,583,0.437,0.425,214,281,0.762,50,79,129,352,50,12,156,171
2597,8,1987,29,1,1,79,76,2872,577,1223,0.472,17,78,0.218,560,1145,0.489,0.479,429,495,0.867,86,180,266,692,78,16,289,208
2605,1,1982,20,1,1,72,72,2433,453,1068,0.424,17,59,0.288,436,1009,0.432,0.432,302,429,0.704,57,152,209,565,150,17,299,253
2605,2,1983,21,1,1,81,81,3093,725,1537,0.472,36,125,0.288,689,1412,0.488,0.483,368,518,0.71,105,223,328,634,199,29,326,318
2605,3,1984,22,1,1,82,82,3007,669,1448,0.462,22,65,0.338,647,1383,0.468,0.47,388,529,0.733,103,224,327,914,204,33,307,324
2605,4,1985,23,1,1,81,81,3089,646,1410,0.458,29,113,0.257,617,1297,0.476,0.468,399,493,0.809,114,247,361,1123,187,25,302,288
2605,5,1986,24,1,1,77,77,2790,609,1248,0.488,26,84,0.31,583,1164,0.501,0.498,365,462,0.79,83,194,277,830,171,20,289,245
2605,6,1987,25,1,1,81,81,3013,626,1353,0.463,19,98,0.194,607,1255,0.484,0.47,400,521,0.768,82,237,319,813,153,20,343,251
2605,7,1988,26,1,1,81,81,2927,621,1341,0.463,30,97,0.309,591,1244,0.475,0.474,305,394,0.774,64,214,278,678,141,17,273,217
2605,8,1989,27,1,1,80,76,2924,569,1227,0.464,33,121,0.273,536,1106,0.485,0.477,287,351,0.818,49,224,273,663,133,20,298,209
2605,9,1990,28,1,1,81,81,2993,579,1322,0.438,42,136,0.309,537,1186,0.453,0.454,292,377,0.775,74,234,308,765,139,19,322,206
2605,10,1991,29,1,1,48,46,1657,289,665,0.435,19,65,0.292,270,600,0.45,0.449,179,229,0.782,35,125,160,446,75,10,185,118
2605,11,1992,30,1,1,78,78,2918,564,1264,0.446,25,86,0.291,539,1178,0.458,0.456,292,378,0.772,68,179,247,560,118,15,252,194
2605,12,1993,31,1,1,79,79,2922,526,1258,0.418,61,198,0.308,465,1060,0.439,0.442,278,377,0.737,71,161,232,671,123,18,284,222
2605,13,1994,32,1,1,58,56,1750,318,763,0.417,39,126,0.31,279,637,0.438,0.442,181,258,0.702,46,113,159,399,68,6,202,126
2606,1,2012,22,1,1,65,37,1656,256,571,0.448,83,219,0.379,173,352,0.491,0.521,154,185,0.832,48,120,168,266,53,8,105,121
2606,2,2013,23,1,1,79,62,2122,366,832,0.44,115,321,0.358,251,511,0.491,0.509,253,287,0.882,29,132,161,316,67,3,140,167
2606,3,2014,24,1,1,72,54,2497,496,1096,0.453,127,364,0.349,369,732,0.504,0.51,346,407,0.85,47,163,210,454,93,8,213,185
2606,4,2015,25,1,1,10,0,241,51,114,0.447,13,40,0.325,38,74,0.514,0.504,52,59,0.881,7,15,22,43,7,1,18,23
2623,1,1995,24,1,1,38,2,246,45,114,0.395,18,58,0.31,27,56,0.482,0.474,8,12,0.667,7,16,23,43,10,2,27,46
2623,2,1996,25,1,1,33,0,246,48,103,0.466,25,64,0.391,23,39,0.59,0.587,19,27,0.704,4,20,24,31,12,0,24,35
2623,3,1997,26,1,1,65,6,1047,162,405,0.4,97,244,0.398,65,161,0.404,0.52,24,38,0.632,18,78,96,179,55,2,86,125
2623,3,1997,26,1,1,67,6,1055,162,406,0.399,97,244,0.398,65,162,0.401,0.518,24,38,0.632,18,78,96,180,55,2,87,126
2623,4,1998,27,1,1,17,0,121,13,29,0.448,4,14,0.286,9,15,0.6,0.517,3,5,0.6,0,10,10,24,6,1,11,16
2623,4,1998,27,1,1,30,0,167,23,56,0.411,9,30,0.3,14,26,0.538,0.491,4,8,0.5,1,14,15,27,10,1,16,22
2641,1,1984,22,1,1,45,0,464,62,148,0.419,1,8,0.125,61,140,0.436,0.422,23,28,0.821,17,23,40,41,13,2,33,65
2641,2,1985,23,1,1,82,0,1304,188,416,0.452,4,22,0.182,184,394,0.467,0.457,66,90,0.733,21,78,99,175,80,16,99,171
2641,4,1987,25,1,1,28,8,668,108,261,0.414,7,16,0.438,101,245,0.412,0.427,42,53,0.792,18,39,57,82,32,4,47,76
2641,4,1987,25,1,1,40,0,778,131,273,0.48,0,16,0,131,257,0.51,0.48,53,66,0.803,8,43,51,177,42,9,42,88
2641,4,1987,25,1,1,68,8,1446,239,534,0.448,7,32,0.219,232,502,0.462,0.454,95,119,0.798,26,82,108,259,74,13,89,164
2641,5,1988,26,1,1,26,0,354,84,162,0.519,1,7,0.143,83,155,0.535,0.522,25,30,0.833,11,22,33,53,33,5,19,29
2641,5,1988,26,1,1,45,0,701,132,263,0.502,2,20,0.1,130,243,0.535,0.506,32,41,0.78,12,43,55,107,27,3,44,71
2641,5,1988,26,1,1,71,0,1055,216,425,0.508,3,27,0.111,213,398,0.535,0.512,57,71,0.803,23,65,88,160,60,8,63,100
2641,6,1989,27,1,1,63,0,1220,235,476,0.494,11,30,0.367,224,446,0.502,0.505,63,77,0.818,31,86,117,238,83,4,77,155
2641,7,1990,28,1,1,65,18,1481,303,599,0.506,8,32,0.25,295,567,0.52,0.513,130,157,0.828,43,72,115,216,65,8,77,164
2641,8,1991,29,1,1,80,57,2066,433,835,0.519,10,35,0.286,423,800,0.529,0.525,137,173,0.792,25,74,99,273,113,8,138,191
2641,9,1992,30,1,1,82,82,3070,509,1041,0.489,20,62,0.323,489,979,0.499,0.499,202,243,0.831,43,210,253,593,168,16,182,231
2641,10,1993,31,1,1,82,82,2893,522,1028,0.508,14,53,0.264,508,975,0.521,0.515,177,215,0.823,47,226,273,564,142,11,173,248
2641,11,1994,32,1,1,81,20,2278,411,852,0.482,5,33,0.152,406,819,0.496,0.485,138,155,0.89,28,125,153,344,110,19,106,186
2641,12,1995,33,1,1,59,2,1384,217,437,0.497,36,95,0.379,181,342,0.529,0.538,88,111,0.793,21,103,124,248,54,12,70,139
2641,13,1996,34,1,1,82,8,1687,241,526,0.458,60,169,0.355,181,357,0.507,0.515,54,71,0.761,20,75,95,269,68,11,74,178
2687,1,1990,25,1,1,11,0,115,11,38,0.289,0,2,0,11,36,0.306,0.289,4,4,1,4,4,8,23,8,0,12,6
2687,2,1991,26,1,1,70,1,1407,168,383,0.439,12,33,0.364,156,350,0.446,0.454,64,87,0.736,36,116,152,311,63,0,95,124
2687,3,1992,27,1,1,70,3,871,111,261,0.425,1,16,0.063,110,245,0.449,0.427,61,77,0.792,17,73,90,177,57,2,84,59
2700,1,1980,29,1,1,67,-1,1594,183,394,0.464,4,7,0.571,179,387,0.463,0.47,197,252,0.782,52,104,156,273,77,1,131,149
2702,1,1995,23,1,1,55,8,809,72,189,0.381,16,51,0.314,56,138,0.406,0.423,35,50,0.7,13,49,62,174,36,2,97,58
2705,1,2004,22,1,1,61,56,2126,371,798,0.465,16,53,0.302,355,745,0.477,0.475,233,312,0.747,85,162,247,275,86,34,196,140
2716,1,1984,22,1,1,82,0,1324,216,518,0.417,4,15,0.267,212,503,0.421,0.421,208,263,0.791,74,93,167,284,127,15,194,202
2716,2,1985,23,1,1,82,66,2489,430,989,0.435,0,17,0,430,972,0.442,0.435,243,347,0.7,128,150,278,408,167,21,204,244
2716,3,1986,24,1,1,81,35,2023,324,753,0.43,0,10,0,324,743,0.436,0.43,190,277,0.686,100,120,220,337,146,36,192,216
2716,4,1987,25,1,1,81,25,2020,358,742,0.482,0,4,0,358,738,0.485,0.482,272,365,0.745,157,170,327,282,120,37,187,229
2716,6,1989,27,1,1,79,78,2565,286,681,0.42,0,9,0,286,672,0.426,0.42,142,184,0.772,135,372,507,496,155,23,184,215
2716,7,1990,28,1,1,81,81,2883,316,696,0.454,2,21,0.095,314,675,0.465,0.455,138,201,0.687,173,541,714,652,139,30,173,220
2716,8,1991,29,1,1,71,65,2305,230,535,0.43,0,9,0,230,526,0.437,0.43,93,154,0.604,140,358,498,459,78,33,154,199
2716,10,1993,31,1,1,28,0,367,31,77,0.403,0,0,-1,31,77,0.403,0.403,10,20,0.5,18,21,39,44,23,2,12,51
2716,10,1993,31,1,1,37,2,511,34,96,0.354,0,1,0,34,95,0.358,0.354,12,26,0.462,22,36,58,53,33,2,25,63
2719,1,1980,28,1,1,76,-1,2422,258,568,0.454,1,9,0.111,257,559,0.46,0.455,195,243,0.802,78,209,287,607,155,12,157,202
2719,2,1981,29,1,1,41,-1,1172,72,169,0.426,2,9,0.222,70,160,0.438,0.432,88,111,0.793,22,80,102,253,52,1,85,105
2719,3,1982,30,1,1,77,54,1861,156,378,0.413,3,9,0.333,153,369,0.415,0.417,141,194,0.727,31,119,150,398,120,6,107,179
2719,4,1983,31,1,1,79,10,1388,114,250,0.456,2,12,0.167,112,238,0.471,0.46,116,149,0.779,30,106,136,264,78,3,104,134
2719,5,1984,32,1,1,34,0,378,32,90,0.356,2,5,0.4,30,85,0.353,0.367,24,27,0.889,8,23,31,81,20,3,31,37
2722,1,2012,21,1,1,66,25,1792,281,767,0.366,69,226,0.305,212,541,0.392,0.411,168,213,0.789,30,204,234,289,60,20,119,79
2722,2,2013,22,1,1,82,82,2859,526,1244,0.423,107,332,0.322,419,912,0.459,0.466,296,371,0.798,60,223,283,471,160,31,200,153
2722,3,2014,23,1,1,73,73,2614,449,1143,0.393,109,327,0.333,340,816,0.417,0.441,282,337,0.837,39,267,306,447,86,32,169,128
2722,4,2015,24,1,1,10,10,335,54,138,0.391,12,40,0.3,42,98,0.429,0.435,31,45,0.689,6,36,42,46,15,4,14,17
2726,1,2011,20,1,1,69,64,2606,398,972,0.409,34,115,0.296,364,857,0.425,0.427,301,393,0.766,35,282,317,574,121,35,261,175
2726,2,2012,21,1,1,66,66,2386,378,894,0.423,3,42,0.071,375,852,0.44,0.424,317,402,0.789,48,252,300,530,95,57,255,137
2726,3,2013,22,1,1,49,42,1602,324,735,0.441,12,45,0.267,312,690,0.452,0.449,246,306,0.804,35,161,196,373,65,37,157,117
2726,4,2014,23,1,1,82,82,2980,579,1337,0.433,108,308,0.351,471,1029,0.458,0.473,317,394,0.805,38,295,333,721,149,40,295,219
2726,5,2015,24,1,1,9,9,320,61,142,0.43,5,20,0.25,56,122,0.459,0.447,48,62,0.774,3,32,35,82,21,4,30,21
2733,7,2000,29,1,1,33,0,389,38,91,0.418,5,20,0.25,33,71,0.465,0.445,12,16,0.75,8,28,36,65,6,0,29,44
2738,1,1980,26,1,1,76,-1,1243,110,242,0.455,1,3,0.333,109,239,0.456,0.457,49,71,0.69,33,58,91,285,43,2,112,68
2738,2,1981,27,1,1,61,-1,821,90,218,0.413,0,1,0,90,217,0.415,0.413,26,33,0.788,13,35,48,208,32,2,80,45
2741,1,1996,25,1,1,62,1,787,87,218,0.399,33,99,0.333,54,119,0.454,0.475,37,54,0.685,29,73,102,132,54,6,79,98
2741,2,1997,26,1,1,79,21,1763,133,337,0.395,48,154,0.312,85,183,0.464,0.466,95,125,0.76,45,175,220,326,83,15,147,188
2741,3,1998,27,1,1,82,82,2317,235,516,0.455,81,215,0.377,154,301,0.512,0.534,91,113,0.805,32,242,274,466,144,37,175,195
2741,4,1999,28,1,1,50,50,1556,135,334,0.404,53,149,0.356,82,185,0.443,0.484,55,78,0.705,23,149,172,271,103,8,131,105
2741,5,2000,29,1,1,72,69,1986,189,447,0.423,102,264,0.386,87,183,0.475,0.537,48,58,0.828,22,206,228,300,95,16,102,176
2741,6,2001,30,1,1,61,33,1492,155,373,0.416,67,175,0.383,88,198,0.444,0.505,56,70,0.8,32,127,159,273,70,10,112,132
2741,7,2002,31,1,1,63,0,1058,113,303,0.373,53,164,0.323,60,139,0.432,0.46,47,58,0.81,15,112,127,203,68,14,75,100
2741,8,2003,32,1,1,66,6,1465,165,414,0.399,101,267,0.378,64,147,0.435,0.521,41,53,0.774,25,152,177,306,78,11,95,146
2741,9,2004,33,1,1,36,0,425,45,130,0.346,25,68,0.368,20,62,0.323,0.442,4,6,0.667,2,46,48,45,17,3,27,33
2741,9,2004,33,1,1,35,10,827,115,260,0.442,59,138,0.428,56,122,0.459,0.556,16,21,0.762,10,86,96,170,47,8,69,74
2741,9,2004,33,1,1,71,10,1252,160,390,0.41,84,206,0.408,76,184,0.413,0.518,20,27,0.741,12,132,144,215,64,11,96,107
2741,10,2005,34,1,1,14,13,360,24,77,0.312,16,51,0.314,8,26,0.308,0.416,11,13,0.846,6,33,39,43,15,0,18,22
2743,1,2014,24,1,1,9,0,116,18,42,0.429,7,21,0.333,11,21,0.524,0.512,5,6,0.833,0,9,9,10,8,0,5,11
2750,1,2011,21,1,1,19,0,134,13,35,0.371,5,15,0.333,8,20,0.4,0.443,6,8,0.75,1,11,12,27,6,0,8,16
2751,1,1983,23,1,1,43,20,727,65,171,0.38,0,5,0,65,166,0.392,0.38,42,57,0.737,15,54,69,126,21,8,71,103
2751,2,1984,24,1,1,32,0,254,27,66,0.409,1,3,0.333,26,63,0.413,0.417,8,16,0.5,5,17,22,43,9,3,20,37
2751,3,1985,25,1,1,58,1,713,85,173,0.491,1,4,0.25,84,169,0.497,0.494,44,57,0.772,10,48,58,153,23,6,70,85
2751,4,1986,26,1,1,31,5,658,81,172,0.471,2,10,0.2,79,162,0.488,0.477,53,67,0.791,10,56,66,109,25,2,48,76
2751,4,1986,26,1,1,36,5,685,85,182,0.467,3,12,0.25,82,170,0.482,0.475,54,68,0.794,10,59,69,115,27,2,53,79
2758,1,1987,23,1,1,72,61,1600,257,538,0.478,4,24,0.167,253,514,0.492,0.481,98,125,0.784,37,92,129,301,92,7,175,184
2758,2,1988,24,1,1,68,10,1379,245,547,0.448,11,49,0.224,234,498,0.47,0.458,132,189,0.698,54,64,118,206,91,4,141,163
2758,3,1989,25,1,1,54,8,1065,164,387,0.424,1,14,0.071,163,373,0.437,0.425,82,104,0.788,49,74,123,226,73,4,122,101
2767,1,2008,23,1,1,32,0,368,43,101,0.426,9,26,0.346,34,75,0.453,0.47,23,29,0.793,13,19,32,35,15,0,18,19
2767,2,2009,24,1,1,77,18,1883,257,562,0.457,48,120,0.4,209,442,0.473,0.5,168,193,0.87,39,153,192,206,96,4,92,137
2767,3,2010,25,1,1,65,15,1788,247,528,0.468,45,145,0.31,202,383,0.527,0.51,128,166,0.771,28,141,169,180,103,8,69,124
2767,4,2011,26,1,1,82,1,1091,146,394,0.371,44,112,0.393,102,282,0.362,0.426,69,93,0.742,16,78,94,186,55,11,73,82
2767,5,2012,27,1,1,49,25,1159,161,437,0.368,68,173,0.393,93,264,0.352,0.446,84,104,0.808,21,84,105,200,45,8,97,103
2767,6,2013,28,1,1,80,8,1521,192,459,0.418,88,214,0.411,104,245,0.424,0.514,71,91,0.78,38,107,145,161,66,12,69,123
2767,7,2014,29,1,1,63,5,1193,146,334,0.437,53,145,0.366,93,189,0.492,0.516,69,88,0.784,19,82,101,107,60,8,60,66
2768,1,2002,22,1,1,64,0,964,96,212,0.453,16,44,0.364,80,168,0.476,0.491,23,36,0.639,31,52,83,125,60,5,51,93
2768,2,2003,23,1,1,79,2,1366,170,391,0.435,31,91,0.341,139,300,0.463,0.474,62,86,0.721,46,118,164,225,89,14,88,138
2768,3,2004,24,1,1,81,14,1669,172,464,0.371,26,106,0.245,146,358,0.408,0.399,90,138,0.652,49,129,178,402,91,19,146,175
2768,4,2005,25,1,1,80,14,1808,236,554,0.426,52,163,0.319,184,391,0.471,0.473,91,138,0.659,35,129,164,359,83,19,167,184
2768,5,2006,26,1,1,24,0,603,98,227,0.432,42,100,0.42,56,127,0.441,0.524,38,52,0.731,7,65,72,129,31,3,61,64
2768,5,2006,26,1,1,46,10,975,121,282,0.429,68,172,0.395,53,110,0.482,0.55,37,59,0.627,17,69,86,160,37,7,75,95
2768,5,2006,26,1,1,70,10,1578,219,509,0.43,110,272,0.404,109,237,0.46,0.538,75,111,0.676,24,134,158,289,68,10,136,159
2768,6,2007,27,1,1,77,25,2152,263,687,0.383,92,280,0.329,171,407,0.42,0.45,108,147,0.735,34,151,185,437,99,23,167,152
2768,7,2008,28,1,1,78,73,2269,339,747,0.454,49,132,0.371,290,615,0.472,0.487,111,145,0.766,43,182,225,531,69,11,175,158
2768,8,2009,29,1,1,68,18,1776,174,453,0.384,20,85,0.235,154,368,0.418,0.406,80,106,0.755,36,147,183,391,50,11,156,137
2768,9,2010,30,1,1,79,52,2322,223,524,0.426,53,184,0.288,170,340,0.5,0.476,120,169,0.71,54,186,240,399,104,16,175,181
2768,10,2011,31,1,1,80,13,1567,126,307,0.41,36,107,0.336,90,200,0.45,0.469,55,82,0.671,52,130,182,278,61,17,116,146
2768,11,2012,32,1,1,50,2,1033,54,160,0.338,10,52,0.192,44,108,0.407,0.369,31,46,0.674,30,91,121,217,54,22,85,105
2768,12,2013,33,1,1,48,4,829,37,120,0.308,5,28,0.179,32,92,0.348,0.329,17,25,0.68,23,64,87,190,40,8,69,94
2768,13,2014,34,1,1,24,0,161,3,11,0.273,2,7,0.286,1,4,0.25,0.364,4,4,1,5,10,15,28,5,1,17,33
2770,1,2013,21,1,1,21,1,165,19,72,0.264,5,25,0.2,14,47,0.298,0.299,13,15,0.867,1,4,5,20,3,0,13,18
2770,1,2013,21,1,1,27,1,202,26,88,0.295,7,31,0.226,19,57,0.333,0.335,17,19,0.895,1,6,7,27,6,0,15,26
2794,1,1994,23,1,1,60,0,542,64,174,0.368,11,47,0.234,53,127,0.417,0.399,44,53,0.83,10,34,44,123,38,4,52,47
2794,2,1995,24,1,1,51,36,1380,128,313,0.409,51,119,0.429,77,194,0.397,0.49,71,94,0.755,31,86,117,266,82,9,87,144
2794,3,1996,25,1,1,82,53,2104,338,736,0.459,116,272,0.426,222,464,0.478,0.538,217,288,0.753,68,196,264,390,100,11,159,207
2794,4,1997,26,1,1,74,73,2991,456,974,0.468,103,286,0.36,353,688,0.513,0.521,225,288,0.781,67,197,264,537,162,13,211,221
2794,5,1998,27,1,1,81,81,2845,383,864,0.443,59,170,0.347,324,694,0.467,0.477,229,288,0.795,49,164,213,529,140,30,226,229
2794,6,1999,28,1,1,50,50,1848,243,545,0.446,61,170,0.359,182,375,0.485,0.502,159,191,0.832,23,138,161,322,100,10,142,130
2794,7,2000,29,1,1,82,82,2760,407,955,0.426,88,248,0.355,319,707,0.451,0.472,214,275,0.778,39,186,225,463,109,11,159,186
2800,2,2006,22,1,1,71,71,2418,333,684,0.487,84,218,0.385,249,466,0.534,0.548,86,101,0.851,57,232,289,329,84,46,133,197
2800,4,2008,24,1,1,35,5,727,97,250,0.388,19,56,0.339,78,194,0.402,0.426,26,39,0.667,13,83,96,113,30,10,66,44
2800,4,2008,24,1,1,26,26,806,99,225,0.44,29,79,0.367,70,146,0.479,0.504,41,52,0.788,18,79,97,116,29,19,51,59
2800,4,2008,24,1,1,61,31,1533,196,475,0.413,48,135,0.356,148,340,0.435,0.463,67,91,0.736,31,162,193,229,59,29,117,103
2800,7,2011,27,1,1,24,2,453,55,120,0.458,12,33,0.364,43,87,0.494,0.508,13,15,0.867,6,31,37,64,20,10,30,29
2800,8,2012,28,1,1,44,33,1060,166,360,0.461,27,76,0.355,139,284,0.489,0.499,62,70,0.886,13,88,101,139,58,11,76,67
2804,1,2009,20,1,1,82,65,2668,436,1095,0.398,35,129,0.271,401,966,0.415,0.414,349,428,0.815,178,221,399,435,110,16,274,191
2804,2,2010,21,1,1,82,82,2813,485,1160,0.418,23,104,0.221,462,1056,0.438,0.428,329,422,0.78,143,258,401,652,108,34,268,204
2804,3,2011,22,1,1,82,82,2847,614,1390,0.442,34,103,0.33,580,1287,0.451,0.454,531,631,0.842,121,258,379,670,155,30,316,207
2804,4,2012,23,1,1,66,66,2331,578,1266,0.457,62,196,0.316,516,1070,0.482,0.481,340,413,0.823,96,205,301,362,112,21,239,147
2804,5,2013,24,1,1,82,82,2861,673,1535,0.438,97,300,0.323,576,1235,0.466,0.47,460,575,0.8,111,317,428,607,145,24,273,189
2804,6,2014,25,1,1,46,46,1412,346,791,0.437,68,214,0.318,278,577,0.482,0.48,242,293,0.826,55,208,263,319,88,7,177,104
2808,1,1998,24,1,1,34,0,150,20,50,0.4,8,17,0.471,12,33,0.364,0.48,9,15,0.6,3,8,11,25,6,1,9,12
2808,2,1999,25,1,1,46,0,590,73,193,0.378,22,60,0.367,51,133,0.383,0.435,40,55,0.727,11,34,45,102,26,2,48,59
2809,1,1988,28,1,1,59,0,513,62,132,0.47,0,0,-1,62,132,0.47,0.47,25,34,0.735,19,21,40,103,36,2,52,37
2809,2,1989,29,1,1,8,0,143,24,42,0.571,0,0,-1,24,42,0.571,0.571,8,10,0.8,5,7,12,21,8,0,6,9
2809,2,1989,29,1,1,20,0,211,21,45,0.467,0,1,0,21,44,0.477,0.467,7,10,0.7,12,7,19,33,19,0,18,17
2809,2,1989,29,1,1,28,0,354,45,87,0.517,0,1,0,45,86,0.523,0.517,15,20,0.75,17,14,31,54,27,0,24,26
2819,1,1980,33,1,1,78,-1,2052,336,706,0.476,1,6,0.167,335,700,0.479,0.477,97,114,0.851,42,139,181,239,88,13,157,186
2819,2,1981,34,1,1,13,-1,236,36,82,0.439,0,0,-1,36,82,0.439,0.439,11,18,0.611,3,18,21,37,11,1,18,21
2821,1,1988,22,1,1,12,0,117,17,46,0.37,0,1,0,17,45,0.378,0.37,9,13,0.692,1,2,3,10,1,0,13,14
2821,1,1988,22,1,1,35,0,462,94,203,0.463,0,5,0,94,198,0.475,0.463,30,41,0.732,11,17,28,49,19,2,34,43
2821,1,1988,22,1,1,49,0,581,111,249,0.446,0,6,0,111,243,0.457,0.446,39,54,0.722,12,19,31,59,20,2,47,57
2824,1,1997,27,1,1,27,1,259,18,55,0.327,12,36,0.333,6,19,0.316,0.436,11,15,0.733,2,10,12,36,11,0,17,23
2829,1,1994,22,1,1,40,4,339,25,82,0.305,10,30,0.333,15,52,0.288,0.366,12,15,0.8,5,24,29,53,11,1,37,53
2829,2,1995,23,1,1,25,0,179,14,47,0.298,3,19,0.158,11,28,0.393,0.33,11,11,1,4,9,13,28,4,0,18,34
2829,3,1996,24,1,1,21,0,335,45,99,0.455,19,44,0.432,26,55,0.473,0.551,41,44,0.932,2,31,33,51,18,1,23,46
2829,4,1997,25,1,1,82,1,1117,139,330,0.421,58,163,0.356,81,167,0.485,0.509,94,113,0.832,13,91,104,182,49,4,68,100
2829,5,1998,26,1,1,82,6,1073,126,355,0.355,52,169,0.308,74,186,0.398,0.428,118,129,0.915,16,99,115,196,34,6,65,106
2829,6,1999,27,1,1,39,1,441,64,156,0.41,32,95,0.337,32,61,0.525,0.513,27,31,0.871,8,39,47,69,18,2,36,49
2829,7,2000,28,1,1,82,15,1627,217,521,0.417,96,255,0.376,121,266,0.455,0.509,112,132,0.848,20,114,134,313,55,5,107,166
2829,8,2001,29,1,1,59,31,1532,182,470,0.387,93,248,0.375,89,222,0.401,0.486,101,113,0.894,12,94,106,248,55,3,103,150
2829,9,2002,30,1,1,82,81,2171,274,656,0.418,131,323,0.406,143,333,0.429,0.518,154,175,0.88,11,141,152,314,72,6,85,182
2829,10,2003,31,1,1,22,1,290,30,88,0.341,7,36,0.194,23,52,0.442,0.381,11,12,0.917,2,19,21,21,12,1,16,15
2829,10,2003,31,1,1,29,20,762,94,261,0.36,43,128,0.336,51,133,0.383,0.443,46,57,0.807,1,45,46,124,17,1,55,77
2829,10,2003,31,1,1,51,21,1052,124,349,0.355,50,164,0.305,74,185,0.4,0.427,57,69,0.826,3,64,67,145,29,2,71,92
2829,11,2004,32,1,1,16,5,186,17,45,0.378,8,18,0.444,9,27,0.333,0.467,5,5,1,3,12,15,14,6,2,6,6
2838,1,1989,22,1,1,51,1,408,46,114,0.404,6,24,0.25,40,90,0.444,0.43,13,16,0.813,13,34,47,76,25,6,34,61
2838,2,1990,23,1,1,40,2,638,92,208,0.442,17,46,0.37,75,162,0.463,0.483,28,38,0.737,13,39,52,114,45,3,63,65
2838,3,1991,24,1,1,34,0,350,45,108,0.417,6,12,0.5,39,96,0.406,0.444,17,25,0.68,4,13,17,73,24,0,34,37
2838,4,1992,25,1,1,41,19,767,71,160,0.444,14,38,0.368,57,122,0.467,0.488,21,30,0.7,22,51,73,166,43,3,52,73
2838,4,1992,25,1,1,53,19,870,83,193,0.43,14,42,0.333,69,151,0.457,0.466,24,35,0.686,24,57,81,180,47,3,60,89
2838,5,1993,26,1,1,25,2,354,26,81,0.321,15,51,0.294,11,30,0.367,0.414,5,8,0.625,9,26,35,81,26,2,29,49
2838,5,1993,26,1,1,33,13,641,70,173,0.405,39,103,0.379,31,70,0.443,0.517,12,18,0.667,20,36,56,100,39,1,51,78
2838,5,1993,26,1,1,58,15,995,96,254,0.378,54,154,0.351,42,100,0.42,0.484,17,26,0.654,29,62,91,181,65,3,80,127
2838,6,1994,27,1,1,12,0,124,6,21,0.286,2,6,0.333,4,15,0.267,0.333,0,0,-1,0,6,6,16,13,0,11,17
2838,6,1994,27,1,1,16,0,158,9,29,0.31,3,10,0.3,6,19,0.316,0.362,0,0,-1,0,10,10,23,15,0,17,21
2838,7,1995,28,1,1,38,2,407,47,111,0.423,29,75,0.387,18,36,0.5,0.554,7,10,0.7,6,33,39,69,21,1,19,44
2838,7,1995,28,1,1,43,2,424,50,117,0.427,30,79,0.38,20,38,0.526,0.556,7,10,0.7,6,37,43,75,22,2,23,44
2856,1,1993,22,1,1,35,0,242,31,85,0.365,1,3,0.333,30,82,0.366,0.371,18,22,0.818,19,12,31,23,4,2,11,24
2857,1,2006,21,1,1,80,47,2307,339,805,0.421,91,219,0.416,248,586,0.423,0.478,95,135,0.704,35,159,194,359,60,17,145,233
2857,2,2007,22,1,1,80,80,2950,494,1083,0.456,82,255,0.322,412,828,0.498,0.494,227,296,0.767,41,226,267,745,78,13,246,254
2857,3,2008,23,1,1,82,82,3059,566,1117,0.507,83,210,0.395,483,907,0.533,0.544,330,411,0.803,34,209,243,862,90,23,279,200
2857,4,2009,24,1,1,68,68,2505,463,984,0.471,70,226,0.31,393,758,0.518,0.506,326,384,0.849,24,171,195,725,73,20,228,134
2857,5,2010,25,1,1,76,76,2802,494,1053,0.469,96,259,0.371,398,794,0.501,0.515,335,418,0.801,50,253,303,798,96,16,252,208
2857,6,2011,26,1,1,12,12,456,59,169,0.349,16,59,0.271,43,110,0.391,0.396,46,58,0.793,8,47,55,153,15,3,43,38
2857,6,2011,26,1,1,53,53,2009,369,806,0.458,89,258,0.345,280,548,0.511,0.513,302,354,0.853,32,173,205,514,64,12,187,152
2857,6,2011,26,1,1,65,65,2465,428,975,0.439,105,317,0.331,323,658,0.491,0.493,348,412,0.845,40,220,260,667,79,15,230,190
2857,7,2012,27,1,1,55,55,1999,391,961,0.407,115,342,0.336,276,619,0.446,0.467,257,305,0.843,23,160,183,481,67,20,219,121
2857,8,2013,28,1,1,78,78,2842,495,1124,0.44,169,447,0.378,326,677,0.482,0.516,317,369,0.859,29,203,232,604,75,30,218,194
2857,9,2014,29,1,1,64,58,2059,322,716,0.45,98,268,0.366,224,448,0.5,0.518,173,216,0.801,15,153,168,392,93,13,143,148
2857,10,2015,30,1,1,9,9,333,60,125,0.48,12,34,0.353,48,91,0.527,0.528,36,40,0.9,1,24,25,58,9,3,25,23
2859,1,1980,23,1,1,77,-1,1794,232,519,0.447,0,12,0,232,507,0.458,0.447,42,60,0.7,21,85,106,183,100,11,107,166
2861,1,2003,22,1,1,21,0,167,9,33,0.273,6,16,0.375,3,17,0.176,0.364,4,6,0.667,3,15,18,34,7,2,17,20
2861,2,2004,23,1,1,56,3,714,80,208,0.385,18,60,0.3,62,148,0.419,0.428,41,48,0.854,8,45,53,121,25,6,63,58
2865,1,2003,21,1,1,75,54,1961,273,685,0.399,65,202,0.322,208,483,0.431,0.446,103,161,0.64,27,168,195,350,86,17,171,179
2868,1,2010,26,1,1,54,6,742,81,206,0.393,30,93,0.323,51,113,0.451,0.466,32,45,0.711,16,67,83,34,12,5,18,73
2875,1,2006,19,1,1,30,0,145,23,52,0.442,2,9,0.222,21,43,0.488,0.462,8,13,0.615,3,16,19,10,5,0,13,13
2875,2,2007,20,1,1,61,0,688,93,211,0.441,12,37,0.324,81,174,0.466,0.469,64,92,0.696,17,53,70,110,22,1,46,42
2875,3,2008,21,1,1,80,0,1862,319,752,0.424,55,153,0.359,264,599,0.441,0.461,227,290,0.783,41,126,167,253,81,13,125,130
2875,5,2010,23,1,1,64,38,1912,318,677,0.47,70,206,0.34,248,471,0.527,0.521,192,233,0.824,25,162,187,268,80,15,106,110
2875,7,2012,25,1,1,64,0,1682,318,782,0.407,83,229,0.362,235,553,0.425,0.46,237,292,0.812,30,125,155,221,53,18,71,90
2875,9,2014,27,1,1,60,7,1445,197,493,0.4,79,231,0.342,118,262,0.45,0.48,152,179,0.849,10,114,124,210,45,4,92,65
2876,1,2007,21,1,1,79,2,1315,208,526,0.395,46,163,0.282,162,363,0.446,0.439,72,85,0.847,29,134,163,260,29,2,142,96
2876,2,2008,22,1,1,53,7,854,111,293,0.379,54,142,0.38,57,151,0.377,0.471,37,47,0.787,14,87,101,140,25,3,75,52
2876,3,2010,24,1,1,62,1,872,104,271,0.384,24,81,0.296,80,190,0.421,0.428,37,55,0.673,13,80,93,161,32,1,74,43
2882,2,2005,22,1,1,80,80,2254,323,737,0.438,32,99,0.323,291,638,0.456,0.46,136,160,0.85,50,194,244,484,74,11,196,221
2882,3,2006,23,1,1,58,12,1531,267,629,0.424,73,191,0.382,194,438,0.443,0.483,96,113,0.85,30,113,143,230,52,7,105,146
2882,4,2007,24,1,1,68,68,2472,468,1049,0.446,79,228,0.346,389,821,0.474,0.484,159,186,0.855,54,275,329,416,85,6,203,201
2882,5,2008,25,1,1,66,66,2410,441,919,0.48,89,231,0.385,352,688,0.512,0.528,166,194,0.856,37,193,230,419,78,10,182,188
2882,6,2009,26,1,1,81,81,2834,526,1126,0.467,183,420,0.436,343,706,0.486,0.548,208,228,0.912,47,232,279,329,69,9,179,215
2882,7,2010,27,1,1,69,68,2359,378,855,0.442,159,371,0.429,219,484,0.452,0.535,177,198,0.894,28,178,206,368,70,21,173,170
2882,8,2011,28,1,1,22,22,723,113,268,0.422,43,108,0.398,70,160,0.438,0.502,66,75,0.88,6,50,56,123,20,0,66,59
2882,8,2011,28,1,1,36,34,1065,178,462,0.385,36,136,0.265,142,326,0.436,0.424,85,102,0.833,15,82,97,257,33,10,105,91
2882,8,2011,28,1,1,58,56,1788,291,730,0.399,79,244,0.324,212,486,0.436,0.453,151,177,0.853,21,132,153,380,53,10,171,150
2882,10,2013,30,1,1,46,46,1418,229,533,0.43,59,154,0.383,170,379,0.449,0.485,75,85,0.882,24,86,110,285,46,9,125,105
2882,11,2014,31,1,1,74,0,1834,280,672,0.417,83,225,0.369,197,447,0.441,0.478,78,89,0.876,42,111,153,321,55,10,149,197
2882,12,2015,32,1,1,9,0,199,23,68,0.338,3,19,0.158,20,49,0.408,0.36,13,16,0.813,3,11,14,42,5,4,18,23
2884,1,1980,25,1,1,82,-1,2582,687,1384,0.496,7,37,0.189,680,1347,0.505,0.499,333,423,0.787,149,263,412,512,167,24,256,295
2884,2,1981,26,1,1,79,-1,2742,616,1335,0.461,16,68,0.235,600,1267,0.474,0.467,312,382,0.817,122,199,321,432,185,37,235,270
2884,4,1983,28,1,1,72,68,2170,419,1068,0.392,15,74,0.203,404,994,0.406,0.399,256,333,0.769,93,234,327,569,120,26,335,248
2884,6,1985,30,1,1,23,5,459,55,143,0.385,6,23,0.261,49,120,0.408,0.406,31,46,0.674,16,41,57,90,30,5,42,56
2884,7,1986,31,1,1,19,13,367,57,143,0.399,4,11,0.364,53,132,0.402,0.413,41,48,0.854,19,26,45,67,28,1,41,48
2884,7,1986,31,1,1,23,8,397,50,131,0.382,2,6,0.333,48,125,0.384,0.389,62,64,0.969,13,24,37,111,28,3,51,64
2884,7,1986,31,1,1,47,21,827,117,306,0.382,6,19,0.316,111,287,0.387,0.392,115,126,0.913,35,51,86,187,61,4,101,124
2884,8,1987,32,1,1,32,14,800,131,290,0.452,7,28,0.25,124,262,0.473,0.464,49,60,0.817,26,49,75,185,38,9,94,111
2888,1,1983,21,1,1,74,33,1443,191,468,0.408,2,15,0.133,189,453,0.417,0.41,131,174,0.753,37,99,136,361,89,12,185,221
2888,2,1984,22,1,1,79,66,1924,309,671,0.461,15,47,0.319,294,624,0.471,0.472,171,209,0.818,54,140,194,464,84,5,169,268
2903,1,2000,25,1,1,25,1,508,61,179,0.341,29,98,0.296,32,81,0.395,0.422,39,51,0.765,11,40,51,66,23,2,37,32
2915,1,1988,23,1,1,18,1,373,36,99,0.364,9,25,0.36,27,74,0.365,0.409,23,29,0.793,1,25,26,63,17,3,21,34
2915,1,1988,23,1,1,24,1,420,43,110,0.391,10,26,0.385,33,84,0.393,0.436,29,40,0.725,2,25,27,69,23,3,25,40
2931,1,2014,22,1,1,58,31,1309,170,389,0.437,18,62,0.29,152,327,0.465,0.46,59,90,0.656,33,116,149,187,35,15,57,67
2941,1,1993,22,1,1,41,1,174,23,66,0.348,3,14,0.214,20,52,0.385,0.371,19,26,0.731,6,8,14,40,14,1,16,26
2941,2,1994,23,1,1,40,0,352,49,133,0.368,27,78,0.346,22,55,0.4,0.47,20,35,0.571,13,16,29,71,24,2,34,40
2941,3,1995,24,1,1,62,3,495,37,117,0.316,22,74,0.297,15,43,0.349,0.41,28,38,0.737,10,34,44,134,41,0,55,87
2950,1,1981,23,1,1,64,-1,945,95,192,0.495,0,4,0,95,188,0.505,0.495,45,60,0.75,22,93,115,115,57,6,91,115
2959,1,1980,25,1,1,76,-1,1286,229,500,0.458,4,16,0.25,225,484,0.465,0.462,96,108,0.889,40,82,122,222,49,18,108,144
2959,2,1981,26,1,1,45,-1,997,140,303,0.462,2,7,0.286,138,296,0.466,0.465,53,66,0.803,26,62,88,153,42,7,74,114
2977,1,1994,22,1,1,81,80,2700,413,1049,0.394,123,364,0.338,290,685,0.423,0.452,150,192,0.781,47,191,238,466,85,8,145,154
2977,2,1995,23,1,1,80,80,2944,465,1107,0.42,183,511,0.358,282,596,0.473,0.503,235,300,0.783,27,196,223,660,97,6,220,157
2977,3,1996,24,1,1,74,74,2513,396,950,0.417,144,403,0.357,252,547,0.461,0.493,163,204,0.799,29,152,181,509,70,10,156,115
2977,4,1997,25,1,1,79,79,2937,432,1075,0.402,177,468,0.378,255,607,0.42,0.484,165,200,0.825,44,182,226,672,75,10,212,110
2977,5,1998,26,1,1,64,46,2053,311,743,0.419,123,316,0.389,188,427,0.44,0.501,136,172,0.791,31,163,194,442,64,6,104,120
2977,6,1999,27,1,1,50,50,1802,306,769,0.398,72,234,0.308,234,535,0.437,0.445,142,175,0.811,14,99,113,368,40,3,121,90
2977,7,2000,28,1,1,79,79,2950,473,1213,0.39,133,401,0.332,340,812,0.419,0.445,196,240,0.817,34,277,311,714,68,11,221,148
2977,8,2001,29,1,1,71,70,2688,460,1112,0.414,135,358,0.377,325,754,0.431,0.474,204,249,0.819,44,197,241,600,61,18,165,109
2977,9,2002,30,1,1,45,44,1739,372,912,0.408,85,252,0.337,287,660,0.435,0.454,136,174,0.782,19,150,169,365,30,7,116,69
2977,9,2002,30,1,1,72,46,2496,501,1226,0.409,119,350,0.34,382,876,0.436,0.457,201,251,0.801,28,226,254,478,44,11,156,104
2977,11,2004,32,1,1,39,29,1255,187,479,0.39,46,150,0.307,141,329,0.429,0.438,70,99,0.707,16,88,104,206,20,2,78,57
2977,13,2006,34,1,1,65,2,986,136,343,0.397,55,154,0.357,81,189,0.429,0.477,28,41,0.683,6,85,91,123,16,3,57,60
2986,3,2013,26,1,1,78,78,2685,438,1012,0.433,83,243,0.342,355,769,0.462,0.474,124,154,0.805,43,294,337,704,66,6,247,190
2986,4,2014,27,1,1,18,18,465,65,150,0.433,16,50,0.32,49,100,0.49,0.487,30,32,0.938,5,29,34,95,6,1,27,38
2986,5,2015,28,1,1,10,0,185,29,85,0.341,9,36,0.25,20,49,0.408,0.394,14,15,0.933,2,23,25,21,7,0,13,18
2988,1,2001,27,1,1,22,0,411,46,110,0.418,0,6,0,46,104,0.442,0.418,30,50,0.6,15,22,37,66,23,3,37,44
2995,1,1998,22,1,1,45,0,419,44,122,0.361,3,8,0.375,41,114,0.36,0.373,48,68,0.706,4,34,38,84,9,1,56,63
2995,2,2000,24,1,1,78,0,884,109,262,0.416,14,34,0.412,95,228,0.417,0.443,57,76,0.75,11,54,65,121,32,0,77,92
2995,3,2001,25,1,1,82,0,1620,170,393,0.433,30,78,0.385,140,315,0.444,0.471,128,164,0.78,18,132,150,323,48,3,129,145
2995,4,2002,26,1,1,82,16,1856,206,438,0.47,24,54,0.444,182,384,0.474,0.498,104,126,0.825,18,150,168,349,65,2,112,183
2995,5,2003,27,1,1,80,48,1686,184,411,0.448,8,34,0.235,176,377,0.467,0.457,97,125,0.776,26,92,118,232,64,2,97,169
2995,6,2004,28,1,1,71,6,1271,107,277,0.386,3,20,0.15,104,257,0.405,0.392,53,68,0.779,12,104,116,195,44,2,84,126
2995,9,2007,31,1,1,64,4,760,71,167,0.425,1,2,0.5,70,165,0.424,0.428,49,65,0.754,8,60,68,131,24,2,40,74
2995,10,2008,32,1,1,74,9,1139,121,283,0.428,3,10,0.3,118,273,0.432,0.433,61,80,0.763,13,61,74,159,23,1,54,97
2995,11,2009,33,1,1,30,0,292,24,75,0.32,1,1,1,23,74,0.311,0.327,16,18,0.889,4,18,22,55,6,0,15,26
3001,2,1987,23,1,1,46,5,374,60,136,0.441,0,0,-1,60,136,0.441,0.441,51,55,0.927,5,22,27,59,13,1,33,33
3001,3,1988,24,1,1,43,0,548,72,152,0.474,5,13,0.385,67,139,0.482,0.49,46,60,0.767,17,32,49,137,21,4,52,63
3001,3,1988,24,1,1,29,27,953,138,309,0.447,3,8,0.375,135,301,0.449,0.451,99,107,0.925,18,85,103,244,34,12,84,82
3001,3,1988,24,1,1,72,27,1501,210,461,0.456,8,21,0.381,202,440,0.459,0.464,145,167,0.868,35,117,152,381,55,16,136,145
3001,4,1989,25,1,1,70,56,1703,274,566,0.484,2,17,0.118,272,549,0.495,0.486,106,129,0.822,34,156,190,335,53,10,142,124
3001,5,1990,26,1,1,63,45,1657,258,564,0.457,1,14,0.071,257,550,0.467,0.458,188,214,0.879,37,157,194,354,65,20,132,108
3001,6,1991,27,1,1,49,17,975,152,353,0.431,3,19,0.158,149,334,0.446,0.435,99,120,0.825,17,90,107,197,30,5,91,74
3001,7,1992,28,1,1,39,18,885,150,349,0.43,1,13,0.077,149,336,0.443,0.431,110,130,0.846,19,82,101,148,35,4,72,55
3019,1,2003,23,1,1,64,1,504,48,116,0.414,10,31,0.323,38,85,0.447,0.457,26,35,0.743,16,43,59,47,17,6,29,53
3031,1,2002,20,1,1,36,4,560,73,199,0.367,7,27,0.259,66,172,0.384,0.384,36,46,0.783,17,35,52,108,31,1,53,43
3031,2,2003,21,1,1,22,6,420,51,165,0.309,5,28,0.179,46,137,0.336,0.324,16,23,0.696,12,23,35,53,18,2,36,30
3031,2,2003,21,1,1,39,6,502,55,183,0.301,5,28,0.179,50,155,0.323,0.314,17,25,0.68,16,27,43,68,20,2,43,36
3070,12,1995,33,1,1,80,1,1528,265,583,0.455,79,203,0.389,186,380,0.489,0.522,193,227,0.85,18,133,151,108,61,13,119,123
3082,1,2012,20,1,1,28,0,237,25,72,0.347,2,15,0.133,23,57,0.404,0.361,11,14,0.786,2,13,15,30,7,0,29,17
3091,1,2008,21,1,1,17,7,450,51,117,0.436,3,7,0.429,48,110,0.436,0.449,32,41,0.78,8,50,58,127,17,3,36,26
3091,2,2009,22,1,1,79,39,2173,345,775,0.445,6,34,0.176,339,741,0.457,0.449,281,354,0.794,64,205,269,452,83,7,152,158
3091,3,2010,23,1,1,82,1,1732,253,555,0.456,1,15,0.067,252,540,0.467,0.457,167,233,0.717,58,156,214,258,55,5,137,137
3091,4,2011,24,1,1,81,38,2133,362,776,0.466,3,15,0.2,359,761,0.472,0.468,348,423,0.823,46,209,255,419,60,8,178,93
3091,5,2012,25,1,1,23,19,701,101,211,0.479,17,35,0.486,84,176,0.477,0.519,72,101,0.713,14,73,87,142,17,2,59,37
3091,5,2012,25,1,1,41,4,1006,141,354,0.398,26,62,0.419,115,292,0.394,0.435,122,147,0.83,19,108,127,212,27,1,82,63
3091,5,2012,25,1,1,64,23,1707,242,565,0.428,43,97,0.443,199,468,0.425,0.466,194,248,0.782,33,181,214,354,44,3,141,100
3091,7,2014,27,1,1,28,12,909,140,304,0.461,20,56,0.357,120,248,0.484,0.493,143,170,0.841,16,70,86,134,16,3,55,40
3091,7,2014,27,1,1,55,7,1305,190,465,0.409,15,68,0.221,175,397,0.441,0.425,183,234,0.782,22,95,117,206,33,6,93,50
3091,7,2014,27,1,1,83,19,2214,330,769,0.429,35,124,0.282,295,645,0.457,0.452,326,404,0.807,38,165,203,340,49,9,148,90
3091,8,2015,28,1,1,10,1,155,14,44,0.318,3,8,0.375,11,36,0.306,0.352,25,29,0.862,2,10,12,16,4,0,13,11
3098,1,1998,21,1,1,20,0,146,19,58,0.328,0,2,0,19,56,0.339,0.328,23,30,0.767,2,5,7,36,7,1,21,27
3117,1,1983,23,1,1,64,37,1624,171,421,0.406,1,13,0.077,170,408,0.417,0.407,52,80,0.65,43,106,149,311,96,14,104,112
3123,1,2012,21,1,1,59,35,1705,214,534,0.401,48,157,0.306,166,377,0.44,0.446,87,109,0.798,42,144,186,164,101,8,111,173
3127,1,1981,24,1,1,47,-1,450,34,95,0.358,0,5,0,34,90,0.378,0.358,25,32,0.781,11,32,43,70,23,1,28,38
3127,2,1982,25,1,1,51,0,800,91,194,0.469,1,9,0.111,90,185,0.486,0.472,29,38,0.763,14,41,55,117,33,1,42,63
3127,3,1983,26,1,1,78,58,2435,316,661,0.478,3,18,0.167,313,643,0.487,0.48,92,107,0.86,33,122,155,433,104,2,138,185
3127,4,1984,27,1,1,80,80,2497,397,746,0.532,6,20,0.3,391,726,0.539,0.536,117,135,0.867,44,127,171,457,90,8,144,179
3127,5,1985,28,1,1,70,25,1808,325,624,0.521,9,37,0.243,316,587,0.538,0.528,112,128,0.875,24,90,114,264,47,4,102,116
3127,6,1986,29,1,1,82,7,1596,235,412,0.57,6,16,0.375,229,396,0.578,0.578,61,66,0.924,27,77,104,188,50,0,73,118
3127,7,1987,30,1,1,78,15,1566,202,398,0.508,7,26,0.269,195,372,0.524,0.516,37,42,0.881,22,69,91,187,40,1,61,124
3127,8,1988,31,1,1,28,0,324,49,90,0.544,8,14,0.571,41,76,0.539,0.589,9,11,0.818,4,11,15,33,7,0,8,30
3127,8,1988,31,1,1,24,1,370,44,82,0.537,2,8,0.25,42,74,0.568,0.549,8,12,0.667,5,16,21,60,14,0,14,30
3127,8,1988,31,1,1,52,1,694,93,172,0.541,10,22,0.455,83,150,0.553,0.57,17,23,0.739,9,27,36,93,21,0,22,60
3127,9,1989,32,1,1,25,1,390,46,104,0.442,3,12,0.25,43,92,0.467,0.457,7,8,0.875,9,20,29,59,15,0,25,17
3127,10,1990,33,1,1,34,8,469,50,119,0.42,3,12,0.25,47,107,0.439,0.433,15,18,0.833,3,16,19,92,16,2,22,39
3127,10,1990,33,1,1,35,8,496,50,125,0.4,3,12,0.25,47,113,0.416,0.412,18,22,0.818,3,16,19,94,16,2,22,40
3132,1,1980,30,1,1,77,-1,2293,513,999,0.514,0,4,0,513,995,0.516,0.514,339,382,0.887,45,122,167,347,61,14,192,206
3132,2,1981,31,1,1,75,-1,2055,476,997,0.477,0,2,0,476,995,0.478,0.477,374,440,0.85,44,187,231,285,51,12,159,129
3152,1,2009,23,1,1,13,1,122,12,37,0.324,4,10,0.4,8,27,0.296,0.378,6,6,1,5,11,16,12,6,0,5,14
3152,1,2009,23,1,1,24,1,181,19,48,0.396,6,15,0.4,13,33,0.394,0.458,12,15,0.8,5,14,19,17,5,0,18,31
3152,1,2009,23,1,1,37,2,303,31,85,0.365,10,25,0.4,21,60,0.35,0.424,18,21,0.857,10,25,35,29,11,0,23,45
3153,1,1987,22,1,1,13,0,205,18,62,0.29,3,14,0.214,15,48,0.313,0.315,10,12,0.833,6,20,26,45,5,1,21,18
3153,2,1988,23,1,1,51,2,760,86,209,0.411,6,20,0.3,80,189,0.423,0.426,45,54,0.833,11,55,66,180,22,3,76,97
3153,3,1989,24,1,1,80,13,1571,198,442,0.448,20,75,0.267,178,367,0.485,0.471,130,144,0.903,21,128,149,390,64,2,177,151
3153,4,1990,25,1,1,70,32,1460,190,464,0.409,52,132,0.394,138,332,0.416,0.466,104,119,0.874,23,136,159,334,36,4,90,126
3153,5,1991,26,1,1,79,66,2714,462,1039,0.445,93,228,0.408,369,811,0.455,0.489,340,377,0.902,57,213,270,660,89,4,252,192
3153,6,1992,27,1,1,75,63,2377,359,868,0.414,91,250,0.364,268,618,0.434,0.466,248,277,0.895,36,166,202,544,74,5,233,188
3153,7,1993,28,1,1,78,78,3086,416,891,0.467,80,235,0.34,336,656,0.512,0.512,289,324,0.892,52,238,290,735,86,2,267,244
3153,8,1994,29,1,1,82,46,2303,276,644,0.429,68,165,0.412,208,479,0.434,0.481,195,222,0.878,42,147,189,503,47,2,193,171
3153,9,1995,30,1,1,62,62,2077,265,583,0.455,96,228,0.421,169,355,0.476,0.537,179,202,0.886,26,133,159,452,70,6,172,135
3153,10,1996,31,1,1,10,9,236,20,57,0.351,15,34,0.441,5,23,0.217,0.482,8,10,0.8,1,15,16,38,7,0,16,21
3166,1,2012,24,1,1,25,11,608,71,176,0.403,2,22,0.091,69,154,0.448,0.409,21,26,0.808,15,44,59,92,10,3,42,32
3166,1,2012,24,1,1,33,11,669,79,198,0.399,2,25,0.08,77,173,0.445,0.404,23,30,0.767,18,49,67,105,13,3,49,37
3166,4,2015,27,1,1,11,11,358,48,123,0.39,19,50,0.38,29,73,0.397,0.467,24,29,0.828,5,42,47,55,6,0,23,18
3178,2,1994,23,1,1,80,16,1617,184,423,0.435,10,39,0.256,174,384,0.453,0.447,95,141,0.674,15,107,122,285,38,18,101,131
3189,1,2011,22,1,1,15,0,113,11,32,0.344,0,2,0,11,30,0.367,0.344,5,11,0.455,1,4,5,15,5,0,8,11
3189,1,2011,22,1,1,28,3,329,32,83,0.386,3,8,0.375,29,75,0.387,0.404,7,10,0.7,6,36,42,64,13,2,26,26
3189,1,2011,22,1,1,43,3,442,43,115,0.374,3,10,0.3,40,105,0.381,0.387,12,21,0.571,7,40,47,79,18,2,34,37
3189,2,2012,23,1,1,20,0,171,19,51,0.373,1,4,0.25,18,47,0.383,0.382,6,8,0.75,5,21,26,32,11,2,12,11
3189,2,2012,23,1,1,26,1,234,31,81,0.383,3,9,0.333,28,72,0.389,0.401,7,10,0.7,7,28,35,41,15,2,13,15
3189,3,2013,24,1,1,16,0,138,17,43,0.395,4,10,0.4,13,33,0.394,0.442,0,0,-1,1,14,15,30,8,3,10,12
3189,3,2013,24,1,1,36,3,378,39,116,0.336,4,17,0.235,35,99,0.354,0.353,3,7,0.429,11,35,46,57,13,6,27,14
3189,3,2013,24,1,1,52,3,516,56,159,0.352,8,27,0.296,48,132,0.364,0.377,3,7,0.429,12,49,61,87,21,9,37,26
3189,4,2014,25,1,1,70,1,1006,119,281,0.423,1,23,0.043,118,258,0.457,0.425,22,39,0.564,31,98,129,179,49,13,65,66
3202,1,1988,22,1,1,61,60,2170,331,694,0.477,12,39,0.308,319,655,0.487,0.486,167,204,0.819,40,98,138,434,92,8,184,140
3202,2,1989,23,1,1,81,81,3145,547,1183,0.462,46,128,0.359,501,1055,0.475,0.482,263,357,0.737,49,177,226,621,102,7,249,173
3202,3,1990,24,1,1,33,5,674,98,204,0.48,4,24,0.167,94,180,0.522,0.49,55,65,0.846,7,30,37,142,22,1,47,45
3202,3,1990,24,1,1,46,46,1747,280,607,0.461,22,59,0.373,258,548,0.471,0.479,106,131,0.809,11,109,120,303,57,7,122,98
3202,3,1990,24,1,1,79,51,2421,378,811,0.466,26,83,0.313,352,728,0.484,0.482,161,196,0.821,18,139,157,445,79,8,169,143
3202,4,1991,25,1,1,78,78,2699,522,1003,0.52,49,135,0.363,473,868,0.545,0.545,287,340,0.844,36,127,163,554,106,11,237,131
3202,5,1992,26,1,1,81,80,2735,432,910,0.475,54,137,0.394,378,773,0.489,0.504,219,253,0.866,34,143,177,562,104,7,227,112
3202,6,1993,27,1,1,82,82,2422,387,744,0.52,96,219,0.438,291,525,0.554,0.585,195,222,0.878,28,132,160,446,80,7,163,110
3202,7,1994,28,1,1,78,78,2209,341,711,0.48,89,220,0.405,252,491,0.513,0.542,135,155,0.871,24,114,138,327,59,4,126,121
3202,8,1995,29,1,1,81,81,2030,287,593,0.484,142,331,0.429,145,262,0.553,0.604,126,148,0.851,27,128,155,323,71,10,123,109
3202,9,1996,30,1,1,68,56,1617,201,464,0.433,91,238,0.382,110,226,0.487,0.531,87,106,0.821,21,75,96,245,47,3,100,116
3202,10,1997,31,1,1,33,3,654,87,206,0.422,51,120,0.425,36,86,0.419,0.546,35,41,0.854,3,34,37,102,18,0,62,25
3202,10,1997,31,1,1,48,3,765,101,239,0.423,59,135,0.437,42,104,0.404,0.546,39,45,0.867,4,40,44,116,19,0,71,30
3206,1,2012,23,1,1,44,4,541,67,180,0.372,13,45,0.289,54,135,0.4,0.408,20,28,0.714,17,39,56,62,18,3,42,55
3206,2,2013,24,1,1,40,0,288,42,114,0.368,6,28,0.214,36,86,0.419,0.395,20,28,0.714,7,20,27,35,7,1,29,26
3216,1,1980,26,1,1,62,-1,1051,121,315,0.384,17,71,0.239,104,244,0.426,0.411,40,52,0.769,56,65,121,259,75,1,95,110
3224,1,1996,22,1,1,43,1,389,42,100,0.42,2,10,0.2,40,90,0.444,0.43,29,49,0.592,9,34,43,73,28,0,38,53
3224,2,1997,23,1,1,67,0,775,74,164,0.451,4,15,0.267,70,149,0.47,0.463,47,66,0.712,17,53,70,159,37,3,48,94
3224,3,1998,24,1,1,47,0,844,69,161,0.429,2,16,0.125,67,145,0.462,0.435,44,61,0.721,19,58,77,164,60,4,51,99
3224,3,1998,24,1,1,64,0,918,79,184,0.429,2,17,0.118,77,167,0.461,0.435,49,71,0.69,19,62,81,177,60,5,63,114
3224,4,1999,25,1,1,48,48,1716,149,348,0.428,5,21,0.238,144,327,0.44,0.435,110,150,0.733,25,137,162,301,100,1,111,149
3224,5,2000,26,1,1,82,80,2866,257,597,0.43,11,45,0.244,246,552,0.446,0.44,126,177,0.712,42,219,261,624,140,8,162,243
3224,6,2001,27,1,1,50,50,1740,182,435,0.418,5,19,0.263,177,416,0.425,0.424,122,154,0.792,27,139,166,369,77,7,124,123
3224,7,2002,28,1,1,61,61,2225,276,624,0.442,3,27,0.111,273,597,0.457,0.445,183,227,0.806,33,182,215,400,95,9,138,167
3224,8,2003,29,1,1,82,82,3108,361,799,0.452,7,32,0.219,354,767,0.462,0.456,325,379,0.858,71,230,301,544,133,11,194,235
3224,9,2004,30,1,1,82,82,2966,295,715,0.413,2,18,0.111,293,697,0.42,0.414,252,316,0.797,62,219,281,563,97,6,187,213
3224,11,2006,32,1,1,82,82,2351,163,399,0.409,1,10,0.1,162,389,0.416,0.41,64,93,0.688,38,160,198,346,76,19,116,218
3224,12,2007,33,1,1,82,45,1929,135,324,0.417,0,4,0,135,320,0.422,0.417,72,113,0.637,35,153,188,330,55,16,111,185
3224,13,2008,34,1,1,22,5,305,6,38,0.158,0,2,0,6,36,0.167,0.158,10,22,0.455,4,16,20,42,10,4,10,30
3228,1,1980,27,1,1,82,-1,2673,470,1002,0.469,21,68,0.309,449,934,0.481,0.48,200,239,0.837,75,167,242,426,136,17,282,294
3228,2,1981,28,1,1,71,-1,1803,355,769,0.462,17,66,0.258,338,703,0.481,0.473,231,247,0.935,46,98,144,284,98,17,206,225
3242,1,1981,22,1,1,15,-1,212,22,63,0.349,0,0,-1,22,63,0.349,0.349,12,16,0.75,7,11,18,32,13,3,18,15
3242,2,1982,23,1,1,82,82,2610,366,730,0.501,1,15,0.067,365,715,0.51,0.502,124,148,0.838,53,171,224,424,87,13,145,240
3242,3,1983,24,1,1,32,9,880,128,298,0.43,2,7,0.286,126,291,0.433,0.433,63,86,0.733,22,67,89,159,37,4,71,93
3242,3,1983,24,1,1,49,49,1548,264,512,0.516,3,15,0.2,261,497,0.525,0.519,84,113,0.743,39,102,141,238,70,1,126,162
3242,3,1983,24,1,1,81,58,2428,392,810,0.484,5,22,0.227,387,788,0.491,0.487,147,199,0.739,61,169,230,397,107,5,197,255
3242,4,1984,25,1,1,79,74,2436,350,738,0.474,10,39,0.256,340,699,0.486,0.481,108,131,0.824,48,141,189,539,100,8,210,230
3242,5,1985,26,1,1,79,41,2292,326,662,0.492,7,31,0.226,319,631,0.506,0.498,122,141,0.865,38,131,169,557,81,9,150,200
3242,6,1986,27,1,1,74,74,2344,345,723,0.477,5,20,0.25,340,703,0.484,0.481,101,127,0.795,50,120,170,472,85,14,154,182
3242,7,1987,28,1,1,80,30,1951,263,590,0.446,11,42,0.262,252,548,0.46,0.455,71,89,0.798,29,86,115,432,67,6,140,160
3242,8,1988,29,1,1,55,25,992,112,274,0.409,2,12,0.167,110,262,0.42,0.412,24,33,0.727,14,56,70,162,37,3,52,72
3242,8,1988,29,1,1,58,25,1044,117,293,0.399,2,13,0.154,115,280,0.411,0.403,24,33,0.727,15,57,72,167,41,3,58,79
3242,9,1989,30,1,1,80,79,2613,444,982,0.452,18,74,0.243,426,908,0.469,0.461,94,107,0.879,55,161,216,429,103,17,204,168
3242,10,1990,31,1,1,82,25,1756,210,510,0.412,8,40,0.2,202,470,0.43,0.42,59,77,0.766,37,101,138,298,49,4,99,140
3242,11,1991,32,1,1,80,74,2375,371,756,0.491,31,78,0.397,340,678,0.501,0.511,58,83,0.699,45,141,186,362,83,16,126,189
3242,12,1992,33,1,1,42,0,471,57,143,0.399,2,13,0.154,55,130,0.423,0.406,8,13,0.615,3,24,27,79,12,5,31,55
3242,12,1992,33,1,1,46,0,489,58,151,0.384,3,15,0.2,55,136,0.404,0.394,8,13,0.615,3,25,28,83,12,5,33,57
3287,1,1985,22,1,1,82,5,1490,157,333,0.471,2,11,0.182,155,322,0.481,0.474,142,193,0.736,26,79,105,415,109,11,150,203
3287,2,1986,23,1,1,82,38,1935,228,466,0.489,2,15,0.133,226,451,0.501,0.491,172,205,0.839,33,146,179,610,157,10,168,227
3287,3,1987,24,1,1,82,2,1858,231,463,0.499,7,39,0.179,224,424,0.528,0.506,179,229,0.782,32,119,151,670,177,14,164,224
3287,4,1988,25,1,1,82,79,2842,454,791,0.574,24,67,0.358,430,724,0.594,0.589,272,324,0.84,54,183,237,1128,242,16,262,247
3287,5,1989,26,1,1,82,82,3171,497,923,0.538,16,66,0.242,481,857,0.561,0.547,390,452,0.863,83,165,248,1118,263,14,308,241
3287,6,1990,27,1,1,78,78,2915,472,918,0.514,47,113,0.416,425,805,0.528,0.54,354,432,0.819,57,149,206,1134,207,18,272,233
3287,7,1991,28,1,1,82,82,3103,496,978,0.507,58,168,0.345,438,810,0.541,0.537,363,434,0.836,46,191,237,1164,234,16,298,233
3287,8,1992,29,1,1,82,82,3002,453,939,0.482,83,204,0.407,370,735,0.503,0.527,308,366,0.842,68,202,270,1126,244,22,286,234
3287,9,1993,30,1,1,82,82,2863,437,899,0.486,72,187,0.385,365,712,0.513,0.526,293,367,0.798,64,173,237,987,199,21,266,224
3287,10,1994,31,1,1,82,82,2969,458,868,0.528,48,149,0.322,410,719,0.57,0.555,272,338,0.805,72,186,258,1031,199,22,266,236
3287,11,1995,32,1,1,82,82,2867,429,791,0.542,102,227,0.449,327,564,0.58,0.607,246,306,0.804,57,194,251,1011,194,22,267,215
3287,12,1996,33,1,1,82,82,2915,440,818,0.538,95,225,0.422,345,593,0.582,0.596,234,282,0.83,54,172,226,916,140,15,246,207
3287,13,1997,34,1,1,82,82,2896,416,759,0.548,76,180,0.422,340,579,0.587,0.598,275,325,0.846,45,183,228,860,166,15,248,194
3287,14,1998,35,1,1,64,64,1858,270,511,0.528,39,91,0.429,231,420,0.55,0.567,191,231,0.827,35,131,166,543,89,10,161,138
3287,15,1999,36,1,1,50,50,1410,200,410,0.488,16,50,0.32,184,360,0.511,0.507,137,169,0.811,31,115,146,374,81,13,110,107
3287,16,2000,37,1,1,82,82,2432,363,725,0.501,43,121,0.355,320,604,0.53,0.53,221,257,0.86,45,170,215,703,143,15,179,192
3287,17,2001,38,1,1,82,82,2397,328,651,0.504,61,132,0.462,267,519,0.514,0.551,227,278,0.817,54,173,227,713,132,21,203,194
3287,18,2002,39,1,1,82,82,2566,401,775,0.517,25,78,0.321,376,697,0.539,0.534,275,321,0.857,59,204,263,674,152,24,208,209
3287,19,2003,40,1,1,82,82,2275,309,640,0.483,29,80,0.363,280,560,0.5,0.505,237,287,0.826,51,150,201,629,137,16,182,184
3290,1,1996,22,1,1,70,70,2865,481,1129,0.426,133,337,0.395,348,792,0.439,0.485,236,296,0.797,59,222,281,653,98,19,267,166
3290,2,1997,23,1,1,81,81,3311,564,1407,0.401,176,496,0.355,388,911,0.426,0.463,330,401,0.823,86,244,330,709,123,13,288,162
3290,3,1998,24,1,1,22,22,806,94,258,0.364,26,99,0.263,68,159,0.428,0.415,59,75,0.787,24,57,81,181,33,2,64,38
3290,3,1998,24,1,1,49,49,2033,354,833,0.425,65,205,0.317,289,628,0.46,0.464,179,212,0.844,63,154,217,399,80,5,159,112
3290,3,1998,24,1,1,71,71,2839,448,1091,0.411,91,304,0.299,357,787,0.454,0.452,238,287,0.829,87,211,298,580,113,7,223,150
3290,4,1999,25,1,1,50,50,1673,249,629,0.396,44,142,0.31,205,487,0.421,0.431,89,122,0.73,41,126,167,312,49,4,110,81
3290,5,2000,26,1,1,78,78,2372,386,894,0.432,80,212,0.377,306,682,0.449,0.477,122,145,0.841,61,182,243,405,77,1,149,173
3290,6,2001,27,1,1,82,82,2655,406,935,0.434,82,219,0.374,324,716,0.453,0.478,172,207,0.831,69,234,303,468,106,8,191,202
3290,7,2002,28,1,1,75,71,2796,369,918,0.402,104,295,0.353,265,623,0.425,0.459,174,196,0.888,78,214,292,490,67,7,149,153
3290,8,2003,29,1,1,59,27,1315,156,415,0.376,44,114,0.386,112,301,0.372,0.429,53,67,0.791,40,115,155,204,39,6,82,67
3290,9,2004,30,1,1,82,82,3118,408,1018,0.401,156,427,0.365,252,591,0.426,0.477,127,145,0.876,52,256,308,500,99,9,180,173
3290,10,2005,31,1,1,81,70,2762,457,1165,0.392,181,490,0.369,276,675,0.409,0.47,182,199,0.915,56,254,310,458,86,2,164,158
3290,11,2006,32,1,1,27,27,862,114,287,0.397,36,104,0.346,78,183,0.426,0.46,53,62,0.855,23,72,95,128,19,1,55,49
3290,12,2007,33,1,1,62,51,1501,171,437,0.391,59,175,0.337,112,262,0.427,0.459,66,83,0.795,31,108,139,299,47,2,101,95
3290,13,2008,34,1,1,31,4,413,43,143,0.301,14,55,0.255,29,88,0.33,0.35,6,8,0.75,6,41,47,53,11,2,30,30
3290,13,2008,34,1,1,29,29,624,77,194,0.397,36,94,0.383,41,100,0.41,0.49,21,26,0.808,14,57,71,112,19,0,50,46
3290,13,2008,34,1,1,60,33,1037,120,337,0.356,50,149,0.336,70,188,0.372,0.43,27,34,0.794,20,98,118,165,30,2,80,76
3291,3,2008,25,1,1,35,0,402,65,180,0.361,29,85,0.341,36,95,0.379,0.442,41,50,0.82,4,20,24,28,7,5,21,34
3297,5,2001,27,1,1,22,0,409,41,136,0.301,14,48,0.292,27,88,0.307,0.353,44,51,0.863,9,67,76,66,22,1,27,42
3297,5,2001,27,1,1,28,0,421,40,131,0.305,16,47,0.34,24,84,0.286,0.366,24,28,0.857,9,43,52,29,22,1,21,46
3297,5,2001,27,1,1,50,0,830,81,267,0.303,30,95,0.316,51,172,0.297,0.36,68,79,0.861,18,110,128,95,44,2,48,88
3297,6,2002,28,1,1,79,4,1643,190,488,0.389,95,247,0.385,95,241,0.394,0.487,131,155,0.845,22,191,213,184,56,1,94,145
3297,8,2004,30,1,1,43,0,571,79,196,0.403,29,66,0.439,50,130,0.385,0.477,44,51,0.863,13,58,71,90,26,2,54,63
3298,1,1989,22,1,1,81,10,1358,265,567,0.467,19,59,0.322,246,508,0.484,0.484,172,231,0.745,51,109,160,319,98,3,148,142
3298,2,1990,23,1,1,51,0,1019,170,386,0.44,6,21,0.286,164,365,0.449,0.448,83,130,0.638,43,83,126,219,70,8,85,71
3298,2,1990,23,1,1,31,24,1121,173,370,0.468,2,9,0.222,171,361,0.474,0.47,91,148,0.615,47,86,133,249,57,6,85,89
3298,2,1990,23,1,1,82,24,2140,343,756,0.454,8,30,0.267,335,726,0.461,0.459,174,278,0.626,90,169,259,468,127,14,170,160
3298,3,1991,24,1,1,58,56,2076,314,651,0.482,11,33,0.333,303,618,0.49,0.491,161,211,0.763,57,162,219,463,117,11,156,125
3298,4,1992,25,1,1,57,54,2053,300,659,0.455,5,15,0.333,295,644,0.458,0.459,182,265,0.687,92,173,265,491,118,17,160,122
3298,6,1994,27,1,1,82,58,2889,528,1093,0.483,2,10,0.2,526,1083,0.486,0.484,353,471,0.749,122,248,370,740,147,24,257,171
3298,7,1995,28,1,1,64,61,2267,441,946,0.466,46,123,0.374,395,823,0.48,0.49,283,380,0.745,73,244,317,562,123,9,209,118
3298,8,1996,29,1,1,67,63,2526,471,1023,0.46,38,111,0.342,433,912,0.475,0.479,276,423,0.652,89,208,297,640,97,16,255,135
3298,9,1997,30,1,1,82,81,2997,515,1105,0.466,13,77,0.169,502,1028,0.488,0.472,367,497,0.738,95,240,335,727,143,14,270,166
3298,10,1998,31,1,1,76,76,3020,490,1130,0.434,12,48,0.25,478,1082,0.442,0.439,357,492,0.726,112,293,405,801,126,25,266,182
3298,11,1999,32,1,1,44,43,1632,251,603,0.416,12,42,0.286,239,561,0.426,0.426,176,236,0.746,56,156,212,434,76,5,142,91
3298,12,2000,33,1,1,69,67,2188,327,762,0.429,1,21,0.048,326,741,0.44,0.43,214,305,0.702,73,186,259,519,94,18,187,147
3298,13,2001,34,1,1,21,0,351,41,98,0.418,0,1,0,41,97,0.423,0.418,15,26,0.577,11,24,35,72,10,1,24,21
3298,13,2001,34,1,1,33,28,1020,141,331,0.426,4,16,0.25,137,315,0.435,0.432,115,147,0.782,25,80,105,231,43,4,83,55
3298,13,2001,34,1,1,54,28,1371,182,429,0.424,4,17,0.235,178,412,0.432,0.429,130,173,0.751,36,104,140,303,53,5,107,76
3298,14,2002,35,1,1,76,64,2294,316,714,0.443,8,26,0.308,308,688,0.448,0.448,154,201,0.766,49,183,232,463,82,11,159,114
3298,15,2003,36,1,1,47,8,956,120,278,0.432,1,11,0.091,119,267,0.446,0.433,79,107,0.738,20,75,95,215,46,6,76,55
3298,16,2004,37,1,1,15,1,282,28,84,0.333,0,3,0,28,81,0.346,0.333,15,22,0.682,10,27,37,59,8,4,18,17
3298,16,2004,37,1,1,46,9,915,122,269,0.454,10,33,0.303,112,236,0.475,0.472,57,76,0.75,24,94,118,185,27,7,67,59
3298,16,2004,37,1,1,61,10,1197,150,353,0.425,10,36,0.278,140,317,0.442,0.439,72,98,0.735,34,121,155,244,35,11,85,76
3298,17,2005,38,1,1,16,2,196,9,43,0.209,1,2,0.5,8,41,0.195,0.221,9,10,0.9,3,24,27,39,3,2,16,15
3308,1,2008,21,1,1,57,2,1081,153,382,0.401,3,16,0.188,150,366,0.41,0.404,127,156,0.814,32,97,129,160,49,6,78,113
3308,2,2009,22,1,1,79,65,2517,401,913,0.439,23,78,0.295,378,835,0.453,0.452,233,290,0.803,69,206,275,387,78,11,173,217
3308,3,2010,23,1,1,73,67,2499,449,1109,0.405,18,79,0.228,431,1030,0.418,0.413,299,359,0.833,67,214,281,348,101,12,163,205
3308,4,2011,24,1,1,70,54,2183,363,827,0.439,26,90,0.289,337,737,0.457,0.455,330,381,0.866,70,146,216,361,76,10,155,177
3316,1,1984,22,1,1,73,2,1284,217,488,0.445,9,37,0.243,208,451,0.461,0.454,64,72,0.889,23,68,91,239,29,1,81,81
3316,2,1985,23,1,1,73,1,1150,170,400,0.425,12,38,0.316,158,362,0.436,0.44,48,59,0.814,17,53,70,206,36,1,85,87
3316,3,1986,24,1,1,70,4,1150,220,476,0.462,21,60,0.35,199,416,0.478,0.484,39,48,0.813,22,58,80,261,34,0,85,110
3316,4,1987,25,1,1,76,42,1765,365,751,0.486,50,149,0.336,315,602,0.523,0.519,70,84,0.833,20,78,98,315,35,0,97,109
3316,5,1988,26,1,1,52,12,1024,176,379,0.464,26,64,0.406,150,315,0.476,0.499,43,48,0.896,14,34,48,183,27,2,57,54
3318,4,1999,25,1,1,50,6,841,70,210,0.333,9,45,0.2,61,165,0.37,0.355,65,103,0.631,21,81,102,152,46,14,67,98
3318,7,2002,28,1,1,78,5,1780,250,590,0.424,42,133,0.316,208,457,0.455,0.459,236,328,0.72,89,167,256,275,88,17,133,160
3318,10,2005,31,1,1,61,59,1922,215,504,0.427,55,155,0.355,160,349,0.458,0.481,141,188,0.75,79,258,337,317,65,7,147,168
3347,1,2003,24,1,1,42,0,244,22,58,0.379,5,12,0.417,17,46,0.37,0.422,29,36,0.806,4,13,17,33,4,0,23,25
3355,1,1981,22,1,1,80,-1,2431,525,1162,0.452,3,31,0.097,522,1131,0.462,0.453,164,219,0.749,42,153,195,555,88,9,232,201
3355,2,1982,23,1,1,78,68,2418,504,1095,0.46,3,38,0.079,501,1057,0.474,0.462,242,318,0.761,39,147,186,555,97,4,229,169
3355,3,1983,24,1,1,76,4,1607,343,746,0.46,2,16,0.125,341,730,0.467,0.461,152,199,0.764,44,103,147,280,58,4,129,109
3355,4,1984,25,1,1,80,50,1937,304,700,0.434,7,32,0.219,297,668,0.445,0.439,145,183,0.792,28,99,127,483,91,6,141,182
3355,5,1985,26,1,1,81,29,1689,300,654,0.459,2,11,0.182,298,643,0.463,0.46,122,142,0.859,40,90,130,355,87,7,113,134
3355,6,1986,27,1,1,79,15,1504,231,505,0.457,3,24,0.125,228,481,0.474,0.46,121,148,0.818,34,82,116,252,51,4,114,128
3374,4,1999,31,1,1,44,2,708,82,184,0.446,24,60,0.4,58,124,0.468,0.511,34,39,0.872,20,57,77,91,17,1,58,66
3374,5,2001,33,1,1,43,0,403,38,114,0.333,13,39,0.333,25,75,0.333,0.39,14,18,0.778,13,37,50,39,6,1,27,30
3377,1,2007,22,1,1,42,0,622,80,195,0.41,38,98,0.388,42,97,0.433,0.508,54,60,0.9,10,42,52,36,12,0,21,52
3384,1,1995,22,1,1,67,17,1462,206,465,0.443,67,171,0.392,139,294,0.473,0.515,140,196,0.714,52,134,186,288,77,10,132,139
3384,2,1996,23,1,1,31,7,415,41,109,0.376,17,55,0.309,24,54,0.444,0.454,18,31,0.581,7,32,39,46,21,2,33,69
3384,2,1996,23,1,1,20,5,418,54,118,0.458,11,36,0.306,43,82,0.524,0.504,43,51,0.843,11,29,40,72,16,1,30,46
3384,2,1996,23,1,1,51,12,833,95,227,0.419,28,91,0.308,67,136,0.493,0.48,61,82,0.744,18,61,79,118,37,3,63,115
3384,3,1997,24,1,1,13,12,384,43,111,0.387,7,35,0.2,36,76,0.474,0.419,9,12,0.75,12,19,31,56,11,2,26,40
3384,3,1997,24,1,1,50,18,1048,141,359,0.393,76,192,0.396,65,167,0.389,0.499,56,75,0.747,22,66,88,170,23,7,82,119
3384,3,1997,24,1,1,63,30,1432,184,470,0.391,83,227,0.366,101,243,0.416,0.48,65,87,0.747,34,85,119,226,34,9,108,159
3384,4,1998,25,1,1,82,54,1950,248,593,0.418,56,152,0.368,192,441,0.435,0.465,165,213,0.775,54,131,185,230,80,10,130,195
3384,5,1999,26,1,1,11,0,112,8,21,0.381,1,3,0.333,7,18,0.389,0.405,8,14,0.571,3,4,7,11,4,0,7,13
3395,1,1996,22,1,1,34,1,397,32,99,0.323,9,29,0.31,23,70,0.329,0.369,30,43,0.698,9,33,42,54,16,1,41,36
3395,1,1996,22,1,1,36,1,405,33,100,0.33,9,29,0.31,24,71,0.338,0.375,31,46,0.674,9,35,44,54,16,2,43,37
3408,3,1982,26,1,1,82,79,3044,619,1343,0.461,19,101,0.188,600,1242,0.483,0.468,212,303,0.7,177,388,565,572,213,41,291,317
3408,4,1983,27,1,1,31,26,1002,170,388,0.438,4,20,0.2,166,368,0.451,0.443,51,76,0.671,68,82,150,187,81,15,107,116
3408,4,1983,27,1,1,33,25,1074,176,427,0.412,4,31,0.129,172,396,0.434,0.417,55,87,0.632,45,100,145,245,101,9,137,124
3408,4,1983,27,1,1,64,51,2076,346,815,0.425,8,51,0.157,338,764,0.442,0.429,106,163,0.65,113,182,295,432,182,24,244,240
3408,5,1984,28,1,1,48,25,1285,243,528,0.46,14,58,0.241,229,470,0.487,0.473,76,108,0.704,56,116,172,214,103,20,118,156
3408,6,1985,29,1,1,82,82,3127,690,1470,0.469,29,115,0.252,661,1355,0.488,0.479,240,313,0.767,156,301,457,669,243,22,249,277
3408,7,1986,30,1,1,47,39,1604,296,661,0.448,4,27,0.148,292,634,0.461,0.451,141,179,0.788,77,173,250,340,125,11,150,163
3411,1,1990,23,1,1,82,48,2581,426,925,0.461,23,83,0.277,403,842,0.479,0.473,63,107,0.589,55,162,217,554,133,25,141,143
3411,2,1991,24,1,1,82,82,3154,635,1350,0.47,42,128,0.328,593,1222,0.485,0.486,89,165,0.539,82,204,286,734,131,13,174,114
3411,3,1992,25,1,1,82,82,2922,587,1261,0.466,53,155,0.342,534,1106,0.483,0.487,123,178,0.691,91,210,301,685,119,25,204,152
3411,4,1993,26,1,1,74,73,2396,337,703,0.479,3,29,0.103,334,674,0.496,0.482,92,124,0.742,63,204,267,573,94,12,167,132
3411,5,1994,27,1,1,37,25,1022,160,354,0.452,3,12,0.25,157,342,0.459,0.456,47,77,0.61,28,82,110,237,32,3,88,78
3411,6,1995,28,1,1,80,77,2864,353,897,0.394,87,244,0.357,266,653,0.407,0.442,81,125,0.648,38,223,261,632,129,12,171,218
3411,7,1996,29,1,1,63,61,2013,281,664,0.423,94,245,0.384,187,419,0.446,0.494,78,105,0.743,35,123,158,340,77,13,95,134
3411,8,1997,30,1,1,59,18,1065,131,344,0.381,42,128,0.328,89,216,0.412,0.442,26,43,0.605,25,73,98,169,54,5,62,82
3411,9,1998,31,1,1,69,17,1252,124,333,0.372,11,57,0.193,113,276,0.409,0.389,30,43,0.698,17,79,96,226,44,3,54,71
3411,10,1999,32,1,1,11,0,130,12,36,0.333,0,6,0,12,30,0.4,0.333,4,4,1,1,12,13,30,4,0,9,5
3412,1,2004,22,1,1,69,6,1114,145,350,0.414,27,80,0.338,118,270,0.437,0.453,65,79,0.823,35,73,108,163,52,7,80,105
3412,2,2005,23,1,1,82,82,2571,299,739,0.405,67,178,0.376,232,561,0.414,0.45,159,180,0.883,55,149,204,483,94,23,149,185
3412,3,2006,24,1,1,79,77,2625,334,799,0.418,43,149,0.289,291,650,0.448,0.445,199,227,0.877,47,188,235,550,123,22,162,178
3412,4,2007,25,1,1,71,58,2091,301,695,0.433,49,139,0.353,252,556,0.453,0.468,128,159,0.805,28,136,164,368,83,19,156,181
3412,5,2008,26,1,1,61,5,1223,147,368,0.399,21,71,0.296,126,297,0.424,0.428,78,91,0.857,13,81,94,241,37,14,80,120
3412,6,2009,27,1,1,72,50,2033,250,621,0.403,55,157,0.35,195,464,0.42,0.447,133,153,0.869,33,185,218,365,92,16,128,200
3412,7,2010,28,1,1,82,0,1759,328,686,0.478,69,181,0.381,259,505,0.513,0.528,127,140,0.907,24,119,143,324,54,7,106,182
3412,8,2011,29,1,1,71,66,2159,319,681,0.468,81,184,0.44,238,497,0.479,0.528,121,137,0.883,37,162,199,384,89,10,158,146
3412,11,2014,32,1,1,25,2,378,42,108,0.389,12,40,0.3,30,68,0.441,0.444,4,7,0.571,8,27,35,54,9,6,20,37
3412,11,2014,32,1,1,36,12,763,84,219,0.384,25,68,0.368,59,151,0.391,0.441,13,19,0.684,15,47,62,122,23,2,46,55
3412,11,2014,32,1,1,61,14,1141,126,327,0.385,37,108,0.343,89,219,0.406,0.442,17,26,0.654,23,74,97,176,32,8,66,92
3412,12,2015,33,1,1,10,0,200,25,54,0.463,4,14,0.286,21,40,0.525,0.5,4,5,0.8,3,22,25,31,4,0,14,23
3431,1,1984,22,1,1,81,47,1938,250,541,0.462,2,12,0.167,248,529,0.469,0.464,255,325,0.785,72,148,220,314,127,30,174,286
3431,2,1985,23,1,1,69,58,2126,334,701,0.476,15,36,0.417,319,665,0.48,0.487,291,378,0.77,66,148,214,410,163,53,176,250
3431,3,1986,24,1,1,53,50,1571,220,464,0.474,0,16,0,220,448,0.491,0.474,172,283,0.608,49,113,162,443,120,13,141,185
3431,4,1987,25,1,1,82,82,2590,342,758,0.451,4,21,0.19,338,737,0.459,0.454,365,441,0.828,83,216,299,823,171,30,217,287
3431,5,1988,26,1,1,80,80,2502,403,890,0.453,9,33,0.273,394,857,0.46,0.458,319,421,0.758,83,283,366,747,140,41,210,272
3431,6,1989,27,1,1,76,76,2462,371,816,0.455,43,124,0.347,328,692,0.474,0.481,247,287,0.861,89,197,286,525,181,40,158,263
3431,7,1990,28,1,1,48,44,1526,218,480,0.454,24,66,0.364,194,414,0.469,0.479,138,170,0.812,47,153,200,264,116,22,98,151
3431,8,1991,29,1,1,79,79,2586,444,1020,0.435,88,262,0.336,356,758,0.47,0.478,221,262,0.844,47,206,253,340,148,47,125,216
3431,9,1992,30,1,1,59,25,1657,226,533,0.424,26,92,0.283,200,441,0.454,0.448,163,196,0.832,23,124,147,233,111,19,92,166
3431,10,1993,31,1,1,77,45,1886,216,494,0.437,39,123,0.317,177,371,0.477,0.477,133,162,0.821,26,166,192,405,123,9,114,215
3431,11,1994,32,1,1,19,19,499,55,127,0.433,19,52,0.365,36,75,0.48,0.508,14,22,0.636,4,35,39,100,25,5,29,44
3431,12,1995,33,1,1,60,0,942,104,289,0.36,42,122,0.344,62,167,0.371,0.433,52,71,0.732,13,87,100,154,61,21,56,142
3431,12,1995,33,1,1,63,0,989,108,302,0.358,45,127,0.354,63,175,0.36,0.432,60,82,0.732,15,94,109,162,65,21,60,150
3431,13,1996,34,1,1,78,0,1235,108,290,0.372,47,137,0.343,61,153,0.399,0.453,48,64,0.75,30,108,138,123,73,21,57,175
3439,1,2013,27,1,1,78,5,1324,213,511,0.417,59,153,0.386,154,358,0.43,0.475,70,77,0.909,17,80,97,219,37,3,71,108
3439,2,2014,28,1,1,72,42,1667,244,581,0.42,64,178,0.36,180,403,0.447,0.475,125,133,0.94,17,119,136,234,43,7,95,132
3439,3,2015,29,1,1,10,0,157,19,53,0.358,6,19,0.316,13,34,0.382,0.415,11,11,1,2,7,9,28,5,0,7,9
3454,1,2006,21,1,1,72,26,1544,230,565,0.407,58,146,0.397,172,419,0.411,0.458,152,202,0.752,56,111,167,147,59,1,114,201
3454,2,2007,22,1,1,64,5,1356,227,523,0.434,83,213,0.39,144,310,0.465,0.513,108,139,0.777,55,97,152,90,50,6,72,160
3454,3,2008,23,1,1,72,17,1883,331,782,0.423,97,292,0.332,234,490,0.478,0.485,154,196,0.786,51,171,222,212,60,1,103,186
3454,4,2009,24,1,1,74,11,2209,449,1028,0.437,125,385,0.325,324,643,0.504,0.498,249,296,0.841,98,192,290,301,95,6,139,206
3454,5,2010,25,1,1,26,0,382,63,157,0.401,36,87,0.414,27,70,0.386,0.516,8,13,0.615,5,33,38,51,22,0,20,50
3454,5,2010,25,1,1,30,2,733,152,336,0.452,51,136,0.375,101,200,0.505,0.528,42,54,0.778,23,49,72,112,27,5,53,66
3454,5,2010,25,1,1,56,2,1115,215,493,0.436,87,223,0.39,128,270,0.474,0.524,50,67,0.746,28,82,110,163,49,5,73,116
3454,6,2011,26,1,1,55,11,983,146,361,0.404,63,192,0.328,83,169,0.491,0.492,33,40,0.825,15,74,89,105,29,4,66,107
3454,6,2011,26,1,1,59,11,1013,150,376,0.399,65,200,0.325,85,176,0.483,0.485,36,44,0.818,15,75,90,111,29,4,68,115
3454,7,2012,27,1,1,51,9,1192,205,484,0.424,66,181,0.365,139,303,0.459,0.492,94,113,0.832,15,85,100,231,59,2,75,118
3454,8,2013,28,1,1,82,23,2086,399,921,0.433,141,348,0.405,258,573,0.45,0.51,135,169,0.799,29,155,184,358,85,10,144,207
3454,9,2014,29,1,1,44,1,866,164,383,0.428,58,154,0.377,106,229,0.463,0.504,71,85,0.835,21,60,81,112,36,4,58,92
3454,10,2015,30,1,1,8,1,118,20,51,0.392,5,20,0.25,15,31,0.484,0.441,4,5,0.8,3,4,7,14,4,0,5,16
3469,1,2007,20,1,1,67,1,862,101,239,0.423,24,85,0.282,77,154,0.5,0.473,21,26,0.808,20,71,91,218,35,2,77,72
3469,2,2008,21,1,1,72,0,628,69,196,0.352,17,58,0.293,52,138,0.377,0.395,25,38,0.658,13,45,58,123,24,0,53,57
3469,3,2009,22,1,1,80,13,1225,129,329,0.392,37,114,0.325,92,215,0.428,0.448,61,77,0.792,43,87,130,286,54,2,119,133
3469,4,2010,23,1,1,39,0,517,88,190,0.463,15,42,0.357,73,148,0.493,0.503,43,62,0.694,15,35,50,121,29,3,59,46
3469,4,2010,23,1,1,27,8,531,79,161,0.491,17,49,0.347,62,112,0.554,0.543,25,31,0.806,9,30,39,91,21,2,55,38
3469,4,2010,23,1,1,66,8,1048,167,351,0.476,32,91,0.352,135,260,0.519,0.521,68,93,0.731,24,65,89,212,50,5,114,84
3480,1,1981,22,1,1,53,-1,726,87,211,0.412,2,6,0.333,85,205,0.415,0.417,43,63,0.683,10,46,56,136,27,3,52,64
3480,2,1982,23,1,1,79,11,1259,203,403,0.504,3,15,0.2,200,388,0.515,0.507,79,96,0.823,12,86,98,226,60,13,89,103
3480,3,1983,24,1,1,82,64,2130,266,572,0.465,10,33,0.303,256,539,0.475,0.474,78,105,0.743,23,115,138,455,98,5,141,142
3480,4,1984,25,1,1,65,9,1007,159,346,0.46,4,32,0.125,155,314,0.494,0.465,65,90,0.722,21,71,92,192,55,8,63,76
3480,4,1984,25,1,1,68,9,1022,161,351,0.459,4,33,0.121,157,318,0.494,0.464,67,94,0.713,21,72,93,193,55,8,63,77
3481,1,2007,20,1,1,78,25,1831,188,450,0.418,6,29,0.207,182,421,0.432,0.424,119,184,0.647,74,218,292,297,128,8,137,181
3481,2,2008,21,1,1,77,77,2306,351,713,0.492,5,19,0.263,346,694,0.499,0.496,107,175,0.611,78,244,322,393,129,13,147,187
3481,3,2009,22,1,1,80,80,2642,383,759,0.505,15,48,0.313,368,711,0.518,0.514,172,268,0.642,100,316,416,659,149,11,209,193
3481,4,2010,23,1,1,81,81,2963,459,904,0.508,17,80,0.213,442,824,0.536,0.517,175,282,0.621,100,260,360,794,189,11,246,198
3481,5,2011,24,1,1,68,68,2527,318,670,0.475,10,43,0.233,308,627,0.491,0.482,75,132,0.568,87,210,297,760,153,11,234,120
3481,6,2012,25,1,1,53,53,1957,256,572,0.448,10,42,0.238,246,530,0.464,0.456,108,181,0.597,62,195,257,620,95,3,193,99
3481,7,2013,26,1,1,38,38,1423,225,465,0.484,12,50,0.24,213,415,0.513,0.497,60,93,0.645,43,169,212,420,70,9,148,96
3481,8,2014,27,1,1,30,30,998,141,350,0.403,26,90,0.289,115,260,0.442,0.44,42,67,0.627,22,142,164,294,40,2,99,65
3481,9,2015,28,1,1,7,7,233,31,72,0.431,5,13,0.385,26,59,0.441,0.465,4,10,0.4,11,46,57,84,13,2,25,16
3484,10,2004,31,1,1,50,50,1968,308,752,0.41,46,148,0.311,262,604,0.434,0.44,148,180,0.822,27,175,202,273,39,18,171,139
3484,10,2004,31,1,1,66,64,2497,383,952,0.402,69,202,0.342,314,750,0.419,0.439,187,231,0.81,34,232,266,329,51,22,208,184
3507,1,1995,24,1,1,49,1,319,84,197,0.426,38,99,0.384,46,98,0.469,0.523,27,38,0.711,8,15,23,48,14,2,47,52
3507,2,1996,25,1,1,61,23,1551,263,648,0.406,104,284,0.366,159,364,0.437,0.486,148,182,0.813,21,111,132,269,43,2,149,132
3508,1,2012,21,1,1,41,31,1404,139,389,0.357,32,94,0.34,107,295,0.363,0.398,126,157,0.803,21,150,171,336,91,8,131,97
3508,2,2013,22,1,1,57,47,1691,185,514,0.36,27,92,0.293,158,422,0.374,0.386,211,264,0.799,44,185,229,418,137,5,172,143
3508,3,2014,23,1,1,82,82,2638,255,670,0.381,44,133,0.331,211,537,0.393,0.413,227,283,0.802,61,281,342,704,191,11,221,218
3508,4,2015,24,1,1,5,5,144,20,47,0.426,1,4,0.25,19,43,0.442,0.436,6,10,0.6,6,22,28,50,6,0,15,19
3510,1,1990,27,1,1,77,2,850,111,259,0.429,16,56,0.286,95,203,0.468,0.459,35,53,0.66,12,43,55,177,22,1,88,81
3510,2,1991,28,1,1,82,0,874,124,285,0.435,17,61,0.279,107,224,0.478,0.465,59,71,0.831,14,52,66,216,36,2,102,92
3523,1,2012,29,1,1,28,0,357,33,95,0.347,4,13,0.308,29,82,0.354,0.368,14,22,0.636,7,19,26,58,18,1,33,29
3524,1,2009,24,1,1,72,0,890,123,324,0.38,11,62,0.177,112,262,0.427,0.397,44,60,0.733,27,48,75,153,30,2,60,77
3525,1,1983,22,1,1,68,1,757,67,184,0.364,2,18,0.111,65,166,0.392,0.37,47,58,0.81,19,54,73,131,16,1,92,71
3525,2,1984,23,1,1,16,0,119,14,42,0.333,1,2,0.5,13,40,0.325,0.345,12,13,0.923,6,13,19,22,4,0,9,25
3525,3,1985,24,1,1,21,2,377,34,63,0.54,1,1,1,33,62,0.532,0.548,14,17,0.824,8,32,40,66,17,4,40,37
3525,4,1987,26,1,1,48,0,511,64,165,0.388,2,16,0.125,62,149,0.416,0.394,27,37,0.73,18,37,55,129,20,5,60,62
3529,1,2005,22,1,1,80,2,1149,173,390,0.444,58,142,0.408,115,248,0.464,0.518,67,89,0.753,16,67,83,150,41,10,77,96
3529,2,2006,23,1,1,54,3,586,106,233,0.455,24,70,0.343,82,163,0.503,0.506,39,50,0.78,18,34,52,92,14,2,53,55
3529,3,2007,24,1,1,73,1,948,127,344,0.369,33,115,0.287,94,229,0.41,0.417,53,60,0.883,11,71,82,122,27,1,56,70
3529,4,2008,25,1,1,65,51,2080,328,708,0.463,53,137,0.387,275,571,0.482,0.501,125,147,0.85,34,183,217,282,56,10,148,138
3529,5,2009,26,1,1,73,72,2270,321,696,0.461,35,113,0.31,286,583,0.491,0.486,123,150,0.82,46,174,220,342,81,12,158,192
3529,6,2010,27,1,1,79,41,2477,415,841,0.493,75,199,0.377,340,642,0.53,0.538,118,141,0.837,38,181,219,372,89,10,136,166
3529,7,2011,28,1,1,79,64,2734,412,824,0.5,65,182,0.357,347,642,0.54,0.539,197,228,0.864,41,224,265,386,94,9,141,181
3529,9,2013,30,1,1,27,9,738,97,238,0.408,21,53,0.396,76,185,0.411,0.452,60,70,0.857,17,46,63,164,25,1,55,51
3529,11,2015,32,1,1,10,0,166,31,59,0.525,3,15,0.2,28,44,0.636,0.551,4,4,1,0,14,14,23,4,0,15,16
3532,1,2011,22,1,1,42,0,438,61,144,0.424,3,8,0.375,58,136,0.426,0.434,33,56,0.589,30,31,61,69,13,8,25,29
3532,2,2012,23,1,1,16,8,357,33,94,0.351,0,1,0,33,93,0.355,0.351,11,19,0.579,17,46,63,59,16,3,19,30
3532,2,2012,23,1,1,18,8,370,35,99,0.354,0,1,0,35,98,0.357,0.354,11,19,0.579,19,48,67,61,17,3,19,31
