5,1,2011,21,1,2,20,0,118,21,51,0.412,2,5,0.4,19,46,0.413,0.431,18,23,0.783,15,12,27,2,4,5,6,7
5,2,2012,22,1,2,24,12,396,37,89,0.416,0,9,0,37,80,0.463,0.416,23,35,0.657,26,28,54,12,11,6,18,26
15,1,1983,22,1,2,32,2,309,48,139,0.345,0,2,0,48,137,0.35,0.345,16,27,0.593,20,19,39,22,11,6,20,41
15,2,1984,23,1,2,15,0,101,23,47,0.489,0,0,-1,23,47,0.489,0.489,18,25,0.72,6,12,18,7,4,1,16,16
15,2,1984,23,1,2,40,0,521,135,274,0.493,0,0,-1,135,274,0.493,0.493,76,101,0.752,40,30,70,27,22,6,45,67
15,2,1984,23,1,2,55,0,622,158,321,0.492,0,0,-1,158,321,0.492,0.492,94,126,0.746,46,42,88,34,26,7,61,83
18,9,1998,32,1,2,81,20,1968,326,742,0.439,40,120,0.333,286,622,0.46,0.466,180,215,0.837,61,156,217,201,86,27,134,183
30,1,1985,23,1,2,45,0,189,34,69,0.493,0,3,0,34,66,0.515,0.493,19,30,0.633,8,17,25,26,11,3,22,26
30,2,1986,24,1,2,36,0,199,36,84,0.429,3,9,0.333,33,75,0.44,0.446,23,29,0.793,17,29,46,29,11,4,15,22
30,3,1987,25,1,2,44,15,890,99,239,0.414,5,29,0.172,94,210,0.448,0.425,70,99,0.707,55,106,161,92,40,30,61,80
30,4,1988,26,1,2,79,27,1709,226,485,0.466,22,64,0.344,204,421,0.485,0.489,89,132,0.674,86,188,274,206,82,30,107,182
30,5,1989,27,1,2,82,4,1867,249,524,0.475,39,100,0.39,210,424,0.495,0.512,71,117,0.607,100,195,295,266,110,19,116,161
30,6,1990,28,1,2,81,64,2894,436,940,0.464,104,248,0.419,332,692,0.48,0.519,126,185,0.681,147,292,439,371,126,23,161,226
30,7,1991,29,1,2,82,68,2766,344,773,0.445,49,149,0.329,295,624,0.473,0.477,95,140,0.679,142,246,388,376,121,34,160,209
30,8,1992,30,1,2,63,62,2016,310,684,0.453,69,167,0.413,241,517,0.466,0.504,87,123,0.707,94,213,307,238,78,22,104,150
30,9,1993,31,1,2,82,73,2559,385,785,0.49,93,244,0.381,292,541,0.54,0.55,86,120,0.717,113,290,403,254,104,22,124,170
30,10,1994,32,1,2,82,0,2147,316,708,0.446,77,221,0.348,239,487,0.491,0.501,112,154,0.727,71,208,279,273,136,26,130,161
30,11,1995,33,1,2,49,0,1166,191,422,0.453,51,134,0.381,140,288,0.486,0.513,44,71,0.62,55,92,147,113,46,6,73,86
30,12,1996,34,1,2,79,8,1758,253,591,0.428,82,221,0.371,171,370,0.462,0.497,81,103,0.786,65,191,256,138,85,9,104,138
30,13,1997,35,1,2,62,0,848,87,248,0.351,27,95,0.284,60,153,0.392,0.405,13,26,0.5,39,71,110,68,36,4,45,71
31,1,2010,22,1,2,76,1,1384,190,448,0.424,64,162,0.395,126,286,0.441,0.496,61,70,0.871,33,126,159,74,20,5,74,72
31,2,2011,23,1,2,62,8,1181,160,397,0.403,48,121,0.397,112,276,0.406,0.463,42,53,0.792,26,82,108,72,28,3,53,85
31,3,2012,24,1,2,51,4,973,122,302,0.404,35,108,0.324,87,194,0.448,0.462,32,40,0.8,14,85,99,33,26,10,26,56
31,4,2013,25,1,2,40,4,676,81,199,0.407,41,97,0.423,40,102,0.392,0.51,15,16,0.938,5,47,52,42,16,1,24,38
31,4,2013,25,1,2,38,17,985,145,330,0.439,53,143,0.371,92,187,0.492,0.52,53,59,0.898,20,94,114,62,29,2,33,43
31,4,2013,25,1,2,78,21,1661,226,529,0.427,94,240,0.392,132,289,0.457,0.516,68,75,0.907,25,141,166,104,45,3,57,81
31,5,2014,26,1,2,45,1,393,55,126,0.437,25,59,0.424,30,67,0.448,0.536,10,11,0.909,8,35,43,19,16,2,11,33
31,6,2015,27,1,2,5,0,103,16,28,0.571,4,12,0.333,12,16,0.75,0.643,3,4,0.75,4,13,17,4,3,0,2,4
32,7,2001,28,1,2,82,40,2426,265,675,0.393,107,269,0.398,158,406,0.389,0.472,104,126,0.825,23,174,197,295,99,12,102,218
34,2,1992,28,1,2,79,32,1677,221,424,0.521,23,70,0.329,198,354,0.559,0.548,155,182,0.852,69,158,227,174,68,15,83,159
34,9,1999,35,1,2,47,37,1291,156,331,0.471,40,107,0.374,116,224,0.518,0.532,103,119,0.866,36,101,137,89,46,12,61,91
34,11,2001,37,1,2,68,67,1506,104,246,0.423,36,100,0.36,68,146,0.466,0.496,55,69,0.797,38,117,155,131,58,12,60,112
42,4,1987,26,1,2,82,76,3073,785,1520,0.516,86,240,0.358,699,1280,0.546,0.545,385,489,0.787,187,260,447,238,104,32,238,267
42,5,1988,27,1,2,75,73,2790,764,1519,0.503,107,259,0.413,657,1260,0.521,0.538,303,395,0.767,167,173,340,197,74,11,172,221
42,6,1989,28,1,2,82,82,3190,857,1710,0.501,162,339,0.478,695,1371,0.507,0.549,377,462,0.816,156,186,342,164,108,22,218,197
42,7,1990,29,1,2,55,49,2033,502,1011,0.497,96,256,0.375,406,755,0.538,0.544,193,236,0.818,90,148,238,110,59,7,119,124
42,8,1991,30,1,2,21,0,624,159,327,0.486,30,68,0.441,129,259,0.498,0.532,58,82,0.707,38,43,81,31,16,5,32,53
42,8,1991,30,1,2,30,24,800,181,391,0.463,27,89,0.303,154,302,0.51,0.497,62,84,0.738,28,64,92,64,33,3,49,59
42,8,1991,30,1,2,51,24,1424,340,718,0.474,57,157,0.363,283,561,0.504,0.513,120,166,0.723,66,107,173,95,49,8,81,112
42,10,1993,32,1,2,82,76,2731,545,1092,0.499,119,297,0.401,426,795,0.536,0.554,157,197,0.797,81,231,312,107,78,18,111,179
42,17,2000,39,1,2,24,5,240,19,58,0.328,14,35,0.4,5,23,0.217,0.448,3,4,0.75,6,16,22,8,7,0,13,22
42,17,2000,39,1,2,18,0,324,47,101,0.465,23,65,0.354,24,36,0.667,0.579,6,9,0.667,7,27,34,6,6,0,7,23
42,17,2000,39,1,2,42,5,564,66,159,0.415,37,100,0.37,29,59,0.492,0.531,9,13,0.692,13,43,56,14,13,0,20,45
43,1,2006,20,1,2,49,3,886,132,318,0.415,28,82,0.341,104,236,0.441,0.459,42,59,0.712,22,83,105,78,32,11,58,69
43,2,2007,21,1,2,77,53,2638,480,1010,0.475,39,143,0.273,441,867,0.509,0.495,273,358,0.763,62,181,243,319,132,21,221,210
43,3,2008,22,1,2,81,72,3071,652,1227,0.531,12,52,0.231,640,1175,0.545,0.536,320,417,0.767,133,271,404,315,124,27,173,195
43,4,2009,23,1,2,25,25,892,194,430,0.451,8,26,0.308,186,404,0.46,0.46,78,94,0.83,14,94,108,93,39,8,67,67
43,5,2010,24,1,2,64,64,2647,631,1406,0.449,77,228,0.338,554,1178,0.47,0.476,292,388,0.753,47,210,257,340,143,25,244,189
43,6,2011,25,1,2,80,80,3227,726,1611,0.451,137,379,0.361,589,1232,0.478,0.493,340,431,0.789,44,237,281,450,168,23,252,203
43,7,2012,26,1,2,21,21,755,145,336,0.432,12,45,0.267,133,291,0.457,0.449,68,89,0.764,4,69,73,123,29,6,54,52
43,7,2012,26,1,2,37,37,1365,305,704,0.433,50,156,0.321,255,548,0.465,0.469,151,186,0.812,16,111,127,223,56,12,123,84
43,7,2012,26,1,2,58,58,2120,450,1040,0.433,62,201,0.308,388,839,0.462,0.463,219,275,0.796,20,180,200,346,85,18,177,136
43,8,2013,27,1,2,82,82,3076,597,1436,0.416,94,328,0.287,503,1108,0.454,0.448,289,374,0.773,45,271,316,496,169,36,254,164
43,10,2015,29,1,2,10,10,318,74,151,0.49,9,27,0.333,65,124,0.524,0.52,27,33,0.818,8,18,26,44,12,3,22,28
51,1,1991,23,1,2,70,12,1443,251,572,0.439,3,31,0.097,248,541,0.458,0.441,111,157,0.707,66,81,147,177,25,15,114,127
51,2,1992,24,1,2,81,6,1665,366,846,0.433,6,34,0.176,360,812,0.443,0.436,148,176,0.841,74,94,168,143,32,9,89,160
54,1,1994,23,1,2,36,0,419,56,129,0.434,8,17,0.471,48,112,0.429,0.465,10,21,0.476,9,36,45,38,8,10,36,61
54,2,1995,24,1,2,8,0,127,15,39,0.385,3,12,0.25,12,27,0.444,0.423,10,13,0.769,1,2,3,7,7,1,6,19
55,1,2013,24,1,2,41,0,407,42,112,0.375,14,50,0.28,28,62,0.452,0.438,21,29,0.724,8,29,37,26,16,3,19,46
69,1,1980,24,1,2,79,-1,1246,208,464,0.448,12,42,0.286,196,422,0.464,0.461,58,85,0.682,29,78,107,230,60,9,128,194
69,4,1983,27,1,2,42,5,695,115,243,0.473,0,9,0,115,234,0.491,0.473,33,41,0.805,4,54,58,113,23,3,71,94
69,6,1985,29,1,2,81,0,1437,323,661,0.489,57,157,0.363,266,504,0.528,0.532,113,131,0.863,26,93,119,231,65,12,130,174
69,8,1987,31,1,2,81,4,1567,334,729,0.458,53,169,0.314,281,560,0.502,0.495,96,123,0.78,36,92,128,185,79,12,107,149
70,1,2006,22,1,2,66,5,971,97,255,0.38,22,78,0.282,75,177,0.424,0.424,36,46,0.783,23,62,85,84,37,6,57,86
72,1,2010,20,1,2,72,72,2677,533,1165,0.458,36,141,0.255,497,1024,0.485,0.473,348,465,0.748,66,314,380,414,109,26,216,204
72,2,2011,21,1,2,57,53,2107,382,933,0.409,43,148,0.291,339,785,0.432,0.432,205,266,0.771,46,229,275,319,85,30,184,143
72,3,2012,22,1,2,63,61,2162,408,900,0.453,20,99,0.202,388,801,0.484,0.464,201,258,0.779,64,225,289,283,84,29,171,136
72,4,2013,23,1,2,65,61,2016,366,765,0.478,45,133,0.338,321,632,0.508,0.508,210,271,0.775,56,231,287,229,90,27,128,133
79,1,1998,23,1,2,59,16,959,144,357,0.403,4,19,0.211,140,338,0.414,0.409,84,125,0.672,44,72,116,51,35,13,65,81
79,2,1999,24,1,2,49,49,1205,177,407,0.435,6,21,0.286,171,386,0.443,0.442,94,136,0.691,72,114,186,50,50,16,70,121
79,3,2000,25,1,2,15,10,373,51,131,0.389,1,2,0.5,50,129,0.388,0.393,31,42,0.738,24,28,52,26,6,12,19,31
79,3,2000,25,1,2,46,46,1205,223,515,0.433,2,21,0.095,221,494,0.447,0.435,115,151,0.762,77,162,239,72,53,16,87,116
79,3,2000,25,1,2,61,56,1578,274,646,0.424,3,23,0.13,271,623,0.435,0.426,146,193,0.756,101,190,291,98,59,28,106,147
79,4,2001,26,1,2,29,12,420,43,111,0.387,4,10,0.4,39,101,0.386,0.405,21,36,0.583,14,45,59,22,14,13,34,54
79,5,2002,27,1,2,20,12,417,55,145,0.379,1,2,0.5,54,143,0.378,0.383,24,32,0.75,39,39,78,22,18,9,24,51
79,5,2002,27,1,2,24,12,441,55,147,0.374,1,2,0.5,54,145,0.372,0.378,24,33,0.727,41,43,84,24,20,10,27,56
79,6,2003,28,1,2,14,0,204,27,58,0.466,0,1,0,27,57,0.474,0.466,3,6,0.5,14,26,40,21,6,3,7,26
96,1,2008,22,1,2,75,9,970,99,241,0.411,10,48,0.208,89,193,0.461,0.432,68,87,0.782,36,101,137,52,31,8,34,83
96,2,2009,23,1,2,74,8,1234,131,300,0.437,43,107,0.402,88,193,0.456,0.508,58,71,0.817,30,104,134,44,28,13,43,144
96,3,2010,24,1,2,82,75,2221,272,585,0.465,108,249,0.434,164,336,0.488,0.557,72,98,0.735,59,193,252,138,46,30,74,225
96,4,2011,25,1,2,69,69,2324,312,627,0.498,105,248,0.423,207,379,0.546,0.581,138,163,0.847,45,206,251,168,34,31,71,153
96,5,2012,26,1,2,62,62,2086,329,699,0.471,88,221,0.398,241,478,0.504,0.534,197,247,0.798,40,157,197,149,36,13,85,134
96,7,2014,28,1,2,73,73,2552,464,1011,0.459,128,300,0.427,336,711,0.473,0.522,274,336,0.815,32,230,262,248,35,3,146,136
96,8,2015,29,1,2,8,8,220,32,77,0.416,9,30,0.3,23,47,0.489,0.474,13,16,0.813,2,22,24,13,3,0,4,17
98,1,1982,22,1,2,53,1,564,79,221,0.357,5,17,0.294,74,204,0.363,0.369,56,65,0.862,25,31,56,87,37,3,53,86
98,2,1983,23,1,2,80,76,2048,357,720,0.496,5,29,0.172,352,691,0.509,0.499,72,97,0.742,83,131,214,251,109,6,98,259
98,3,1984,24,1,2,71,3,1154,166,361,0.46,6,22,0.273,160,339,0.472,0.468,46,56,0.821,29,87,116,162,41,4,70,143
98,4,1985,25,1,2,75,73,2564,419,792,0.529,15,56,0.268,404,736,0.549,0.539,118,136,0.868,76,192,268,399,122,6,149,228
98,5,1986,26,1,2,80,78,2407,353,701,0.504,26,73,0.356,327,628,0.521,0.522,123,136,0.904,47,188,235,405,94,7,129,204
98,6,1987,27,1,2,71,66,2499,410,844,0.486,85,192,0.443,325,652,0.498,0.536,148,165,0.897,49,193,242,400,101,14,141,189
98,7,1988,28,1,2,81,81,3018,482,982,0.491,148,357,0.415,334,625,0.534,0.566,158,180,0.878,59,190,249,503,115,17,153,203
98,10,1991,31,1,2,80,0,1710,337,714,0.472,102,251,0.406,235,463,0.508,0.543,114,138,0.826,45,160,205,285,63,13,100,195
98,11,1992,32,1,2,81,6,1595,299,676,0.442,78,230,0.339,221,446,0.496,0.5,108,131,0.824,40,108,148,202,73,13,70,148
98,12,1993,33,1,2,80,0,2163,337,730,0.462,150,372,0.403,187,358,0.522,0.564,123,145,0.848,49,165,214,260,69,8,113,175
98,13,1994,34,1,2,68,1,1555,224,537,0.417,80,244,0.328,144,293,0.491,0.492,78,94,0.83,28,103,131,180,57,8,81,140
98,14,1995,35,1,2,74,1,1374,194,422,0.46,78,214,0.364,116,208,0.558,0.552,105,130,0.808,25,84,109,210,46,7,79,155
109,2,2002,24,1,2,56,28,1325,223,474,0.47,5,18,0.278,218,456,0.478,0.476,98,121,0.81,43,105,148,86,35,7,60,113
114,1,1996,23,1,2,41,0,362,36,105,0.343,10,33,0.303,26,72,0.361,0.39,26,36,0.722,5,20,25,49,21,5,34,42
114,2,1997,24,1,2,25,0,251,21,74,0.284,7,34,0.206,14,40,0.35,0.331,15,25,0.6,12,21,33,43,4,4,13,17
114,2,1997,24,1,2,51,1,692,57,147,0.388,23,59,0.39,34,88,0.386,0.466,27,47,0.574,13,52,65,109,27,0,56,67
114,2,1997,24,1,2,76,1,943,78,221,0.353,30,93,0.323,48,128,0.375,0.421,42,72,0.583,25,73,98,152,31,4,69,84
117,1,1990,25,1,2,63,6,746,106,239,0.444,0,7,0,106,232,0.457,0.444,23,43,0.535,49,89,138,23,16,19,28,102
118,1,1997,21,1,2,82,81,2532,390,908,0.43,117,298,0.393,273,610,0.448,0.494,205,249,0.823,97,229,326,210,75,10,149,218
118,2,1998,22,1,2,82,82,3287,563,1315,0.428,134,368,0.364,429,947,0.453,0.479,342,391,0.875,127,278,405,356,111,12,263,244
118,3,1999,23,1,2,50,50,1719,303,673,0.45,74,208,0.356,229,465,0.492,0.505,176,195,0.903,57,155,212,178,53,7,122,117
118,4,2000,24,1,2,82,82,3070,642,1411,0.455,172,407,0.423,470,1004,0.468,0.516,353,398,0.887,83,276,359,308,110,19,183,187
118,5,2001,25,1,2,82,82,3129,628,1309,0.48,202,467,0.433,426,842,0.506,0.557,348,392,0.888,101,327,428,374,124,20,204,192
118,6,2002,26,1,2,69,67,2525,530,1148,0.462,229,528,0.434,301,620,0.485,0.561,214,245,0.873,81,231,312,271,88,18,159,157
118,7,2003,27,1,2,29,29,1197,247,560,0.441,78,222,0.351,169,338,0.5,0.511,138,150,0.92,49,114,163,170,46,3,81,71
118,7,2003,27,1,2,47,46,1683,351,803,0.437,123,311,0.395,228,492,0.463,0.514,178,195,0.913,45,173,218,164,57,11,117,149
118,7,2003,27,1,2,76,75,2880,598,1363,0.439,201,533,0.377,397,830,0.478,0.512,316,345,0.916,94,287,381,334,103,14,198,220
118,8,2004,28,1,2,56,56,2152,447,1017,0.44,148,378,0.392,299,639,0.468,0.512,245,271,0.904,69,217,286,268,71,11,156,132
118,9,2005,29,1,2,78,78,3064,640,1494,0.428,209,556,0.376,431,938,0.459,0.498,378,428,0.883,79,268,347,289,84,5,171,167
118,10,2006,30,1,2,78,78,3022,681,1500,0.454,269,653,0.412,412,847,0.486,0.544,324,359,0.903,71,261,332,286,105,16,188,151
118,11,2007,31,1,2,55,55,2219,505,1153,0.438,165,443,0.372,340,710,0.479,0.51,279,309,0.903,57,190,247,228,82,11,154,113
118,12,2008,32,1,2,73,73,2624,439,986,0.445,180,452,0.398,259,534,0.485,0.537,215,237,0.907,75,193,268,225,65,16,127,147
118,13,2009,33,1,2,79,79,2876,499,1040,0.48,199,486,0.409,300,554,0.542,0.575,237,249,0.952,66,212,278,218,69,13,134,157
118,14,2010,34,1,2,80,80,2819,464,973,0.477,145,399,0.363,319,574,0.556,0.551,231,253,0.913,45,208,253,210,64,25,129,182
118,15,2011,35,1,2,80,80,2890,480,978,0.491,168,378,0.444,312,600,0.52,0.577,193,219,0.881,51,223,274,219,77,16,117,147
118,16,2012,36,1,2,46,42,1565,226,493,0.458,106,234,0.453,120,259,0.463,0.566,97,106,0.915,14,128,142,109,49,8,68,83
118,17,2013,37,1,2,79,0,2035,292,651,0.449,139,332,0.419,153,319,0.48,0.555,140,158,0.886,40,177,217,135,67,15,103,129
118,18,2014,38,1,2,73,9,1936,240,543,0.442,116,309,0.375,124,234,0.53,0.549,105,116,0.905,23,182,205,143,54,8,84,115
121,1,2005,23,1,2,77,34,1262,184,387,0.475,12,31,0.387,172,356,0.483,0.491,112,152,0.737,85,136,221,64,76,24,77,156
121,3,2007,25,1,2,33,18,805,133,259,0.514,8,33,0.242,125,226,0.553,0.529,105,134,0.784,35,89,124,56,49,12,75,87
121,4,2008,26,1,2,75,11,1373,169,389,0.434,18,57,0.316,151,332,0.455,0.458,138,181,0.762,34,134,168,114,62,21,109,168
121,5,2009,27,1,2,46,2,887,137,284,0.482,6,27,0.222,131,257,0.51,0.493,79,109,0.725,22,82,104,66,54,23,77,98
121,6,2010,28,1,2,54,8,889,129,253,0.51,0,5,0,129,248,0.52,0.51,72,119,0.605,52,93,145,72,59,19,66,109
121,7,2011,29,1,2,72,31,1494,251,492,0.51,4,23,0.174,247,469,0.527,0.514,137,182,0.753,70,123,193,104,129,44,86,161
121,8,2012,30,1,2,58,57,1525,210,448,0.469,8,26,0.308,202,422,0.479,0.478,140,175,0.8,98,135,233,79,104,33,94,142
121,9,2013,31,1,2,79,79,2109,284,638,0.445,3,24,0.125,281,614,0.458,0.447,134,187,0.717,121,242,363,98,119,44,94,211
121,10,2014,32,1,2,55,28,1278,204,413,0.494,11,47,0.234,193,366,0.527,0.507,76,121,0.628,79,129,208,94,90,19,90,121
121,11,2015,33,1,2,10,10,282,30,67,0.448,1,5,0.2,29,62,0.468,0.455,9,17,0.529,14,33,47,20,22,2,11,35
139,2,1999,24,1,2,38,13,978,125,314,0.398,21,69,0.304,104,245,0.424,0.432,138,165,0.836,20,89,109,145,48,4,82,73
139,3,2000,25,1,2,64,58,2201,377,860,0.438,55,178,0.309,322,682,0.472,0.47,271,309,0.877,80,178,258,220,90,11,167,149
139,4,2001,26,1,2,82,82,2859,413,993,0.416,101,253,0.399,312,740,0.422,0.467,342,402,0.851,75,288,363,301,120,14,165,188
139,5,2002,27,1,2,70,27,1860,247,612,0.404,85,228,0.373,162,384,0.422,0.473,178,208,0.856,47,142,189,216,68,8,87,113
139,7,2004,29,1,2,51,46,1810,230,612,0.376,79,259,0.305,151,353,0.428,0.44,155,188,0.824,26,156,182,228,66,3,90,79
139,8,2005,30,1,2,47,32,1239,152,391,0.389,58,151,0.384,94,240,0.392,0.463,70,87,0.805,25,103,128,143,36,4,70,89
139,9,2006,31,1,2,23,3,465,40,130,0.308,21,67,0.313,19,63,0.302,0.388,32,38,0.842,9,51,60,48,8,2,17,49
139,9,2006,31,1,2,20,8,582,68,173,0.393,19,67,0.284,49,106,0.462,0.448,61,73,0.836,12,71,83,53,15,4,37,49
139,9,2006,31,1,2,43,11,1047,108,303,0.356,40,134,0.299,68,169,0.402,0.422,93,111,0.838,21,122,143,101,23,6,54,98
139,11,2008,33,1,2,28,0,396,47,125,0.376,19,52,0.365,28,73,0.384,0.452,28,38,0.737,9,43,52,44,12,1,25,49
143,2,2012,22,1,2,51,2,603,66,174,0.379,19,68,0.279,47,106,0.443,0.434,39,52,0.75,16,63,79,41,8,2,30,35
143,3,2013,23,1,2,29,2,307,41,101,0.406,16,49,0.327,25,52,0.481,0.485,17,19,0.895,15,43,58,33,12,3,18,18
143,3,2013,23,1,2,39,2,401,52,126,0.413,21,60,0.35,31,66,0.47,0.496,24,28,0.857,18,54,72,42,15,5,25,25
143,4,2014,24,1,2,80,62,2309,309,717,0.431,115,351,0.328,194,366,0.53,0.511,77,106,0.726,59,241,300,149,74,28,106,154
149,1,1990,22,1,2,81,9,1785,372,753,0.494,1,17,0.059,371,736,0.504,0.495,186,264,0.705,107,209,316,124,69,34,138,140
149,2,1991,23,1,2,70,42,1971,400,857,0.467,17,58,0.293,383,799,0.479,0.477,173,259,0.668,92,294,386,106,74,44,113,145
149,3,1992,24,1,2,60,59,2203,482,1042,0.463,30,85,0.353,452,957,0.472,0.477,202,303,0.667,98,286,384,163,97,33,126,132
149,4,1993,25,1,2,79,76,2920,594,1324,0.449,88,249,0.353,506,1075,0.471,0.482,298,402,0.741,122,355,477,265,128,56,164,200
149,5,1994,26,1,2,81,81,2811,504,1054,0.478,101,314,0.322,403,740,0.545,0.526,168,250,0.672,113,363,476,294,134,33,165,148
149,6,1995,27,1,2,76,76,2588,439,923,0.476,179,431,0.415,260,492,0.528,0.573,143,203,0.704,85,250,335,314,125,22,141,124
149,7,1996,28,1,2,77,77,2717,400,904,0.442,168,430,0.391,232,474,0.489,0.535,166,240,0.692,92,323,415,279,121,46,141,135
149,8,1997,29,1,2,63,61,2163,288,725,0.397,143,405,0.353,145,320,0.453,0.496,38,94,0.404,66,238,304,182,120,32,86,160
149,11,2000,32,1,2,72,72,2094,306,782,0.391,132,397,0.332,174,385,0.452,0.476,37,76,0.487,83,256,339,123,94,16,95,118
149,12,2001,33,1,2,21,0,169,14,57,0.246,10,39,0.256,4,18,0.222,0.333,0,0,-1,3,22,25,13,10,4,7,13
149,13,2002,34,1,2,15,0,219,21,76,0.276,13,48,0.271,8,28,0.286,0.362,5,9,0.556,1,32,33,14,6,6,14,17
150,1,1997,23,1,2,65,0,1066,147,318,0.462,24,47,0.511,123,271,0.454,0.5,68,99,0.687,52,127,179,49,27,8,73,113
150,2,1998,24,1,2,82,2,1602,269,500,0.538,7,32,0.219,262,468,0.56,0.545,136,185,0.735,86,141,227,89,66,18,91,145
150,3,1999,25,1,2,50,2,1072,162,363,0.446,14,41,0.341,148,322,0.46,0.466,89,125,0.712,49,83,132,56,39,10,66,89
150,5,2001,27,1,2,82,82,2396,263,590,0.446,46,170,0.271,217,420,0.517,0.485,138,188,0.734,72,261,333,189,82,40,131,202
150,6,2002,28,1,2,82,6,1596,149,373,0.399,39,141,0.277,110,232,0.474,0.452,74,107,0.692,57,192,249,76,48,15,97,134
150,8,2004,30,1,2,80,37,1974,238,564,0.422,36,128,0.281,202,436,0.463,0.454,123,161,0.764,53,169,222,122,68,17,118,182
151,2,1990,23,1,2,82,81,2788,532,1082,0.492,7,26,0.269,525,1056,0.497,0.495,217,290,0.748,115,257,372,364,111,58,198,252
151,3,1991,24,1,2,75,75,2592,453,991,0.457,7,35,0.2,446,956,0.467,0.461,170,213,0.798,68,283,351,358,79,46,167,226
151,4,1992,25,1,2,57,55,1889,312,685,0.455,13,56,0.232,299,629,0.475,0.465,107,138,0.775,62,238,300,302,54,51,140,151
151,5,1993,26,1,2,38,7,560,80,186,0.43,1,8,0.125,79,178,0.444,0.433,22,28,0.786,7,50,57,79,14,6,44,52
151,6,1994,27,1,2,80,79,2488,394,837,0.471,22,68,0.324,372,769,0.484,0.484,145,171,0.848,68,174,242,347,71,46,153,187
151,7,1995,28,1,2,38,11,556,76,162,0.469,3,19,0.158,73,143,0.51,0.478,30,41,0.732,15,40,55,52,26,10,38,71
151,8,1996,29,1,2,27,2,496,56,133,0.421,5,25,0.2,51,108,0.472,0.44,19,31,0.613,13,47,60,48,17,8,24,59
151,8,1996,29,1,2,49,42,1564,232,527,0.44,29,95,0.305,203,432,0.47,0.468,113,132,0.856,35,151,186,149,58,51,119,171
151,8,1996,29,1,2,76,44,2060,288,660,0.436,34,120,0.283,254,540,0.47,0.462,132,163,0.81,48,198,246,197,75,59,143,230
151,9,1997,30,1,2,28,1,303,29,64,0.453,8,19,0.421,21,45,0.467,0.516,17,20,0.85,15,27,42,34,14,4,19,36
159,2,2015,20,1,2,9,0,221,43,82,0.524,2,8,0.25,41,74,0.554,0.537,18,24,0.75,9,39,48,11,2,6,11,16
168,3,2007,21,1,2,57,7,1278,200,371,0.539,0,7,0,200,364,0.549,0.539,106,171,0.62,98,151,249,65,59,19,84,134
177,1,2002,21,1,2,35,0,196,27,85,0.318,5,17,0.294,22,68,0.324,0.347,5,10,0.5,10,6,16,8,7,1,8,26
177,2,2004,23,1,2,56,0,434,65,175,0.371,19,52,0.365,46,123,0.374,0.426,2,4,0.5,12,31,43,14,12,2,24,49
184,7,2006,31,1,2,28,2,552,66,174,0.379,33,92,0.359,33,82,0.402,0.474,22,31,0.71,12,33,45,69,14,0,30,58
184,9,2008,33,1,2,24,0,352,42,122,0.344,25,79,0.316,17,43,0.395,0.447,4,9,0.444,3,28,31,47,9,1,10,27
186,1,1992,23,1,2,82,82,2505,440,899,0.489,1,6,0.167,439,893,0.492,0.49,213,320,0.666,191,229,420,201,124,27,181,161
186,2,1993,24,1,2,73,66,2112,397,792,0.501,0,4,0,397,788,0.504,0.501,227,307,0.739,141,146,287,170,91,18,157,141
186,3,1994,25,1,2,82,82,2605,439,861,0.51,1,7,0.143,438,854,0.513,0.51,333,436,0.764,178,216,394,187,149,45,147,179
186,4,1995,26,1,2,76,76,2362,397,876,0.453,7,26,0.269,390,850,0.459,0.457,252,346,0.728,157,211,368,197,100,47,152,163
186,6,1997,28,1,2,20,3,292,31,77,0.403,0,0,-1,31,77,0.403,0.403,28,41,0.683,14,35,49,15,10,10,27,29
186,6,1997,28,1,2,40,7,650,74,143,0.517,0,0,-1,74,143,0.517,0.517,41,56,0.732,33,56,89,41,32,7,37,58
186,6,1997,28,1,2,60,10,942,105,220,0.477,0,0,-1,105,220,0.477,0.477,69,97,0.711,47,91,138,56,42,17,64,87
186,7,1998,29,1,2,71,23,1445,154,372,0.414,1,7,0.143,153,365,0.419,0.415,94,156,0.603,104,131,235,88,57,32,81,144
186,9,2000,31,1,2,59,0,692,83,175,0.474,0,2,0,83,173,0.48,0.474,37,55,0.673,42,74,116,53,27,11,38,69
186,10,2001,32,1,2,66,23,1182,127,266,0.477,0,4,0,127,262,0.485,0.477,57,87,0.655,60,99,159,98,48,21,48,105
186,11,2002,33,1,2,77,3,1319,140,328,0.427,0,3,0,140,325,0.431,0.427,77,101,0.762,59,166,225,103,56,12,54,115
186,12,2003,34,1,2,70,3,862,79,192,0.411,0,7,0,79,185,0.427,0.411,54,72,0.75,26,93,119,69,27,9,40,80
194,1,2014,23,1,2,14,0,132,8,30,0.267,6,27,0.222,2,3,0.667,0.367,0,0,-1,4,13,17,3,6,0,3,13
205,1,1999,23,1,2,27,10,249,34,86,0.395,1,5,0.2,33,81,0.407,0.401,9,13,0.692,24,30,54,13,9,2,11,24
205,2,2000,24,1,2,46,2,449,58,140,0.414,2,10,0.2,56,130,0.431,0.421,45,65,0.692,26,46,72,30,13,4,24,55
217,3,2006,23,1,2,57,11,1592,273,567,0.481,87,196,0.444,186,371,0.501,0.558,111,147,0.755,31,119,150,158,48,6,89,145
217,4,2007,24,1,2,80,18,2613,529,1111,0.476,190,438,0.434,339,673,0.504,0.562,196,232,0.845,22,192,214,317,96,15,146,210
217,5,2008,25,1,2,82,12,2421,472,1021,0.462,164,422,0.389,308,599,0.514,0.543,175,213,0.822,40,191,231,216,75,18,117,195
217,6,2009,26,1,2,70,11,1705,366,759,0.482,90,240,0.375,276,519,0.532,0.542,171,194,0.881,34,147,181,162,82,7,93,115
217,8,2011,28,1,2,58,0,1395,294,653,0.45,72,213,0.338,222,440,0.505,0.505,109,137,0.796,14,85,99,119,50,6,84,112
217,9,2012,29,1,2,22,0,436,73,183,0.399,25,59,0.424,48,124,0.387,0.467,25,33,0.758,12,37,49,33,20,0,26,34
217,9,2012,29,1,2,42,0,946,198,454,0.436,40,111,0.36,158,343,0.461,0.48,76,91,0.835,21,58,79,63,36,7,68,101
217,9,2012,29,1,2,64,0,1382,271,637,0.425,65,170,0.382,206,467,0.441,0.476,101,124,0.815,33,95,128,96,56,7,94,135
217,12,2015,32,1,2,9,1,154,31,61,0.508,4,16,0.25,27,45,0.6,0.541,5,6,0.833,5,11,16,15,7,4,12,17
218,3,2009,24,1,2,79,15,1600,246,557,0.442,55,154,0.357,191,403,0.474,0.491,70,93,0.753,36,141,177,269,37,5,105,121
238,1,1996,24,1,2,79,44,1898,283,597,0.474,123,296,0.416,160,301,0.532,0.577,111,137,0.81,38,130,168,230,95,22,120,196
238,2,1997,25,1,2,59,0,1094,155,379,0.409,56,173,0.324,99,206,0.481,0.483,76,93,0.817,30,80,110,154,51,15,76,88
238,3,1998,26,1,2,17,0,259,23,62,0.371,12,34,0.353,11,28,0.393,0.468,12,12,1,2,26,28,21,14,4,9,30
238,3,1998,26,1,2,41,36,1341,190,444,0.428,78,195,0.4,112,249,0.45,0.516,103,122,0.844,27,116,143,132,50,23,95,88
238,3,1998,26,1,2,58,36,1600,213,506,0.421,90,229,0.393,123,277,0.444,0.51,115,134,0.858,29,142,171,153,64,27,104,118
238,4,1999,27,1,2,37,30,1181,141,356,0.396,52,172,0.302,89,184,0.484,0.469,78,101,0.772,39,105,144,116,42,11,72,98
238,5,2000,28,1,2,80,74,2726,327,707,0.463,164,399,0.411,163,308,0.529,0.579,127,157,0.809,50,322,372,291,103,31,142,228
238,6,2001,29,1,2,67,20,1778,198,401,0.494,109,229,0.476,89,172,0.517,0.63,84,103,0.816,33,178,211,225,80,14,86,126
238,7,2002,30,1,2,81,81,3040,401,790,0.508,164,387,0.424,237,403,0.588,0.611,198,234,0.846,58,383,441,426,147,37,165,182
238,8,2003,31,1,2,75,68,2480,264,577,0.458,118,293,0.403,146,284,0.514,0.56,128,161,0.795,48,253,301,384,113,15,142,199
238,9,2004,32,1,2,59,53,1803,215,427,0.504,114,252,0.452,101,175,0.577,0.637,91,110,0.827,21,183,204,342,85,16,139,121
238,10,2005,33,1,2,81,8,1742,194,459,0.423,100,280,0.357,94,179,0.525,0.532,113,135,0.837,29,161,190,178,39,20,64,123
238,11,2006,34,1,2,74,5,1259,156,345,0.452,80,202,0.396,76,143,0.531,0.568,39,59,0.661,29,130,159,123,39,27,52,99
238,12,2007,35,1,2,75,28,1631,202,425,0.475,128,287,0.446,74,138,0.536,0.626,103,117,0.88,17,143,160,138,56,12,61,88
238,14,2009,37,1,2,56,1,857,70,172,0.407,49,131,0.374,21,41,0.512,0.549,19,20,0.95,17,77,94,78,24,3,48,45
239,2,1999,25,1,2,17,0,183,10,32,0.313,8,24,0.333,2,8,0.25,0.438,9,13,0.692,3,17,20,29,7,1,12,24
240,1,1993,23,1,2,47,0,552,76,206,0.369,21,63,0.333,55,143,0.385,0.42,33,49,0.673,10,33,43,68,35,3,42,57
240,2,1994,24,1,2,72,7,1242,158,382,0.414,32,115,0.278,126,267,0.472,0.455,97,122,0.795,36,110,146,168,102,17,83,110
240,3,1995,25,1,2,52,0,602,57,134,0.425,16,48,0.333,41,86,0.477,0.485,61,80,0.763,15,34,49,85,30,4,41,54
240,4,1996,26,1,2,68,0,712,91,185,0.492,44,93,0.473,47,92,0.511,0.611,31,37,0.838,17,46,63,85,33,11,42,51
240,5,1997,27,1,2,58,8,965,100,246,0.407,48,124,0.387,52,122,0.426,0.504,37,46,0.804,26,73,99,115,55,3,59,56
240,6,1998,28,1,2,49,1,374,38,104,0.365,18,61,0.295,20,43,0.465,0.452,27,29,0.931,8,29,37,51,24,3,22,33
240,7,1999,29,1,2,43,0,736,59,138,0.428,24,79,0.304,35,59,0.593,0.514,71,84,0.845,25,71,96,112,53,5,47,61
240,8,2000,30,1,2,62,1,1281,161,346,0.465,66,154,0.429,95,192,0.495,0.561,107,116,0.922,38,121,159,150,75,7,85,104
240,9,2001,31,1,2,62,2,1010,103,255,0.404,46,132,0.348,57,123,0.463,0.494,64,73,0.877,16,78,94,130,28,6,53,66
240,10,2002,32,1,2,82,6,1985,255,522,0.489,121,258,0.469,134,264,0.508,0.604,108,116,0.931,42,192,234,274,94,20,111,134
240,11,2003,33,1,2,80,0,1473,191,424,0.45,87,214,0.407,104,210,0.495,0.553,86,100,0.86,33,147,180,206,63,14,81,104
240,12,2004,34,1,2,57,9,1101,120,297,0.404,51,138,0.37,69,159,0.434,0.49,60,71,0.845,25,98,123,147,57,8,53,66
240,13,2005,35,1,2,16,0,275,31,77,0.403,11,32,0.344,20,45,0.444,0.474,10,13,0.769,4,17,21,28,14,2,14,28
240,13,2005,35,1,2,53,2,1230,130,291,0.447,60,133,0.451,70,158,0.443,0.55,52,58,0.897,22,116,138,139,46,7,53,67
240,13,2005,35,1,2,69,2,1505,161,368,0.438,71,165,0.43,90,203,0.443,0.534,62,71,0.873,26,133,159,167,60,9,67,95
240,14,2006,36,1,2,20,0,342,25,65,0.385,12,32,0.375,13,33,0.394,0.477,24,29,0.828,1,30,31,26,13,1,22,25
243,1,2013,22,1,2,73,5,894,118,309,0.382,9,65,0.138,109,244,0.447,0.396,50,65,0.769,36,109,145,58,34,9,60,56
243,2,2014,23,1,2,41,0,387,65,156,0.417,10,33,0.303,55,123,0.447,0.449,26,32,0.813,16,58,74,33,9,7,18,31
249,1,1980,23,1,2,16,-1,235,72,146,0.493,8,19,0.421,64,127,0.504,0.521,28,39,0.718,13,16,29,31,14,2,20,26
249,2,1981,24,1,2,77,-1,1560,439,902,0.487,14,54,0.259,425,848,0.501,0.494,170,199,0.854,71,86,157,196,82,6,149,120
249,3,1982,25,1,2,75,0,1229,327,692,0.473,12,41,0.293,315,651,0.484,0.481,166,211,0.787,53,55,108,111,41,5,93,100
249,4,1983,26,1,2,15,3,277,53,129,0.411,2,5,0.4,51,124,0.411,0.419,10,20,0.5,10,8,18,14,13,3,12,18
249,4,1983,26,1,2,19,3,304,55,145,0.379,2,5,0.4,53,140,0.379,0.386,11,22,0.5,11,8,19,14,14,3,12,19
252,4,2005,26,1,2,80,72,2516,271,613,0.442,70,177,0.395,201,436,0.461,0.499,180,228,0.789,158,255,413,126,91,77,75,201
252,8,2009,30,1,2,60,59,2031,145,354,0.41,91,237,0.384,54,117,0.462,0.538,55,67,0.821,52,233,285,137,48,54,49,114
252,9,2010,31,1,2,67,62,2168,178,447,0.398,101,279,0.362,77,168,0.458,0.511,77,106,0.726,74,238,312,164,53,76,64,139
253,1,1986,23,1,2,64,0,639,101,222,0.455,0,7,0,101,215,0.47,0.455,75,103,0.728,12,50,62,74,23,3,47,80
253,2,1987,24,1,2,64,8,804,144,315,0.457,0,10,0,144,305,0.472,0.457,93,126,0.738,16,44,60,124,29,5,60,76
253,3,1988,25,1,2,67,1,1227,278,613,0.454,16,41,0.39,262,572,0.458,0.467,141,188,0.75,26,87,113,158,31,5,75,84
253,4,1989,26,1,2,82,0,1672,287,628,0.457,11,34,0.324,276,594,0.465,0.466,194,238,0.815,30,110,140,197,42,9,104,125
253,5,1990,27,1,2,60,48,1477,275,544,0.506,2,13,0.154,273,531,0.514,0.507,102,135,0.756,27,72,99,154,28,3,89,115
253,6,1991,28,1,2,79,2,1863,397,862,0.461,14,49,0.286,383,813,0.471,0.469,270,316,0.854,34,125,159,217,45,6,113,145
253,7,1992,29,1,2,76,2,1637,316,659,0.48,2,17,0.118,314,642,0.489,0.481,145,171,0.848,19,93,112,159,36,5,91,116
253,8,1993,30,1,2,41,0,497,83,200,0.415,1,6,0.167,82,194,0.423,0.418,56,72,0.778,4,25,29,54,9,5,22,39
253,9,1994,31,1,2,51,1,814,130,273,0.476,5,19,0.263,125,254,0.492,0.485,73,97,0.753,7,32,39,83,22,1,41,66
253,10,1995,32,1,2,28,0,280,43,114,0.377,11,31,0.355,32,83,0.386,0.425,19,26,0.731,3,8,11,37,8,1,17,28
254,1,1990,25,1,2,59,8,729,93,170,0.547,1,4,0.25,92,166,0.554,0.55,55,82,0.671,44,80,124,38,35,11,32,94
254,2,1991,26,1,2,16,4,263,38,86,0.442,0,2,0,38,84,0.452,0.442,20,29,0.69,21,32,53,15,19,6,17,25
254,2,1991,26,1,2,40,4,682,95,196,0.485,3,22,0.136,92,174,0.529,0.492,50,64,0.781,62,61,123,47,41,12,36,83
254,2,1991,26,1,2,56,8,945,133,282,0.472,3,24,0.125,130,258,0.504,0.477,70,93,0.753,83,93,176,62,60,18,53,108
261,2,2010,21,1,2,74,11,1304,200,483,0.414,29,92,0.315,171,391,0.437,0.444,201,242,0.831,18,102,120,172,26,5,94,152
267,1,2013,19,1,2,56,46,1745,282,687,0.41,91,236,0.386,191,451,0.424,0.477,125,159,0.786,43,168,211,137,50,29,90,113
267,2,2014,20,1,2,73,73,2530,481,1149,0.419,138,343,0.402,343,806,0.426,0.479,149,189,0.788,54,219,273,243,71,18,128,153
270,1,2013,23,1,2,61,0,267,43,116,0.371,10,34,0.294,33,82,0.402,0.414,27,44,0.614,5,17,22,22,17,4,18,27
270,2,2014,24,1,2,44,0,268,36,97,0.371,10,39,0.256,26,58,0.448,0.423,19,36,0.528,5,35,40,20,12,6,28,42
270,2,2014,24,1,2,23,15,643,111,246,0.451,33,89,0.371,78,157,0.497,0.518,47,73,0.644,5,72,77,71,31,7,51,60
270,2,2014,24,1,2,67,15,911,147,343,0.429,43,128,0.336,104,215,0.484,0.491,66,109,0.606,10,107,117,91,43,13,79,102
284,1,2002,25,1,2,74,12,890,103,240,0.429,12,44,0.273,91,196,0.464,0.454,36,48,0.75,31,80,111,71,21,4,48,109
284,2,2003,26,1,2,75,32,1173,93,211,0.441,21,51,0.412,72,160,0.45,0.491,23,34,0.676,47,98,145,57,52,8,43,134
284,3,2004,27,1,2,82,4,2020,329,805,0.409,62,166,0.373,267,639,0.418,0.447,195,248,0.786,60,181,241,107,63,13,111,262
284,4,2005,28,1,2,63,32,1790,303,667,0.454,54,134,0.403,249,533,0.467,0.495,112,150,0.747,48,153,201,91,44,8,79,205
284,5,2006,29,1,2,79,79,2959,425,930,0.457,197,446,0.442,228,484,0.471,0.563,115,146,0.788,44,209,253,207,76,22,89,248
284,6,2007,30,1,2,78,78,2917,410,950,0.432,205,496,0.413,205,454,0.452,0.539,118,152,0.776,48,203,251,196,50,22,83,233
284,7,2008,31,1,2,75,75,2646,317,753,0.421,176,439,0.401,141,314,0.449,0.538,79,91,0.868,47,227,274,168,54,27,65,220
284,8,2009,32,1,2,22,22,712,76,177,0.429,44,94,0.468,32,83,0.386,0.554,16,21,0.762,8,56,64,29,13,2,18,57
284,8,2009,32,1,2,45,44,1603,223,507,0.44,70,177,0.395,153,330,0.464,0.509,71,81,0.877,33,146,179,113,37,6,68,109
284,8,2009,32,1,2,67,66,2315,299,684,0.437,114,271,0.421,185,413,0.448,0.52,87,102,0.853,41,202,243,142,50,8,86,166
284,9,2010,33,1,2,5,5,157,24,55,0.436,9,24,0.375,15,31,0.484,0.518,3,3,1,5,16,21,10,4,2,5,13
284,9,2010,33,1,2,6,5,180,28,61,0.459,12,27,0.444,16,34,0.471,0.557,3,3,1,5,18,23,13,4,2,5,15
284,10,2011,34,1,2,68,63,2097,191,467,0.409,68,193,0.352,123,274,0.449,0.482,91,102,0.892,31,145,176,118,56,14,63,169
284,11,2012,35,1,2,34,33,796,81,174,0.466,34,87,0.391,47,87,0.54,0.563,21,25,0.84,6,43,49,38,13,2,21,78
286,2,2009,22,1,2,42,23,882,140,317,0.442,52,131,0.397,88,186,0.473,0.524,40,52,0.769,10,61,71,88,36,1,59,73
286,3,2010,23,1,2,66,1,1121,154,379,0.406,60,158,0.38,94,221,0.425,0.485,101,121,0.835,14,81,95,89,42,5,60,80
286,4,2011,24,1,2,80,69,1957,302,691,0.437,134,324,0.414,168,367,0.458,0.534,98,125,0.784,17,134,151,92,38,6,77,146
286,5,2012,25,1,2,66,55,1966,286,686,0.417,107,284,0.377,179,402,0.445,0.495,101,129,0.783,19,153,172,101,48,5,69,115
286,6,2013,26,1,2,73,27,1882,241,610,0.395,79,221,0.357,162,389,0.416,0.46,141,168,0.839,13,127,140,148,44,6,82,140
300,1,1989,24,1,2,64,21,1406,255,567,0.45,65,160,0.406,190,407,0.467,0.507,131,166,0.789,57,140,197,80,37,22,82,197
310,2,2014,25,1,2,56,55,1751,199,481,0.414,92,255,0.361,107,226,0.473,0.509,83,102,0.814,72,124,196,151,77,23,66,174
316,2,1999,22,1,2,45,41,1488,191,495,0.386,85,235,0.362,106,260,0.408,0.472,157,172,0.913,24,72,96,173,58,14,98,115
316,3,2000,23,1,2,13,5,305,34,101,0.337,7,41,0.171,27,60,0.45,0.371,37,44,0.841,8,26,34,39,10,2,24,27
316,4,2001,24,1,2,77,33,1790,248,587,0.422,73,194,0.376,175,393,0.445,0.485,144,171,0.842,32,126,158,260,51,11,111,178
316,15,2012,35,1,2,20,20,607,83,228,0.364,48,125,0.384,35,103,0.34,0.469,85,95,0.895,4,46,50,80,9,3,38,40
316,16,2013,36,1,2,22,22,418,53,132,0.402,33,90,0.367,20,42,0.476,0.527,45,48,0.938,2,30,32,49,12,1,26,25
316,17,2014,37,1,2,19,7,309,24,79,0.304,14,48,0.292,10,31,0.323,0.392,10,12,0.833,4,24,28,42,8,1,25,25
321,1,1980,24,1,2,82,-1,2885,781,1546,0.505,10,36,0.278,771,1510,0.511,0.508,286,412,0.694,170,161,331,202,136,22,179,226
321,2,1981,25,1,2,71,-1,2593,710,1306,0.544,10,35,0.286,700,1271,0.551,0.547,317,455,0.697,119,139,258,233,93,18,173,172
321,3,1982,26,1,2,37,22,1025,225,480,0.469,0,10,0,225,470,0.479,0.469,74,127,0.583,30,67,97,124,30,5,64,74
321,4,1983,27,1,2,62,54,1885,426,834,0.511,2,6,0.333,424,828,0.512,0.512,82,145,0.566,53,97,150,239,85,16,114,155
321,5,1984,28,1,2,69,57,2168,583,1147,0.508,5,20,0.25,578,1127,0.513,0.51,194,319,0.608,74,96,170,266,86,17,170,180
321,6,1985,29,1,2,56,45,1842,495,968,0.511,4,21,0.19,491,947,0.518,0.513,161,259,0.622,60,88,148,232,84,7,117,145
321,7,1986,30,1,2,77,74,2395,542,1056,0.513,8,22,0.364,534,1034,0.516,0.517,122,210,0.581,88,114,202,261,85,17,179,228
321,8,1987,31,1,2,7,6,127,19,42,0.452,0,1,0,19,41,0.463,0.452,6,9,0.667,3,4,7,17,3,0,9,16
321,9,1988,32,1,2,67,59,1882,337,736,0.458,9,25,0.36,328,711,0.461,0.464,47,92,0.511,73,94,167,222,54,11,129,143
321,10,1989,33,1,2,13,0,108,18,36,0.5,1,3,0.333,17,33,0.515,0.514,0,2,0,4,9,13,9,3,1,12,10
331,1,1982,22,1,2,82,16,1979,439,855,0.513,1,4,0.25,438,851,0.515,0.514,212,276,0.768,97,157,254,105,46,30,113,122
331,2,1983,23,1,2,75,62,2349,513,1042,0.492,3,15,0.2,510,1027,0.497,0.494,297,381,0.78,108,185,293,185,37,29,118,116
331,3,1984,24,1,2,81,81,3025,721,1320,0.546,1,11,0.091,720,1309,0.55,0.547,372,458,0.812,124,249,373,288,56,37,169,127
331,4,1985,25,1,2,81,80,2834,625,1230,0.508,6,20,0.3,619,1210,0.512,0.511,342,413,0.828,107,193,300,289,61,16,162,96
331,5,1986,26,1,2,82,81,2787,677,1318,0.514,4,29,0.138,673,1289,0.522,0.515,404,483,0.836,88,203,291,271,79,25,189,138
331,6,1987,27,1,2,80,80,2758,626,1264,0.495,5,15,0.333,621,1249,0.497,0.497,419,474,0.884,96,182,278,266,64,21,174,142
331,7,1988,28,1,2,71,69,2580,497,1050,0.473,0,5,0,497,1045,0.476,0.473,331,379,0.873,82,164,246,262,64,18,144,112
331,8,1989,29,1,2,78,78,2946,594,1249,0.476,30,85,0.353,564,1164,0.485,0.488,316,370,0.854,70,203,273,288,65,20,165,137
331,9,1990,30,1,2,80,80,2934,626,1256,0.498,13,43,0.302,613,1213,0.505,0.504,287,340,0.844,88,192,280,289,77,21,174,128
331,10,1991,31,1,2,80,80,2965,634,1316,0.482,40,114,0.351,594,1202,0.494,0.497,282,326,0.865,63,193,256,301,69,19,159,153
331,11,1992,32,1,2,75,74,2527,535,1161,0.461,65,169,0.385,470,992,0.474,0.489,239,266,0.898,78,161,239,204,50,22,153,134
331,12,1993,33,1,2,60,33,1434,239,539,0.443,31,73,0.425,208,466,0.446,0.472,71,90,0.789,23,79,102,157,22,10,65,129
331,13,1994,34,1,2,55,1,969,161,369,0.436,30,84,0.357,131,285,0.46,0.477,48,53,0.906,23,70,93,76,25,6,44,100
336,1,1991,24,1,2,38,0,214,26,61,0.426,2,16,0.125,24,45,0.533,0.443,10,14,0.714,4,16,20,26,9,2,18,35
336,2,1992,25,1,2,43,0,189,25,55,0.455,6,16,0.375,19,39,0.487,0.509,8,11,0.727,9,13,22,19,14,1,14,26
336,3,1993,26,1,2,61,2,642,65,150,0.433,11,43,0.256,54,107,0.505,0.47,20,32,0.625,18,50,68,72,16,5,31,61
349,1,1982,23,1,2,49,2,546,102,222,0.459,4,18,0.222,98,204,0.48,0.468,18,28,0.643,14,27,41,68,23,2,54,57
352,2,2005,24,1,2,74,42,1791,262,688,0.381,57,173,0.329,205,515,0.398,0.422,133,183,0.727,76,150,226,135,68,8,122,167
352,3,2006,25,1,2,39,9,848,114,288,0.396,33,98,0.337,81,190,0.426,0.453,80,105,0.762,29,77,106,45,39,3,41,78
352,3,2006,25,1,2,72,31,1912,215,544,0.395,65,200,0.325,150,344,0.436,0.455,127,186,0.683,55,200,255,128,71,9,90,167
352,4,2007,26,1,2,59,18,990,99,245,0.404,53,137,0.387,46,108,0.426,0.512,47,63,0.746,16,77,93,59,28,2,46,98
352,5,2008,27,1,2,82,35,2198,241,588,0.41,148,409,0.362,93,179,0.52,0.536,81,110,0.736,42,224,266,104,59,10,53,164
352,6,2009,28,1,2,29,0,485,56,149,0.376,32,92,0.348,24,57,0.421,0.483,31,33,0.939,16,75,91,33,20,2,22,44
352,6,2009,28,1,2,36,15,787,63,175,0.36,42,126,0.333,21,49,0.429,0.48,21,24,0.875,15,96,111,31,23,2,19,61
352,6,2009,28,1,2,65,15,1272,119,324,0.367,74,218,0.339,45,106,0.425,0.481,52,57,0.912,31,171,202,64,43,4,41,105
352,8,2011,30,1,2,82,82,1461,124,307,0.404,90,237,0.38,34,70,0.486,0.55,21,32,0.656,19,129,148,101,38,9,41,113
352,9,2013,32,1,2,74,23,1408,108,284,0.38,84,245,0.343,24,39,0.615,0.528,11,17,0.647,16,104,120,76,28,4,49,108
362,1,1993,23,1,2,74,38,1578,227,565,0.402,7,42,0.167,220,523,0.421,0.408,129,167,0.772,52,144,196,122,75,18,112,223
362,2,1994,24,1,2,56,4,559,63,156,0.404,19,54,0.352,44,102,0.431,0.465,31,40,0.775,20,41,61,31,16,12,17,90
362,3,1995,25,1,2,18,0,239,36,72,0.5,14,37,0.378,22,35,0.629,0.597,11,16,0.688,7,20,27,17,5,4,14,37
362,3,1995,25,1,2,23,0,290,39,84,0.464,15,41,0.366,24,43,0.558,0.554,14,20,0.7,8,24,32,24,6,4,17,47
367,1,1980,33,1,2,6,-1,106,14,40,0.35,0,0,-1,14,40,0.35,0.35,6,7,0.857,4,7,11,7,5,0,13,13
367,1,1980,33,1,2,75,-1,2286,391,875,0.447,19,50,0.38,372,825,0.451,0.458,169,189,0.894,50,166,216,302,92,3,184,219
367,1,1980,33,1,2,81,-1,2392,405,915,0.443,19,50,0.38,386,865,0.446,0.453,175,196,0.893,54,173,227,309,97,3,197,232
367,2,1981,34,1,2,52,-1,1146,160,371,0.431,11,39,0.282,149,332,0.449,0.446,75,94,0.798,17,67,84,161,33,8,111,126
391,1,1997,23,1,2,22,2,154,21,63,0.333,2,16,0.125,19,47,0.404,0.349,11,22,0.5,7,8,15,13,10,4,16,17
394,1,1980,22,1,2,64,-1,1102,221,467,0.473,0,4,0,221,463,0.477,0.473,104,136,0.765,51,82,133,95,59,19,96,132
394,2,1981,23,1,2,44,-1,757,121,313,0.387,0,0,-1,121,313,0.387,0.387,45,55,0.818,24,51,75,37,23,16,69,79
395,1,2007,23,1,2,23,5,199,11,39,0.282,2,13,0.154,9,26,0.346,0.308,2,6,0.333,3,20,23,9,5,2,9,32
400,5,2015,24,1,2,8,8,250,51,110,0.464,11,36,0.306,40,74,0.541,0.514,9,11,0.818,5,21,26,9,7,2,14,24
403,1,1982,22,1,2,51,1,339,55,122,0.451,0,1,0,55,121,0.455,0.451,42,62,0.677,12,26,38,22,14,6,37,61
403,2,1983,23,1,2,51,5,532,69,176,0.392,0,3,0,69,173,0.399,0.392,46,90,0.511,30,48,78,28,32,27,42,84
422,3,2010,23,1,2,82,82,2482,409,949,0.431,82,237,0.346,327,712,0.459,0.474,166,256,0.648,70,209,279,193,117,29,164,224
422,4,2011,24,1,2,13,2,148,25,51,0.49,4,13,0.308,21,38,0.553,0.529,15,21,0.714,12,11,23,12,11,2,10,25
426,1,2007,21,1,2,56,14,675,102,193,0.528,0,9,0,102,184,0.554,0.528,56,83,0.675,37,38,75,24,37,6,24,44
426,2,2008,22,1,2,76,76,2088,354,634,0.558,11,50,0.22,343,584,0.587,0.567,195,257,0.759,97,121,218,134,129,19,69,110
426,4,2010,24,1,2,53,53,1662,206,416,0.495,8,31,0.258,198,385,0.514,0.505,81,128,0.633,44,136,180,151,85,15,51,80
426,4,2010,24,1,2,58,53,1742,209,429,0.487,8,31,0.258,201,398,0.505,0.497,85,133,0.639,45,142,187,154,91,15,53,80
426,5,2011,25,1,2,81,1,1781,205,427,0.48,6,27,0.222,199,400,0.498,0.487,87,133,0.654,55,207,262,140,106,22,55,82
426,6,2012,26,1,2,66,43,1635,190,445,0.427,19,69,0.275,171,376,0.455,0.448,56,100,0.56,72,159,231,137,72,21,59,64
427,1,1980,24,1,2,82,-1,2815,548,1182,0.464,6,32,0.188,542,1150,0.471,0.466,184,219,0.84,54,160,214,216,98,48,167,154
427,2,1981,25,1,2,29,-1,548,95,246,0.386,1,3,0.333,94,243,0.387,0.388,26,34,0.765,13,20,33,55,34,9,38,42
427,2,1981,25,1,2,46,-1,904,180,385,0.468,0,4,0,180,381,0.472,0.468,65,80,0.813,21,32,53,93,27,25,54,53
427,2,1981,25,1,2,75,-1,1452,275,631,0.436,1,7,0.143,274,624,0.439,0.437,91,114,0.798,34,52,86,148,61,34,92,95
427,3,1982,26,1,2,25,4,595,182,361,0.504,3,10,0.3,179,351,0.51,0.508,77,88,0.875,13,37,50,67,23,7,34,37
427,3,1982,26,1,2,47,41,1724,387,833,0.465,5,21,0.238,382,812,0.47,0.468,134,172,0.779,42,69,111,121,59,23,91,114
427,3,1982,26,1,2,72,45,2319,569,1194,0.477,8,31,0.258,561,1163,0.482,0.48,211,260,0.812,55,106,161,188,82,30,125,151
427,4,1983,27,1,2,21,18,563,98,245,0.4,0,3,0,98,242,0.405,0.4,44,51,0.863,9,28,37,27,20,6,25,27
427,4,1983,27,1,2,53,34,1401,246,562,0.438,7,15,0.467,239,547,0.437,0.444,98,119,0.824,50,57,107,69,70,19,72,96
427,4,1983,27,1,2,74,52,1964,344,807,0.426,7,18,0.389,337,789,0.427,0.431,142,170,0.835,59,85,144,96,90,25,97,123
427,5,1984,28,1,2,13,3,210,27,58,0.466,0,1,0,27,57,0.474,0.466,11,17,0.647,5,8,13,6,6,5,7,10
427,5,1984,28,1,2,40,5,782,152,345,0.441,3,13,0.231,149,332,0.449,0.445,41,50,0.82,17,33,50,44,18,16,33,54
427,5,1984,28,1,2,53,8,992,179,403,0.444,3,14,0.214,176,389,0.452,0.448,52,67,0.776,22,41,63,50,24,21,40,64
427,6,1985,29,1,2,11,0,245,49,84,0.583,0,2,0,49,82,0.598,0.583,16,18,0.889,8,10,18,11,5,5,5,15
427,6,1985,29,1,2,20,0,326,62,118,0.525,0,2,0,62,116,0.534,0.525,23,25,0.92,9,12,21,17,6,6,9,23
427,7,1986,30,1,2,40,3,552,83,215,0.386,5,17,0.294,78,198,0.394,0.398,33,37,0.892,14,39,53,40,17,6,21,43
427,7,1986,30,1,2,44,3,570,86,224,0.384,5,17,0.294,81,207,0.391,0.395,34,38,0.895,14,39,53,40,17,6,23,44
441,1,1982,23,1,2,63,19,1027,165,364,0.453,9,32,0.281,156,332,0.47,0.466,61,84,0.726,61,59,120,156,49,13,83,123
441,2,1983,24,1,2,58,0,466,91,213,0.427,3,13,0.231,88,200,0.44,0.434,34,43,0.791,33,29,62,66,26,9,43,79
444,1,2012,23,1,2,56,47,1648,274,640,0.428,47,150,0.313,227,490,0.463,0.465,113,148,0.764,70,130,200,131,52,15,118,116
444,2,2013,24,1,2,73,2,912,155,335,0.463,15,55,0.273,140,280,0.5,0.485,69,94,0.734,32,72,104,76,34,16,69,93
444,3,2014,25,1,2,18,0,228,43,88,0.489,11,19,0.579,32,69,0.464,0.551,18,26,0.692,8,22,30,21,12,3,17,16
444,3,2014,25,1,2,35,0,316,57,125,0.456,13,25,0.52,44,100,0.44,0.508,32,44,0.727,10,44,54,25,14,4,24,21
448,1,2009,24,1,2,47,1,675,94,247,0.381,31,94,0.33,63,153,0.412,0.443,26,34,0.765,8,28,36,87,15,1,47,74
448,1,2009,24,1,2,68,2,931,141,360,0.392,45,130,0.346,96,230,0.417,0.454,34,43,0.791,14,38,52,117,21,3,63,95
452,4,1994,25,1,2,77,76,2867,490,1021,0.48,30,96,0.313,460,925,0.497,0.495,182,219,0.831,63,237,300,347,156,47,126,207
452,5,1995,26,1,2,79,69,2792,437,977,0.447,126,327,0.385,311,650,0.478,0.512,236,277,0.852,63,186,249,301,110,49,146,181
452,8,1998,29,1,2,41,10,811,109,255,0.427,43,113,0.381,66,142,0.465,0.512,19,28,0.679,10,52,62,53,44,6,32,76
452,8,1998,29,1,2,31,2,908,137,307,0.446,65,158,0.411,72,149,0.483,0.552,39,43,0.907,14,76,90,101,38,17,41,47
452,8,1998,29,1,2,72,12,1719,246,562,0.438,108,271,0.399,138,291,0.474,0.534,58,71,0.817,24,128,152,154,82,23,73,123
454,1,2004,25,1,2,58,0,627,85,196,0.434,4,14,0.286,81,182,0.445,0.444,60,74,0.811,38,92,130,33,15,4,38,61
454,2,2005,26,1,2,67,0,1238,173,409,0.423,45,121,0.372,128,288,0.444,0.478,103,130,0.792,37,139,176,92,39,12,53,83
454,3,2006,27,1,2,81,14,1711,207,527,0.393,39,118,0.331,168,409,0.411,0.43,158,212,0.745,73,134,207,104,44,14,99,153
454,4,2007,28,1,2,58,49,1662,233,555,0.42,81,227,0.357,152,328,0.463,0.493,123,155,0.794,55,196,251,149,44,9,91,139
454,5,2008,29,1,2,78,20,1762,217,531,0.409,45,146,0.308,172,385,0.447,0.451,107,142,0.754,65,198,263,175,52,7,99,144
454,6,2009,30,1,2,63,5,869,111,313,0.355,28,97,0.289,83,216,0.384,0.399,78,100,0.78,31,88,119,54,32,5,54,81
454,7,2010,31,1,2,39,37,967,128,325,0.394,54,147,0.367,74,178,0.416,0.477,69,86,0.802,27,82,109,58,30,5,57,62
454,7,2010,31,1,2,50,37,1060,136,361,0.377,58,164,0.354,78,197,0.396,0.457,69,86,0.802,29,95,124,65,33,6,62,72
458,1,1980,31,1,2,80,-1,1701,404,843,0.479,39,88,0.443,365,755,0.483,0.502,113,135,0.837,35,120,155,174,65,17,105,117
458,2,1981,32,1,2,78,-1,1986,505,1035,0.488,23,64,0.359,482,971,0.496,0.499,173,208,0.832,53,122,175,233,88,13,131,141
458,3,1982,33,1,2,82,2,1785,393,863,0.455,25,77,0.325,368,786,0.468,0.47,111,129,0.86,42,98,140,238,69,4,96,111
458,5,1984,35,1,2,71,1,1129,258,506,0.51,9,34,0.265,249,472,0.528,0.519,77,86,0.895,14,48,62,194,49,2,70,84
464,1,1999,23,1,2,33,0,236,33,89,0.371,3,10,0.3,30,79,0.38,0.388,11,14,0.786,5,17,22,31,5,1,22,21
466,1,2014,23,1,2,26,0,224,26,86,0.302,3,30,0.1,23,56,0.411,0.32,9,13,0.692,8,20,28,41,13,3,16,19
474,1,2007,21,1,2,23,5,202,28,74,0.378,7,25,0.28,21,49,0.429,0.426,10,14,0.714,6,15,21,10,7,3,14,24
474,2,2008,22,1,2,15,4,218,41,111,0.369,9,29,0.31,32,82,0.39,0.41,14,23,0.609,5,13,18,17,10,1,19,27
474,2,2008,22,1,2,21,4,240,44,126,0.349,9,30,0.3,35,96,0.365,0.385,17,29,0.586,6,14,20,17,11,3,24,29
474,3,2009,23,1,2,18,0,136,22,42,0.524,6,9,0.667,16,33,0.485,0.595,8,9,0.889,3,17,20,10,4,2,9,9
474,3,2009,23,1,2,30,0,341,56,123,0.455,8,28,0.286,48,95,0.505,0.488,24,30,0.8,8,16,24,28,18,5,29,33
474,3,2009,23,1,2,48,0,477,78,165,0.473,14,37,0.378,64,128,0.5,0.515,32,39,0.821,11,33,44,38,22,7,38,42
474,4,2010,24,1,2,82,7,1700,253,592,0.427,62,189,0.328,191,403,0.474,0.48,99,121,0.818,30,153,183,108,57,31,67,129
474,5,2011,25,1,2,82,0,1568,273,643,0.425,74,212,0.349,199,431,0.462,0.482,92,101,0.911,35,122,157,96,67,16,75,124
474,6,2012,26,1,2,59,19,1400,251,598,0.42,68,188,0.362,183,410,0.446,0.477,80,99,0.808,38,119,157,69,44,15,64,66
474,7,2013,27,1,2,59,22,1402,240,571,0.42,39,141,0.277,201,430,0.467,0.454,98,125,0.784,44,105,149,108,59,15,74,92
474,8,2014,28,1,2,10,1,103,8,28,0.286,0,2,0,8,26,0.308,0.286,7,9,0.778,1,12,13,5,1,0,8,12
474,8,2014,28,1,2,19,0,148,16,38,0.421,0,0,-1,16,38,0.421,0.421,8,12,0.667,6,9,15,4,12,0,10,12
474,8,2014,28,1,2,29,1,251,24,66,0.364,0,2,0,24,64,0.375,0.364,15,21,0.714,7,21,28,9,13,0,18,24
475,1,2002,22,1,2,40,1,403,49,115,0.426,4,12,0.333,45,103,0.437,0.443,21,28,0.75,12,30,42,70,19,3,40,26
484,1,1997,18,1,2,71,6,1103,176,422,0.417,51,136,0.375,125,286,0.437,0.477,136,166,0.819,47,85,132,91,49,23,112,102
484,2,1998,19,1,2,79,1,2056,391,913,0.428,75,220,0.341,316,693,0.456,0.469,363,457,0.794,79,163,242,199,74,40,157,180
484,3,1999,20,1,2,50,50,1896,362,779,0.465,27,101,0.267,335,678,0.494,0.482,245,292,0.839,53,211,264,190,72,50,157,153
484,4,2000,21,1,2,66,62,2524,554,1183,0.468,46,144,0.319,508,1039,0.489,0.488,331,403,0.821,108,308,416,323,106,62,182,220
484,5,2001,22,1,2,68,68,2783,701,1510,0.464,61,200,0.305,640,1310,0.489,0.484,475,557,0.853,104,295,399,338,114,43,220,222
484,6,2002,23,1,2,80,80,3063,749,1597,0.469,33,132,0.25,716,1465,0.489,0.479,488,589,0.829,112,329,441,438,118,35,223,228
484,7,2003,24,1,2,82,82,3401,868,1924,0.451,124,324,0.383,744,1600,0.465,0.483,601,713,0.843,106,458,564,481,181,67,288,218
484,8,2004,25,1,2,65,64,2447,516,1178,0.438,71,217,0.327,445,961,0.463,0.468,454,533,0.852,103,256,359,330,112,28,171,176
484,9,2005,26,1,2,66,66,2689,573,1324,0.433,131,387,0.339,442,937,0.472,0.482,542,664,0.816,95,297,392,398,86,53,270,174
484,10,2006,27,1,2,80,80,3277,978,2173,0.45,180,518,0.347,798,1655,0.482,0.491,696,819,0.85,71,354,425,360,147,30,250,233
484,11,2007,28,1,2,77,77,3140,813,1757,0.463,137,398,0.344,676,1359,0.497,0.502,667,768,0.868,75,364,439,413,111,36,255,205
484,12,2008,29,1,2,82,82,3192,775,1690,0.459,150,415,0.361,625,1275,0.49,0.503,623,742,0.84,94,423,517,441,151,40,257,227
484,13,2009,30,1,2,82,82,2960,800,1712,0.467,118,336,0.351,682,1376,0.496,0.502,483,564,0.856,90,339,429,399,120,37,210,189
484,14,2010,31,1,2,73,73,2835,716,1569,0.456,99,301,0.329,617,1268,0.487,0.488,439,541,0.811,78,313,391,365,113,20,233,187
484,15,2011,32,1,2,82,82,2779,740,1639,0.451,115,356,0.323,625,1283,0.487,0.487,483,583,0.828,83,336,419,388,99,12,243,172
484,16,2012,33,1,2,58,58,2232,574,1336,0.43,87,287,0.303,487,1049,0.464,0.462,381,451,0.845,66,247,313,264,69,18,204,105
484,17,2013,34,1,2,78,78,3013,738,1595,0.463,132,407,0.324,606,1188,0.51,0.504,525,626,0.839,66,367,433,469,106,25,287,173
484,18,2014,35,1,2,6,6,177,31,73,0.425,3,16,0.188,28,57,0.491,0.445,18,21,0.857,2,24,26,38,7,1,34,9
484,19,2015,36,1,2,9,9,317,77,210,0.367,16,54,0.296,61,156,0.391,0.405,59,74,0.797,6,41,47,35,15,3,28,21
491,1,2000,23,1,2,48,1,923,111,233,0.476,10,26,0.385,101,207,0.488,0.498,43,63,0.683,56,118,174,55,38,20,36,148
491,2,2001,24,1,2,37,9,820,84,192,0.438,2,7,0.286,82,185,0.443,0.443,59,81,0.728,60,97,157,49,33,9,27,118
491,3,2002,25,1,2,44,16,885,104,198,0.525,5,16,0.313,99,182,0.544,0.538,40,58,0.69,67,106,173,48,31,19,27,124
491,4,2003,26,1,2,75,5,1514,185,398,0.465,15,55,0.273,170,343,0.496,0.484,65,81,0.802,72,144,216,96,72,16,62,203
491,5,2004,27,1,2,53,3,703,66,175,0.377,12,44,0.273,54,131,0.412,0.411,20,27,0.741,28,75,103,45,21,4,34,77
491,6,2005,28,1,2,70,41,1522,160,303,0.528,49,121,0.405,111,182,0.61,0.609,63,81,0.778,66,142,208,133,75,6,49,169
491,7,2006,29,1,2,73,27,1758,181,417,0.434,86,243,0.354,95,174,0.546,0.537,43,55,0.782,31,178,209,127,87,20,52,180
491,8,2007,30,1,2,76,11,1372,123,299,0.411,32,103,0.311,91,196,0.464,0.465,27,34,0.794,35,123,158,70,47,7,40,152
491,9,2008,31,1,2,31,4,520,45,117,0.385,15,50,0.3,30,67,0.448,0.449,19,22,0.864,10,55,65,39,21,2,29,63
492,4,1983,28,1,2,72,56,1565,248,561,0.442,0,4,0,248,557,0.445,0.442,74,117,0.632,62,125,187,275,108,5,159,195
504,1,2012,20,1,2,59,0,939,153,357,0.429,15,45,0.333,138,312,0.442,0.45,104,143,0.727,57,75,132,55,27,5,51,84
504,2,2013,21,1,2,64,0,1137,163,388,0.42,33,92,0.359,130,296,0.439,0.463,92,129,0.713,37,108,145,92,35,13,74,114
504,3,2014,22,1,2,78,12,2193,380,831,0.457,50,143,0.35,330,688,0.48,0.487,279,373,0.748,59,198,257,212,69,14,149,190
504,4,2015,23,1,2,11,11,377,51,123,0.415,10,27,0.37,41,96,0.427,0.455,36,43,0.837,7,36,43,33,6,1,25,26
519,2,1981,30,1,2,58,-1,1095,114,287,0.397,19,58,0.328,95,229,0.415,0.43,50,65,0.769,19,65,84,140,74,8,38,61
522,1,2012,22,1,2,42,0,359,32,79,0.405,2,11,0.182,30,68,0.441,0.418,43,56,0.768,23,33,56,14,11,5,14,20
522,3,2014,24,1,2,67,67,2591,275,693,0.397,68,240,0.283,207,453,0.457,0.446,260,338,0.769,87,243,330,175,127,36,102,106
522,4,2015,25,1,2,8,8,318,56,105,0.533,9,23,0.391,47,82,0.573,0.576,49,62,0.79,13,37,50,27,11,6,12,17
523,7,2009,28,1,2,67,67,2585,491,1085,0.453,65,210,0.31,426,875,0.487,0.482,345,402,0.858,118,296,414,290,106,20,210,165
523,8,2010,29,1,2,27,27,930,157,357,0.44,17,50,0.34,140,307,0.456,0.464,79,104,0.76,36,109,145,49,48,9,47,67
536,1,2014,24,1,2,71,7,1173,142,311,0.457,19,61,0.311,123,250,0.492,0.487,44,72,0.611,23,114,137,207,66,8,101,117
537,1,2006,24,1,2,64,11,1487,132,312,0.423,7,43,0.163,125,269,0.465,0.434,78,92,0.848,30,111,141,288,42,4,101,93
537,9,2014,32,1,2,81,81,2468,341,748,0.456,191,425,0.449,150,323,0.464,0.584,52,63,0.825,29,163,192,377,69,11,103,136
540,1,2014,20,1,2,80,41,1583,182,460,0.396,59,185,0.319,123,275,0.447,0.46,47,61,0.77,38,118,156,55,75,12,28,145
540,2,2015,21,1,2,10,10,347,44,124,0.355,18,56,0.321,26,68,0.382,0.427,11,20,0.55,9,27,36,9,3,2,9,20
545,1,1991,24,1,2,64,0,678,75,192,0.391,0,2,0,75,190,0.395,0.391,55,79,0.696,25,53,78,61,22,7,51,98
549,6,1990,27,1,2,82,81,3164,723,1581,0.457,9,54,0.167,714,1527,0.468,0.46,448,569,0.787,209,242,451,213,111,31,251,260
549,7,1991,28,1,2,77,71,2893,652,1502,0.434,16,61,0.262,636,1441,0.441,0.439,358,446,0.803,161,185,346,214,121,48,190,204
562,3,2009,24,1,2,67,6,1199,176,423,0.416,79,226,0.35,97,197,0.492,0.509,50,66,0.758,36,90,126,26,45,29,43,94
562,4,2010,25,1,2,68,0,857,113,282,0.401,41,135,0.304,72,147,0.49,0.473,52,63,0.825,26,111,137,37,25,20,21,79
563,1,1980,31,1,2,77,-1,1595,390,839,0.465,2,6,0.333,388,833,0.466,0.466,127,172,0.738,81,84,165,150,39,3,108,120
563,2,1981,32,1,2,39,-1,580,80,206,0.388,0,7,0,80,199,0.402,0.388,32,50,0.64,18,34,52,49,14,2,32,43
563,2,1981,32,1,2,47,-1,657,87,234,0.372,0,7,0,87,227,0.383,0.372,34,54,0.63,22,39,61,58,15,2,41,53
564,1,1999,23,1,2,42,7,624,71,216,0.329,5,30,0.167,66,186,0.355,0.34,24,32,0.75,8,41,49,66,21,7,46,66
567,1,1996,21,1,2,60,10,590,90,217,0.415,11,42,0.262,79,175,0.451,0.44,49,60,0.817,27,75,102,43,10,5,40,77
567,2,1997,22,1,2,55,10,830,125,271,0.461,31,88,0.352,94,183,0.514,0.518,56,73,0.767,31,82,113,48,24,10,37,93
567,3,1998,23,1,2,51,40,1165,190,452,0.42,40,127,0.315,150,325,0.462,0.465,84,99,0.848,43,112,155,85,17,11,69,129
567,4,1999,24,1,2,28,2,364,67,179,0.374,25,66,0.379,42,113,0.372,0.444,25,36,0.694,23,36,59,16,7,1,24,36
567,4,1999,24,1,2,39,4,445,76,205,0.371,28,75,0.373,48,130,0.369,0.439,27,40,0.675,23,48,71,23,8,2,28,45
567,6,2001,26,1,2,35,0,309,53,112,0.473,17,37,0.459,36,75,0.48,0.549,46,60,0.767,11,33,44,11,4,3,19,45
571,1,2005,24,1,2,25,0,430,70,180,0.389,13,39,0.333,57,141,0.404,0.425,71,83,0.855,13,47,60,17,17,2,25,37
571,2,2006,25,1,2,78,6,1275,192,476,0.403,72,185,0.389,120,291,0.412,0.479,138,168,0.821,34,123,157,35,47,11,48,120
571,3,2007,26,1,2,72,47,1878,285,658,0.433,111,267,0.416,174,391,0.445,0.517,188,208,0.904,35,172,207,91,53,9,73,176
571,4,2008,27,1,2,80,18,2016,252,589,0.428,105,241,0.436,147,348,0.422,0.517,111,138,0.804,33,193,226,73,46,19,58,187
571,5,2009,28,1,2,21,0,141,9,33,0.273,1,8,0.125,8,25,0.32,0.288,6,6,1,2,12,14,3,3,1,7,14
571,5,2009,28,1,2,34,10,475,56,138,0.406,12,45,0.267,44,93,0.473,0.449,15,19,0.789,5,50,55,24,18,5,26,53
571,5,2009,28,1,2,55,10,616,65,171,0.38,13,53,0.245,52,118,0.441,0.418,21,25,0.84,7,62,69,27,21,6,33,67
571,6,2010,29,1,2,25,0,121,18,50,0.36,4,19,0.211,14,31,0.452,0.4,6,6,1,4,8,12,6,5,0,7,13
571,7,2011,30,1,2,54,1,582,89,199,0.447,17,46,0.37,72,153,0.471,0.49,40,52,0.769,12,56,68,23,17,6,23,43
571,8,2012,31,1,2,53,2,596,52,157,0.331,8,43,0.186,44,114,0.386,0.357,30,38,0.789,8,50,58,38,16,7,24,52
574,2,1982,23,1,2,75,0,1035,188,402,0.468,8,25,0.32,180,377,0.477,0.478,58,70,0.829,30,49,79,60,34,11,54,110
574,3,1983,24,1,2,81,28,1716,354,706,0.501,17,51,0.333,337,655,0.515,0.513,124,154,0.805,62,88,150,194,78,13,118,207
574,4,1984,25,1,2,73,54,2045,413,862,0.479,15,46,0.326,398,816,0.488,0.488,136,178,0.764,70,83,153,206,128,13,141,211
574,5,1985,26,1,2,69,11,1279,214,476,0.45,11,43,0.256,203,433,0.469,0.461,109,134,0.813,36,59,95,167,57,5,109,151
576,1,1984,22,1,2,55,5,688,145,316,0.459,5,19,0.263,140,297,0.471,0.467,47,61,0.77,38,48,86,71,19,4,42,81
578,1,2004,27,1,2,10,0,110,11,35,0.314,4,11,0.364,7,24,0.292,0.371,16,20,0.8,2,9,11,4,0,0,9,10
581,1,1981,23,1,2,60,-1,536,59,179,0.33,0,3,0,59,176,0.335,0.33,51,69,0.739,30,39,69,76,22,2,38,68
581,2,1982,24,1,2,75,1,923,119,280,0.425,0,0,-1,119,280,0.425,0.425,64,80,0.8,35,60,95,130,36,6,78,124
582,1,1980,23,1,2,13,-1,117,15,37,0.405,0,0,-1,15,37,0.405,0.405,2,7,0.286,5,14,19,9,2,3,10,19
585,4,2002,25,1,2,60,60,2385,559,1307,0.428,121,313,0.387,438,994,0.441,0.474,245,307,0.798,138,175,313,239,94,43,154,191
585,5,2003,26,1,2,43,42,1471,355,760,0.467,45,131,0.344,310,629,0.493,0.497,129,160,0.806,59,129,188,143,48,41,74,121
585,6,2004,27,1,2,73,73,2785,608,1457,0.417,93,243,0.383,515,1214,0.424,0.449,336,417,0.806,95,254,349,348,88,65,223,212
585,7,2005,28,1,2,20,20,608,124,302,0.411,19,59,0.322,105,243,0.432,0.442,50,72,0.694,28,38,66,61,25,15,22,56
585,8,2006,29,1,2,79,79,2906,653,1518,0.43,125,367,0.341,528,1151,0.459,0.471,480,601,0.799,135,327,462,338,94,53,213,235
585,9,2007,30,1,2,82,82,3126,726,1598,0.454,156,437,0.357,570,1161,0.491,0.503,462,576,0.802,114,378,492,393,82,30,217,266
585,10,2008,31,1,2,76,72,2959,587,1287,0.456,98,273,0.359,489,1014,0.482,0.494,350,429,0.816,112,341,453,389,93,33,181,241
585,11,2009,32,1,2,80,80,2946,588,1345,0.437,151,392,0.385,437,953,0.459,0.493,335,410,0.817,74,336,410,376,82,38,166,234
585,12,2010,33,1,2,75,74,2310,434,1015,0.428,119,324,0.367,315,691,0.456,0.486,257,306,0.84,33,260,293,236,53,18,106,189
585,13,2011,34,1,2,22,22,664,125,266,0.47,27,78,0.346,98,188,0.521,0.521,56,75,0.747,11,79,90,64,20,3,36,70
585,13,2011,34,1,2,51,41,1387,264,625,0.422,89,243,0.366,175,382,0.458,0.494,72,98,0.735,43,142,185,82,47,17,54,123
585,13,2011,34,1,2,73,63,2051,389,891,0.437,116,321,0.361,273,570,0.479,0.502,128,173,0.74,54,221,275,146,67,20,90,193
585,14,2012,35,1,2,61,40,1542,223,542,0.411,74,205,0.361,149,337,0.442,0.48,95,115,0.826,32,173,205,139,56,25,84,134
585,16,2014,37,1,2,81,0,1973,330,811,0.407,146,371,0.394,184,440,0.418,0.497,161,196,0.821,67,217,284,212,61,35,108,209
585,17,2015,38,1,2,9,0,144,21,58,0.362,10,32,0.313,11,26,0.423,0.448,4,6,0.667,4,17,21,11,5,1,11,16
601,1,1980,33,1,2,60,0,523,67,189,0.354,1,6,0.167,66,183,0.361,0.357,32,42,0.762,31,42,73,38,31,11,33,80
603,1,1989,21,1,2,75,44,2219,526,1271,0.414,60,191,0.314,466,1080,0.431,0.437,155,195,0.795,74,113,187,176,70,25,113,167
603,2,1990,22,1,2,54,52,1762,377,924,0.408,47,142,0.331,330,782,0.422,0.433,144,192,0.75,52,127,179,132,46,6,100,113
603,5,1993,25,1,2,60,23,1300,287,602,0.477,43,116,0.371,244,486,0.502,0.512,132,163,0.81,19,69,88,116,38,10,79,119
603,6,1994,26,1,2,60,59,2025,431,865,0.498,64,165,0.388,367,700,0.524,0.535,168,206,0.816,57,89,146,185,59,8,117,83
603,7,1995,27,1,2,45,29,1468,254,639,0.397,86,274,0.314,168,365,0.46,0.465,137,159,0.862,23,90,113,128,67,15,62,85
603,8,1996,28,1,2,56,50,1865,289,679,0.426,125,337,0.371,164,342,0.48,0.518,83,113,0.735,22,123,145,166,45,10,79,117
603,9,1997,29,1,2,65,33,1833,332,749,0.443,110,314,0.35,222,435,0.51,0.517,124,149,0.832,25,156,181,182,52,7,96,108
603,10,1998,30,1,2,68,67,2263,408,956,0.427,120,311,0.386,288,645,0.447,0.49,146,187,0.781,30,143,173,203,71,14,116,102
603,11,1999,31,1,2,38,35,1183,165,459,0.359,53,151,0.351,112,308,0.364,0.417,76,91,0.835,12,92,104,109,34,9,54,46
603,12,2000,32,1,2,53,19,957,124,320,0.388,41,123,0.333,83,197,0.421,0.452,59,78,0.756,10,70,80,62,22,1,38,70
607,3,2010,22,1,2,65,64,2320,412,860,0.479,40,150,0.267,372,710,0.524,0.502,129,160,0.806,93,255,348,138,46,49,108,184
610,1,1994,22,1,2,65,21,1604,327,696,0.47,1,23,0.043,326,673,0.484,0.471,124,161,0.77,88,102,190,126,63,10,108,148
610,2,1995,23,1,2,78,71,2651,512,1129,0.453,96,283,0.339,416,846,0.492,0.496,173,213,0.812,105,216,321,177,80,21,151,215
610,4,1997,25,1,2,79,79,2411,369,730,0.505,4,30,0.133,365,700,0.521,0.508,95,137,0.693,70,198,268,114,77,18,94,226
610,5,1998,26,1,2,82,82,2841,448,981,0.457,15,53,0.283,433,928,0.467,0.464,139,215,0.647,82,242,324,173,96,36,104,264
610,6,1999,27,1,2,50,18,1266,172,415,0.414,8,37,0.216,164,378,0.434,0.424,33,67,0.493,33,108,141,73,39,16,42,146
610,7,2000,28,1,2,67,19,1309,120,273,0.44,18,54,0.333,102,219,0.466,0.473,9,21,0.429,23,115,138,80,44,14,46,158
610,8,2001,29,1,2,9,5,153,10,30,0.333,0,0,-1,10,30,0.333,0.333,1,2,0.5,5,15,20,9,4,2,5,14
610,9,2002,30,1,2,68,47,1631,224,466,0.481,0,4,0,224,462,0.485,0.481,46,67,0.687,57,183,240,110,34,21,70,156
610,10,2003,31,1,2,81,74,2351,325,651,0.499,10,25,0.4,315,626,0.503,0.507,40,69,0.58,73,211,284,163,65,13,108,225
610,12,2005,33,1,2,55,5,951,113,265,0.426,0,3,0,113,262,0.431,0.426,24,37,0.649,32,92,124,64,17,15,35,95
616,1,1980,29,1,2,23,-1,380,52,135,0.385,2,6,0.333,50,129,0.388,0.393,18,26,0.692,9,26,35,47,15,10,26,29
616,1,1980,29,1,2,20,-1,470,84,214,0.393,3,6,0.5,81,208,0.389,0.4,31,41,0.756,10,33,43,42,18,5,29,26
616,1,1980,29,1,2,43,-1,850,136,349,0.39,5,12,0.417,131,337,0.389,0.397,49,67,0.731,19,59,78,89,33,15,55,55
626,1,1993,22,1,2,23,0,332,45,106,0.425,2,12,0.167,43,94,0.457,0.434,50,66,0.758,24,27,51,53,22,5,50,53
626,2,1994,23,1,2,65,34,1515,244,562,0.434,39,119,0.328,205,443,0.463,0.469,145,208,0.697,93,142,235,136,89,28,140,186
626,4,1997,26,1,2,81,81,3127,396,949,0.417,147,383,0.384,249,566,0.44,0.495,237,306,0.775,85,347,432,315,201,45,200,245
626,5,1998,27,1,2,78,78,2939,458,1071,0.428,100,307,0.326,358,764,0.469,0.474,271,327,0.829,94,310,404,282,190,57,228,198
626,6,1999,28,1,2,50,50,1768,252,650,0.388,49,161,0.304,203,489,0.415,0.425,207,246,0.841,59,148,207,187,113,26,119,111
626,7,2000,29,1,2,73,73,2264,311,764,0.407,99,275,0.36,212,489,0.434,0.472,182,216,0.843,63,222,285,321,102,43,144,167
626,8,2001,30,1,2,81,81,2939,311,788,0.395,94,250,0.376,217,538,0.403,0.454,280,312,0.897,95,260,355,289,183,45,154,224
626,9,2002,31,1,2,81,81,2798,338,735,0.46,90,256,0.352,248,479,0.518,0.521,206,242,0.851,74,300,374,340,160,25,164,209
626,10,2003,32,1,2,80,80,2710,267,557,0.479,73,185,0.395,194,372,0.522,0.545,141,174,0.81,61,281,342,376,180,37,144,186
626,11,2004,33,1,2,82,82,2780,317,688,0.461,49,142,0.345,268,546,0.491,0.496,148,172,0.86,69,260,329,347,151,41,155,186
626,12,2005,34,1,2,21,13,529,47,128,0.367,5,23,0.217,42,105,0.4,0.387,20,22,0.909,9,45,54,46,37,5,36,45
626,12,2005,34,1,2,31,31,996,83,204,0.407,10,39,0.256,73,165,0.442,0.431,50,56,0.893,29,94,123,153,43,13,68,61
626,12,2005,34,1,2,52,44,1525,130,332,0.392,15,62,0.242,115,270,0.426,0.414,70,78,0.897,38,139,177,199,80,18,104,106
626,13,2006,35,1,2,7,7,185,9,26,0.346,0,1,0,9,25,0.36,0.346,8,12,0.667,2,11,13,14,9,1,6,10
627,1,1984,23,1,2,31,0,127,19,52,0.365,0,2,0,19,50,0.38,0.365,16,18,0.889,7,10,17,17,8,1,12,13
627,2,1985,24,1,2,62,3,562,64,152,0.421,0,5,0,64,147,0.435,0.421,41,53,0.774,29,40,69,48,35,2,42,66
629,1,2014,22,1,2,23,0,172,26,67,0.388,11,31,0.355,15,36,0.417,0.47,5,7,0.714,3,16,19,15,8,2,14,24
652,1,1981,26,1,2,29,-1,395,35,99,0.354,0,2,0,35,97,0.361,0.354,24,36,0.667,19,22,41,25,11,1,32,35
654,1,1980,28,1,2,36,-1,963,191,410,0.466,0,1,0,191,409,0.467,0.466,113,124,0.911,29,65,94,100,30,7,82,76
654,2,1981,29,1,2,12,-1,329,62,126,0.492,0,0,-1,62,126,0.492,0.492,24,29,0.828,6,23,29,42,7,4,22,23
655,1,1998,24,1,2,23,0,103,21,55,0.382,9,20,0.45,12,35,0.343,0.464,8,14,0.571,7,7,14,3,6,3,8,12
660,2,2008,23,1,2,46,8,634,57,175,0.326,8,32,0.25,49,143,0.343,0.349,23,38,0.605,19,56,75,89,24,8,56,56
660,4,2010,25,1,2,43,0,470,47,128,0.367,4,17,0.235,43,111,0.387,0.383,13,21,0.619,13,37,50,44,23,1,32,45
679,1,2008,20,1,2,59,19,1441,196,514,0.381,79,238,0.332,117,276,0.424,0.458,47,57,0.825,20,157,177,75,23,9,63,157
679,3,2010,22,1,2,45,3,691,81,253,0.32,40,126,0.317,41,127,0.323,0.399,21,25,0.84,9,73,82,43,14,10,24,50
679,4,2011,23,1,2,43,0,598,79,181,0.436,65,154,0.422,14,27,0.519,0.616,16,20,0.8,8,64,72,20,14,1,17,51
679,5,2012,24,1,2,57,22,989,109,296,0.368,79,228,0.346,30,68,0.441,0.502,14,22,0.636,12,110,122,15,22,11,16,69
679,6,2013,25,1,2,16,1,165,21,59,0.356,11,30,0.367,10,29,0.345,0.449,2,3,0.667,5,13,18,10,6,2,6,13
679,6,2013,25,1,2,33,0,276,30,108,0.278,15,61,0.246,15,47,0.319,0.347,7,9,0.778,2,41,43,9,2,5,9,13
679,6,2013,25,1,2,49,1,441,51,167,0.305,26,91,0.286,25,76,0.329,0.383,9,12,0.75,7,54,61,19,8,7,15,26
687,1,1980,23,1,2,82,-1,1973,303,578,0.524,5,20,0.25,298,558,0.534,0.529,111,143,0.776,101,128,229,221,86,38,142,215
687,2,1981,24,1,2,81,-1,2625,321,654,0.491,4,19,0.211,317,635,0.499,0.494,117,149,0.785,121,215,336,332,133,78,164,249
687,3,1982,25,1,2,76,14,2197,383,741,0.517,2,17,0.118,381,724,0.526,0.518,139,171,0.813,84,185,269,230,120,61,151,216
687,4,1983,26,1,2,82,3,2148,266,497,0.535,5,21,0.238,261,476,0.548,0.54,102,130,0.785,82,192,274,315,115,50,128,208
687,5,1984,27,1,2,82,9,2387,273,549,0.497,38,121,0.314,235,428,0.549,0.532,155,185,0.838,53,209,262,482,113,67,148,267
687,6,1985,28,1,2,82,20,2189,276,593,0.465,35,123,0.285,241,470,0.513,0.495,115,133,0.865,56,199,255,429,93,49,156,208
687,7,1986,29,1,2,82,15,2269,274,606,0.452,63,163,0.387,211,443,0.476,0.504,147,170,0.865,44,200,244,466,89,43,151,238
687,8,1987,30,1,2,82,2,2253,322,736,0.438,89,231,0.385,233,505,0.461,0.498,126,148,0.851,58,196,254,373,78,43,102,199
687,9,1988,31,1,2,61,8,1793,189,482,0.392,57,178,0.32,132,304,0.434,0.451,97,113,0.858,50,178,228,289,66,26,101,136
687,10,1989,32,1,2,80,13,1943,213,494,0.431,80,210,0.381,133,284,0.468,0.512,81,93,0.871,33,158,191,314,72,32,94,186
687,11,1990,33,1,2,80,10,1851,191,493,0.387,50,157,0.318,141,336,0.42,0.438,83,94,0.883,59,168,227,215,67,36,91,206
704,4,2004,23,1,2,80,73,2811,509,1318,0.386,165,521,0.317,344,797,0.432,0.449,200,240,0.833,46,237,283,405,111,29,193,161
704,5,2005,24,1,2,70,67,2688,437,1097,0.398,185,512,0.361,252,585,0.431,0.483,182,216,0.843,33,170,203,302,92,19,148,135
704,6,2006,25,1,2,79,27,2555,366,879,0.416,101,293,0.345,265,586,0.452,0.474,295,357,0.826,36,212,248,301,87,15,175,150
704,7,2007,26,1,2,59,36,2198,354,886,0.4,103,322,0.32,251,564,0.445,0.458,228,272,0.838,44,145,189,259,57,8,162,114
704,8,2008,27,1,2,80,80,3190,570,1391,0.41,176,494,0.356,394,897,0.439,0.473,329,381,0.864,37,170,207,398,81,17,192,144
704,9,2009,28,1,2,11,11,392,73,169,0.432,35,77,0.455,38,92,0.413,0.536,35,46,0.761,2,15,17,48,9,0,26,13
704,10,2010,29,1,2,79,0,2460,496,1105,0.449,163,427,0.382,333,678,0.491,0.523,270,315,0.857,34,167,201,238,61,12,137,132
704,11,2011,30,1,2,76,0,2297,368,874,0.421,119,349,0.341,249,525,0.474,0.489,222,260,0.854,22,108,130,241,57,14,145,97
704,13,2013,32,1,2,76,0,2230,445,1016,0.438,149,396,0.376,296,620,0.477,0.511,216,248,0.871,22,106,128,193,79,13,146,71
704,14,2014,33,1,2,69,24,2094,421,1011,0.416,161,446,0.361,260,565,0.46,0.496,279,322,0.866,34,124,158,223,59,12,135,120
704,15,2015,34,1,2,7,2,209,37,94,0.394,15,44,0.341,22,50,0.44,0.473,31,35,0.886,0,10,10,20,9,0,12,15
706,1,2011,22,1,2,16,0,160,27,77,0.351,9,27,0.333,18,50,0.36,0.409,4,6,0.667,9,19,28,15,3,0,15,13
706,1,2011,22,1,2,26,18,867,165,423,0.39,24,101,0.238,141,322,0.438,0.418,69,78,0.885,22,55,77,102,36,3,68,50
706,1,2011,22,1,2,42,18,1027,192,500,0.384,33,128,0.258,159,372,0.427,0.417,73,84,0.869,31,74,105,117,39,3,83,63
706,2,2012,23,1,2,64,32,1753,349,872,0.4,79,273,0.289,270,599,0.451,0.446,161,203,0.793,44,124,168,190,59,5,141,111
706,3,2013,24,1,2,27,2,582,90,217,0.415,24,75,0.32,66,142,0.465,0.47,42,53,0.792,13,61,74,68,12,2,44,45
706,3,2013,24,1,2,43,12,1127,211,508,0.415,59,171,0.345,152,337,0.451,0.473,87,106,0.821,31,104,135,157,27,5,97,61
706,3,2013,24,1,2,70,14,1709,301,725,0.415,83,246,0.337,218,479,0.455,0.472,129,159,0.811,44,165,209,225,39,7,141,106
706,4,2014,25,1,2,42,0,661,139,333,0.417,40,128,0.313,99,205,0.483,0.477,36,43,0.837,10,53,63,57,13,2,50,44
706,4,2014,25,1,2,39,35,1198,188,455,0.413,50,157,0.318,138,298,0.463,0.468,110,126,0.873,18,102,120,224,34,3,84,76
706,4,2014,25,1,2,81,35,1859,327,788,0.415,90,285,0.316,237,503,0.471,0.472,146,169,0.864,28,155,183,281,47,5,134,120
709,1,2014,21,1,2,15,0,100,12,33,0.364,6,14,0.429,6,19,0.316,0.455,3,4,0.75,1,8,9,6,2,1,3,10
719,1,2008,20,1,2,22,0,171,26,53,0.491,1,3,0.333,25,50,0.5,0.5,19,28,0.679,7,14,21,18,7,0,22,12
719,1,2008,20,1,2,28,0,508,72,180,0.4,9,34,0.265,63,146,0.432,0.425,53,76,0.697,20,69,89,33,12,2,33,35
719,1,2008,20,1,2,50,0,679,98,233,0.421,10,37,0.27,88,196,0.449,0.442,72,104,0.692,27,83,110,51,19,2,55,47
744,1,1987,22,1,2,67,0,636,139,326,0.426,17,60,0.283,122,266,0.459,0.452,30,38,0.789,30,48,78,58,27,4,44,86
744,2,1988,23,1,2,79,8,1499,340,742,0.458,28,81,0.346,312,661,0.472,0.477,79,101,0.782,43,123,166,149,94,22,108,128
744,3,1989,24,1,2,48,0,813,256,521,0.491,19,55,0.345,237,466,0.509,0.51,40,46,0.87,26,78,104,50,42,4,44,68
744,4,1990,25,1,2,67,13,1860,461,990,0.466,52,147,0.354,409,843,0.485,0.492,96,104,0.923,31,137,168,159,98,26,100,148
744,5,1991,26,1,2,76,14,1515,337,715,0.471,32,86,0.372,305,629,0.485,0.494,96,114,0.842,47,152,199,166,75,25,80,125
744,6,1992,27,1,2,77,0,2020,504,1038,0.486,74,183,0.404,430,855,0.503,0.521,127,152,0.836,57,202,259,177,93,20,134,156
744,7,1993,28,1,2,80,0,2094,498,1102,0.452,95,237,0.401,403,865,0.466,0.495,136,157,0.866,51,235,286,180,87,23,129,150
744,8,1994,29,1,2,82,0,2173,533,1171,0.455,152,378,0.402,381,793,0.48,0.52,117,134,0.873,71,191,262,221,98,27,120,161
744,9,1995,30,1,2,69,0,1718,343,778,0.441,154,361,0.427,189,417,0.453,0.54,95,111,0.856,41,127,168,113,55,18,98,144
744,10,1996,31,1,2,82,29,2371,441,974,0.453,164,406,0.404,277,568,0.488,0.537,146,171,0.854,68,196,264,176,108,25,130,173
744,11,1997,32,1,2,68,20,2078,384,836,0.459,126,296,0.426,258,540,0.478,0.535,114,142,0.803,40,171,211,118,60,14,93,147
744,12,1998,33,1,2,52,1,971,194,434,0.447,61,145,0.421,133,289,0.46,0.517,41,52,0.788,26,75,101,69,31,4,54,85
744,13,1999,34,1,2,42,0,864,163,336,0.485,69,145,0.476,94,191,0.492,0.588,28,34,0.824,18,67,85,48,36,3,45,42
744,14,2000,35,1,2,67,9,1095,194,454,0.427,95,242,0.393,99,212,0.467,0.532,24,32,0.75,11,89,100,89,32,9,40,66
744,15,2001,36,1,2,71,1,956,162,382,0.424,62,145,0.428,100,237,0.422,0.505,43,51,0.843,16,69,85,75,27,8,39,66
744,16,2002,37,1,2,56,4,886,141,347,0.406,45,131,0.344,96,216,0.444,0.471,33,37,0.892,23,58,81,61,22,6,41,50
758,1,2009,21,1,2,15,0,155,24,49,0.49,0,1,0,24,48,0.5,0.49,2,7,0.286,11,17,28,13,6,7,12,19
758,2,2010,22,1,2,47,0,317,40,76,0.526,2,11,0.182,38,65,0.585,0.539,17,30,0.567,13,36,49,16,4,9,11,29
773,1,2000,21,1,2,71,12,1373,254,605,0.42,28,77,0.364,226,528,0.428,0.443,103,133,0.774,38,91,129,108,28,6,84,142
773,3,2002,23,1,2,63,57,2203,472,1084,0.435,16,42,0.381,456,1042,0.438,0.443,300,337,0.89,73,143,216,171,38,14,132,136
773,4,2003,24,1,2,82,82,2640,570,1286,0.443,32,119,0.269,538,1167,0.461,0.456,440,528,0.833,88,230,318,208,64,13,200,249
773,5,2004,25,1,2,78,78,2772,530,1166,0.455,18,68,0.265,512,1098,0.466,0.462,297,342,0.868,78,201,279,310,103,17,210,222
773,6,2005,26,1,2,76,76,2926,510,1160,0.44,36,118,0.305,474,1042,0.455,0.455,368,429,0.858,74,221,295,372,77,13,217,232
773,7,2006,27,1,2,80,80,2825,649,1322,0.491,55,120,0.458,594,1202,0.494,0.512,256,303,0.845,84,172,256,275,52,16,173,207
773,8,2007,28,1,2,75,75,2763,547,1170,0.468,44,129,0.341,503,1041,0.483,0.486,347,403,0.861,75,207,282,285,59,15,159,232
773,9,2008,29,1,2,72,72,2424,499,1030,0.484,62,141,0.44,437,889,0.492,0.515,184,221,0.833,75,160,235,299,73,10,132,171
773,10,2009,30,1,2,67,51,2279,466,1043,0.447,70,190,0.368,396,853,0.464,0.48,223,263,0.848,44,163,207,297,40,4,133,176
773,11,2010,31,1,2,46,46,1552,293,717,0.409,41,138,0.297,252,579,0.435,0.437,204,241,0.846,30,92,122,202,30,3,115,115
773,12,2011,32,1,2,55,39,1498,288,671,0.429,55,144,0.382,233,527,0.442,0.47,146,172,0.849,24,102,126,171,39,4,88,95
773,13,2012,33,1,2,28,28,697,140,310,0.452,17,46,0.37,123,264,0.466,0.479,29,37,0.784,20,46,66,84,12,1,49,56
773,14,2013,34,1,2,50,45,1088,204,475,0.429,16,52,0.308,188,423,0.444,0.446,66,77,0.857,16,67,83,119,24,5,84,93
787,1,1984,23,1,2,55,0,419,65,145,0.448,0,8,0,65,137,0.474,0.448,18,28,0.643,13,35,48,44,15,4,35,62
787,2,1985,24,1,2,54,4,646,110,225,0.489,1,7,0.143,109,218,0.5,0.491,40,72,0.556,20,50,70,75,25,1,49,88
787,3,1986,25,1,2,82,82,2032,299,628,0.476,17,50,0.34,282,578,0.488,0.49,95,132,0.72,82,162,244,193,74,9,126,205
787,4,1987,26,1,2,72,72,1453,272,601,0.453,16,45,0.356,256,556,0.46,0.466,136,179,0.76,84,119,203,102,44,6,77,146
787,5,1988,27,1,2,81,51,1796,316,611,0.517,32,97,0.33,284,514,0.553,0.543,113,152,0.743,64,123,187,175,65,5,91,193
787,6,1989,28,1,2,46,9,964,140,300,0.467,19,54,0.352,121,246,0.492,0.498,42,75,0.56,29,99,128,50,37,6,43,105
787,7,1990,29,1,2,81,81,2174,265,568,0.467,54,154,0.351,211,414,0.51,0.514,33,64,0.516,66,163,229,149,52,11,79,194
787,8,1991,30,1,2,36,24,811,96,256,0.375,19,69,0.275,77,187,0.412,0.412,18,36,0.5,33,63,96,90,20,5,34,72
787,9,1992,31,1,2,66,0,769,75,169,0.444,7,25,0.28,68,144,0.472,0.464,8,22,0.364,15,58,73,68,26,3,28,128
787,9,1992,31,1,2,68,2,809,79,178,0.444,7,27,0.259,72,151,0.477,0.463,8,22,0.364,17,60,77,69,27,3,28,134
794,1,2010,20,1,2,76,0,1738,233,578,0.403,93,248,0.375,140,330,0.424,0.484,194,240,0.808,47,197,244,137,80,20,106,200
794,2,2011,21,1,2,82,5,2189,298,684,0.436,113,324,0.349,185,360,0.514,0.518,289,343,0.843,42,213,255,176,92,24,106,207
794,3,2012,22,1,2,62,2,1946,309,629,0.491,114,292,0.39,195,337,0.579,0.582,312,369,0.846,30,222,252,229,62,15,137,150
794,4,2013,23,1,2,78,78,2985,585,1337,0.438,179,486,0.368,406,851,0.477,0.504,674,792,0.851,62,317,379,455,142,38,295,178
794,5,2014,24,1,2,73,73,2777,549,1205,0.456,177,483,0.366,372,722,0.515,0.529,576,665,0.866,61,283,344,446,115,29,265,177
794,6,2015,25,1,2,9,9,335,65,166,0.392,18,60,0.3,47,106,0.443,0.446,88,97,0.907,7,50,57,67,16,9,37,20
797,1,2014,21,1,2,81,1,1875,294,687,0.428,130,358,0.363,164,329,0.498,0.523,106,128,0.828,19,102,121,66,44,7,47,144
797,2,2015,22,1,2,10,3,180,34,86,0.395,15,39,0.385,19,47,0.404,0.483,11,13,0.846,1,8,9,12,0,1,2,14
801,1,1981,23,1,2,22,-1,111,22,59,0.373,0,0,-1,22,59,0.373,0.373,7,10,0.7,8,11,19,3,1,9,11,13
801,2,1982,24,1,2,38,0,310,62,136,0.456,0,5,0,62,131,0.473,0.456,18,29,0.621,14,20,34,20,9,4,20,32
804,1,1995,25,1,2,10,0,158,21,53,0.396,1,1,1,20,52,0.385,0.406,3,6,0.5,9,14,23,12,9,0,7,12
809,10,1993,31,1,2,62,60,2108,393,939,0.419,101,257,0.393,292,682,0.428,0.472,239,316,0.756,42,81,123,334,80,16,136,145
809,15,1998,36,1,2,66,45,1761,226,542,0.417,59,164,0.36,167,378,0.442,0.471,55,79,0.696,23,80,103,233,72,10,101,140
812,2,2001,24,1,2,56,55,1615,238,524,0.454,13,52,0.25,225,472,0.477,0.467,134,165,0.812,90,152,242,102,42,17,90,161
812,10,2009,32,1,2,63,2,693,111,241,0.461,0,2,0,111,239,0.464,0.461,55,72,0.764,47,76,123,28,29,9,29,102
814,1,1987,23,1,2,82,82,3064,734,1614,0.455,20,94,0.213,714,1520,0.47,0.461,386,564,0.684,169,223,392,394,209,84,345,247
814,2,1988,24,1,2,57,52,1830,340,732,0.464,3,20,0.15,337,712,0.473,0.467,196,278,0.705,64,159,223,281,122,52,158,157
814,3,1989,25,1,2,82,82,2851,587,1149,0.511,29,116,0.25,558,1033,0.54,0.523,323,430,0.751,122,287,409,434,185,74,230,224
814,4,1990,26,1,2,7,7,262,61,138,0.442,1,5,0.2,60,133,0.451,0.446,31,41,0.756,19,29,48,49,14,9,18,25
814,4,1990,26,1,2,28,28,1105,240,499,0.481,13,46,0.283,227,453,0.501,0.494,151,190,0.795,55,103,158,133,67,32,82,80
814,4,1990,26,1,2,35,35,1367,301,637,0.473,14,51,0.275,287,586,0.49,0.484,182,231,0.788,74,132,206,182,81,41,100,105
814,5,1991,27,1,2,39,34,1383,285,729,0.391,48,148,0.324,237,581,0.408,0.424,145,217,0.668,58,130,188,209,66,35,129,111
814,6,1992,28,1,2,82,82,3144,569,1292,0.44,64,211,0.303,505,1081,0.467,0.465,293,398,0.736,120,327,447,417,152,72,252,199
814,7,1993,29,1,2,80,77,2970,542,1203,0.451,52,186,0.28,490,1017,0.482,0.472,307,399,0.769,117,308,425,360,177,73,222,212
814,8,1994,30,1,2,75,75,2856,569,1335,0.426,71,236,0.301,498,1099,0.453,0.453,299,418,0.715,129,331,460,344,144,54,242,167
814,9,1995,31,1,2,77,53,1536,209,491,0.426,31,110,0.282,178,381,0.467,0.457,81,131,0.618,51,129,180,157,97,27,100,132
814,11,1997,33,1,2,76,74,1740,177,406,0.436,68,188,0.362,109,218,0.5,0.52,58,82,0.707,46,147,193,191,86,38,50,138
814,13,1999,35,1,2,35,35,1107,147,390,0.377,27,85,0.318,120,305,0.393,0.412,71,101,0.703,49,131,180,115,60,35,65,80
815,1,2003,22,1,2,19,0,111,11,37,0.297,5,14,0.357,6,23,0.261,0.365,3,4,0.75,1,7,8,12,2,1,2,8
823,9,2013,29,1,2,58,34,1421,194,443,0.438,77,230,0.335,117,213,0.549,0.525,112,154,0.727,6,110,116,197,64,13,88,103
825,1,1994,23,1,2,77,0,1165,162,385,0.421,7,33,0.212,155,352,0.44,0.43,87,119,0.731,45,112,157,106,49,10,78,117
825,2,1995,24,1,2,79,31,1695,280,610,0.459,55,142,0.387,225,468,0.481,0.504,136,170,0.8,85,135,220,132,58,14,77,105
825,3,1996,25,1,2,61,1,1016,183,397,0.461,47,125,0.376,136,272,0.5,0.52,68,87,0.782,41,81,122,79,35,3,46,56
825,4,1997,26,1,2,54,3,813,112,294,0.381,36,99,0.364,76,195,0.39,0.442,33,47,0.702,27,44,71,50,41,3,34,45
825,5,1998,27,1,2,50,0,671,69,177,0.39,12,39,0.308,57,138,0.413,0.424,41,55,0.745,21,31,52,42,42,5,21,77
825,6,1999,28,1,2,36,5,602,73,181,0.403,11,50,0.22,62,131,0.473,0.434,36,48,0.75,21,46,67,31,18,7,18,52
825,7,2000,29,1,2,77,11,1510,198,463,0.428,38,115,0.33,160,348,0.46,0.469,79,99,0.798,53,134,187,100,65,6,42,98
825,8,2001,30,1,2,73,50,2071,265,624,0.425,46,132,0.348,219,492,0.445,0.462,107,139,0.77,71,217,288,135,74,16,64,127
825,9,2002,31,1,2,74,0,1553,249,537,0.464,44,118,0.373,205,419,0.489,0.505,133,158,0.842,49,158,207,116,53,6,61,99
825,10,2003,32,1,2,77,25,1973,298,721,0.413,47,136,0.346,251,585,0.429,0.446,152,189,0.804,63,169,232,155,53,8,71,95
825,12,2005,34,1,2,73,4,1128,118,299,0.395,21,65,0.323,97,234,0.415,0.43,56,69,0.812,39,82,121,49,27,6,29,68
826,1,2012,24,1,2,22,1,318,29,83,0.349,8,39,0.205,21,44,0.477,0.398,14,21,0.667,18,33,51,26,9,2,25,34
826,2,2013,25,1,2,13,0,108,2,19,0.105,0,7,0,2,12,0.167,0.105,1,2,0.5,0,17,17,7,2,3,13,14
826,2,2013,25,1,2,20,0,137,4,27,0.148,0,8,0,4,19,0.211,0.148,7,10,0.7,4,22,26,9,2,3,17,17
829,1,1986,22,1,2,57,0,482,103,233,0.442,1,5,0.2,102,228,0.447,0.444,50,54,0.926,25,32,57,50,21,4,34,55
829,2,1987,23,1,2,74,3,1174,251,599,0.419,0,8,0,251,591,0.425,0.419,111,130,0.854,71,99,170,100,37,16,74,111
829,3,1988,24,1,2,14,10,199,34,86,0.395,0,1,0,34,85,0.4,0.395,15,16,0.938,12,9,21,17,8,2,6,15
829,3,1988,24,1,2,44,16,885,189,401,0.471,0,6,0,189,395,0.478,0.471,74,97,0.763,41,64,105,70,42,6,50,74
829,3,1988,24,1,2,58,26,1084,223,487,0.458,0,7,0,223,480,0.465,0.458,89,113,0.788,53,73,126,87,50,8,56,89
835,1,2002,22,1,2,78,47,2237,267,628,0.425,60,165,0.364,207,463,0.447,0.473,87,114,0.763,65,190,255,172,55,44,101,184
835,2,2003,23,1,2,82,53,1999,144,392,0.367,13,40,0.325,131,352,0.372,0.384,41,55,0.745,37,218,255,151,45,61,83,197
835,3,2004,24,1,2,81,74,2264,177,381,0.465,4,13,0.308,173,368,0.47,0.47,48,61,0.787,68,189,257,133,36,54,46,200
835,4,2005,25,1,2,82,51,2068,225,475,0.474,1,11,0.091,224,464,0.483,0.475,90,114,0.789,80,139,219,128,30,30,64,200
835,5,2006,26,1,2,77,67,2514,286,616,0.464,7,23,0.304,279,593,0.47,0.47,131,176,0.744,82,134,216,203,43,29,124,201
835,6,2007,27,1,2,76,68,2223,217,443,0.49,6,25,0.24,211,418,0.505,0.497,72,92,0.783,83,160,243,203,22,26,80,144
835,7,2008,28,1,2,26,0,310,20,55,0.364,1,5,0.2,19,50,0.38,0.373,6,8,0.75,9,30,39,15,4,2,8,35
835,7,2008,28,1,2,37,6,463,37,80,0.463,1,4,0.25,36,76,0.474,0.469,1,2,0.5,11,33,44,26,9,1,14,55
835,7,2008,28,1,2,63,6,773,57,135,0.422,2,9,0.222,55,126,0.437,0.43,7,10,0.7,20,63,83,41,13,3,22,90
837,1,1980,24,1,2,74,-1,1135,215,509,0.422,69,198,0.348,146,311,0.469,0.49,24,29,0.828,35,59,94,104,46,8,45,85
837,2,1981,25,1,2,17,-1,280,59,142,0.415,10,40,0.25,49,102,0.48,0.451,10,13,0.769,11,14,25,18,5,0,11,21
837,2,1981,25,1,2,24,-1,434,84,198,0.424,43,116,0.371,41,82,0.5,0.533,7,8,0.875,13,30,43,56,8,2,11,44
837,2,1981,25,1,2,41,-1,714,143,340,0.421,53,156,0.34,90,184,0.489,0.499,17,21,0.81,24,44,68,74,13,2,22,65
837,3,1982,26,1,2,68,2,787,144,382,0.377,71,214,0.332,73,168,0.435,0.47,31,37,0.838,13,40,53,104,30,3,36,94
837,4,1983,27,1,2,6,2,139,19,44,0.432,1,9,0.111,18,35,0.514,0.443,0,0,-1,3,8,11,21,2,0,9,14
845,1,2003,29,1,2,58,10,685,57,148,0.385,10,24,0.417,47,124,0.379,0.419,10,20,0.5,16,62,78,47,29,6,29,57
849,1,1989,22,1,2,79,79,2577,442,971,0.455,71,166,0.428,371,805,0.461,0.492,241,290,0.831,51,174,225,239,120,37,158,184
849,2,1990,23,1,2,82,82,2856,522,1136,0.46,84,200,0.42,438,936,0.468,0.496,387,436,0.888,85,219,304,261,130,28,185,217
849,3,1991,24,1,2,80,80,3110,590,1251,0.472,108,270,0.4,482,981,0.491,0.515,479,550,0.871,48,262,310,299,178,39,213,182
849,4,1992,25,1,2,81,81,3013,521,1127,0.462,91,229,0.397,430,898,0.479,0.503,403,461,0.874,53,218,271,248,157,43,189,174
849,6,1994,27,1,2,82,82,2648,395,859,0.46,78,235,0.332,317,624,0.508,0.505,312,362,0.862,89,288,377,216,135,22,158,167
849,7,1995,28,1,2,82,82,2731,390,809,0.482,131,298,0.44,259,511,0.507,0.563,261,301,0.867,60,254,314,262,122,18,150,178
849,8,1996,29,1,2,82,82,2823,443,936,0.473,146,380,0.384,297,556,0.534,0.551,249,285,0.874,86,211,297,218,149,14,164,172
849,9,1997,30,1,2,82,82,2755,369,795,0.464,143,355,0.403,226,440,0.514,0.554,258,295,0.875,92,228,320,250,159,12,130,146
849,10,1998,31,1,2,82,82,2597,280,636,0.44,125,301,0.415,155,335,0.463,0.539,177,204,0.868,71,263,334,221,148,17,102,153
849,11,1999,32,1,2,50,34,1644,171,408,0.419,55,180,0.306,116,228,0.509,0.487,119,132,0.902,51,150,201,123,80,18,80,90
849,12,2000,33,1,2,61,49,1622,159,375,0.424,55,141,0.39,104,234,0.444,0.497,107,119,0.899,31,144,175,134,74,15,100,146
849,13,2001,34,1,2,59,0,681,56,137,0.409,17,46,0.37,39,91,0.429,0.471,54,63,0.857,17,63,80,72,33,9,19,45
853,3,2006,24,1,2,21,13,516,77,183,0.421,17,47,0.362,60,136,0.441,0.467,25,30,0.833,19,57,76,27,16,1,22,38
859,1,2006,23,1,2,80,27,2310,254,630,0.403,113,313,0.361,141,317,0.445,0.493,86,123,0.699,33,233,266,215,89,9,119,169
859,2,2007,24,1,2,80,10,2211,306,700,0.437,177,401,0.441,129,299,0.431,0.564,83,105,0.79,31,221,252,194,76,5,137,133
859,3,2008,25,1,2,73,17,1379,206,477,0.432,79,225,0.351,127,252,0.504,0.515,66,81,0.815,18,117,135,138,44,9,70,75
859,4,2009,26,1,2,10,0,176,16,43,0.372,6,16,0.375,10,27,0.37,0.442,5,8,0.625,3,22,25,23,11,1,9,22
859,5,2010,27,1,2,47,10,813,136,311,0.437,37,105,0.352,99,206,0.481,0.497,48,58,0.828,6,74,80,72,18,9,54,53
867,1,1988,23,1,2,22,1,351,47,116,0.405,0,1,0,47,115,0.409,0.405,32,47,0.681,11,24,35,34,12,5,40,41
870,1,2010,22,1,2,43,0,355,37,104,0.356,4,19,0.211,33,85,0.388,0.375,35,47,0.745,15,40,55,13,10,9,14,25
870,2,2011,23,1,2,68,30,1661,259,570,0.454,7,36,0.194,252,534,0.472,0.461,128,163,0.785,49,158,207,101,50,32,64,118
870,3,2012,24,1,2,55,55,1831,332,723,0.459,11,47,0.234,321,676,0.475,0.467,155,204,0.76,64,161,225,126,49,20,100,128
870,4,2013,25,1,2,68,58,2133,382,855,0.447,33,100,0.33,349,755,0.462,0.466,258,313,0.824,55,195,250,177,68,34,108,149
870,5,2014,26,1,2,77,77,2461,403,930,0.433,40,115,0.348,363,815,0.445,0.455,235,309,0.761,31,279,310,199,51,32,113,159
870,6,2015,27,1,2,8,2,139,12,35,0.343,2,8,0.25,10,27,0.37,0.371,6,6,1,3,15,18,6,7,1,5,9
874,1,1988,23,1,2,12,2,170,19,48,0.396,0,1,0,19,47,0.404,0.396,10,14,0.714,6,11,17,21,8,0,15,24
874,1,1988,23,1,2,17,2,190,21,53,0.396,0,1,0,21,52,0.404,0.396,15,26,0.577,9,12,21,23,8,0,17,26
875,2,1981,29,1,2,66,-1,1411,137,332,0.413,0,3,0,137,329,0.416,0.413,78,95,0.821,30,74,104,307,53,4,93,111
875,3,1982,30,1,2,75,23,1721,183,403,0.454,0,2,0,183,401,0.456,0.454,105,150,0.7,33,105,138,306,55,7,105,120
875,4,1983,31,1,2,51,2,789,107,263,0.407,0,2,0,107,261,0.41,0.407,45,57,0.789,18,51,69,138,37,2,50,57
880,1,2011,19,1,2,38,16,527,65,160,0.406,2,17,0.118,63,143,0.441,0.413,33,52,0.635,9,28,37,18,11,3,13,48
880,2,2012,20,1,2,45,0,759,90,228,0.395,7,17,0.412,83,211,0.393,0.41,52,85,0.612,24,82,106,35,26,8,35,59
890,1,1986,25,1,2,28,0,149,31,67,0.463,4,10,0.4,27,57,0.474,0.493,12,17,0.706,8,11,19,4,5,0,9,11
891,1,1987,23,1,2,36,0,231,38,103,0.369,12,31,0.387,26,72,0.361,0.427,10,17,0.588,7,20,27,27,6,1,17,27
891,1,1987,23,1,2,54,0,323,46,136,0.338,13,42,0.31,33,94,0.351,0.386,17,27,0.63,7,27,34,35,9,1,26,34
891,2,1988,24,1,2,14,2,145,13,41,0.317,2,6,0.333,11,35,0.314,0.341,4,7,0.571,5,14,19,29,4,1,14,11
891,2,1988,24,1,2,15,0,207,38,81,0.469,15,31,0.484,23,50,0.46,0.562,26,30,0.867,6,14,20,26,7,3,16,15
891,2,1988,24,1,2,39,2,433,62,150,0.413,20,45,0.444,42,105,0.4,0.48,39,47,0.83,13,36,49,67,12,5,39,37
915,1,2007,23,1,2,12,0,136,19,60,0.317,5,23,0.217,14,37,0.378,0.358,8,12,0.667,4,12,16,8,3,2,6,8
920,6,2009,28,1,2,51,4,1339,183,419,0.437,69,169,0.408,114,250,0.456,0.519,68,86,0.791,16,107,123,197,66,19,87,126
920,7,2010,29,1,2,74,53,2481,308,753,0.409,104,280,0.371,204,473,0.431,0.478,85,113,0.752,24,236,260,330,85,24,113,204
920,8,2011,30,1,2,48,29,1471,198,438,0.452,43,112,0.384,155,326,0.475,0.501,92,105,0.876,14,115,129,210,56,10,84,119
920,8,2011,30,1,2,72,51,2157,278,623,0.446,75,188,0.399,203,435,0.467,0.506,106,126,0.841,21,161,182,288,75,17,121,185
920,9,2012,31,1,2,48,31,1237,122,295,0.414,47,136,0.346,75,159,0.472,0.493,25,32,0.781,11,90,101,132,38,11,58,100
920,12,2015,34,1,2,10,7,278,30,84,0.357,11,32,0.344,19,52,0.365,0.423,18,26,0.692,1,15,16,33,11,0,17,25
925,1,1983,22,1,2,76,48,2022,318,704,0.452,20,90,0.222,298,614,0.485,0.466,94,130,0.723,53,69,122,275,82,4,161,192
925,2,1984,23,1,2,76,28,1571,258,573,0.45,10,46,0.217,248,527,0.471,0.459,66,88,0.75,22,64,86,116,58,1,85,166
925,3,1985,24,1,2,82,63,2496,359,732,0.49,47,135,0.348,312,597,0.523,0.523,106,130,0.815,74,112,186,349,96,1,135,262
925,4,1986,25,1,2,66,66,1739,284,568,0.5,73,162,0.451,211,406,0.52,0.564,75,86,0.872,39,78,117,229,74,2,89,157
925,6,1988,27,1,2,23,0,462,87,178,0.489,31,57,0.544,56,121,0.463,0.576,27,32,0.844,7,25,32,44,16,2,28,38
925,6,1988,27,1,2,43,0,983,155,345,0.449,55,118,0.466,100,227,0.441,0.529,32,39,0.821,12,34,46,109,30,0,49,80
925,6,1988,27,1,2,66,0,1445,242,523,0.463,86,175,0.491,156,348,0.448,0.545,59,71,0.831,19,59,78,153,46,2,77,118
925,7,1989,28,1,2,49,6,1112,187,394,0.475,71,168,0.423,116,226,0.513,0.565,45,53,0.849,21,63,84,138,41,4,52,82
925,7,1989,28,1,2,59,6,1204,203,430,0.472,75,180,0.417,128,250,0.512,0.559,48,57,0.842,23,66,89,146,43,4,57,90
925,8,1990,29,1,2,63,0,1055,145,331,0.438,87,181,0.481,58,150,0.387,0.569,30,33,0.909,11,42,53,110,30,2,30,87
925,9,1991,30,1,2,73,0,843,146,344,0.424,44,115,0.383,102,229,0.445,0.488,26,27,0.963,10,32,42,97,34,2,35,74
925,10,1992,31,1,2,56,2,555,93,242,0.384,36,96,0.375,57,146,0.39,0.459,16,17,0.941,7,17,24,54,14,1,22,33
928,1,1997,24,1,2,47,0,572,67,156,0.429,29,70,0.414,38,86,0.442,0.522,61,77,0.792,13,68,81,41,27,6,22,51
928,2,1998,25,1,2,65,1,874,85,222,0.383,32,85,0.376,53,137,0.387,0.455,59,69,0.855,14,109,123,45,40,3,22,101
928,3,2000,27,1,2,31,11,845,89,230,0.387,32,94,0.34,57,136,0.419,0.457,69,76,0.908,7,103,110,85,40,2,43,66
928,4,2001,28,1,2,74,37,2247,217,495,0.438,103,250,0.412,114,245,0.465,0.542,136,157,0.866,21,287,308,263,98,12,74,155
928,5,2002,29,1,2,79,8,1408,121,291,0.416,24,92,0.261,97,199,0.487,0.457,79,94,0.84,18,192,210,136,61,5,32,87
928,6,2003,30,1,2,63,0,784,49,126,0.389,5,21,0.238,44,105,0.419,0.409,41,50,0.82,11,126,137,70,40,5,25,59
928,7,2004,31,1,2,79,3,1804,178,383,0.465,76,172,0.442,102,211,0.483,0.564,98,116,0.845,21,247,268,109,66,10,44,136
928,8,2005,32,1,2,76,0,1272,139,284,0.489,70,145,0.483,69,139,0.496,0.613,89,102,0.873,32,149,181,85,50,15,20,105
933,1,1980,23,1,2,38,-1,197,44,104,0.423,3,15,0.2,41,89,0.461,0.438,15,16,0.938,4,13,17,22,15,1,13,24
933,2,1981,24,1,2,41,-1,295,47,111,0.423,1,3,0.333,46,108,0.426,0.428,35,49,0.714,9,20,29,23,21,1,31,44
933,3,1982,25,1,2,13,3,185,27,73,0.37,0,3,0,27,70,0.386,0.37,3,4,0.75,6,7,13,16,11,1,7,12
933,3,1982,25,1,2,14,3,194,27,78,0.346,0,3,0,27,75,0.36,0.346,3,6,0.5,6,7,13,18,11,1,8,13
935,1,1980,26,1,2,27,-1,796,130,313,0.415,2,10,0.2,128,303,0.422,0.419,67,87,0.77,24,45,69,112,46,9,68,68
935,1,1980,26,1,2,47,-1,1209,212,526,0.403,3,20,0.15,209,506,0.413,0.406,101,140,0.721,29,60,89,162,76,10,128,103
941,1,1985,23,1,2,74,59,1761,257,576,0.446,14,45,0.311,243,531,0.458,0.458,96,118,0.814,30,102,132,198,59,6,123,141
954,1,1988,22,1,2,61,19,1365,222,549,0.404,12,45,0.267,210,504,0.417,0.415,131,177,0.74,63,80,143,118,57,25,119,145
954,2,1989,23,1,2,62,36,1551,299,714,0.419,4,27,0.148,295,687,0.429,0.422,186,219,0.849,91,111,202,103,70,30,102,150
954,3,1990,24,1,2,79,64,2551,474,1093,0.434,32,101,0.317,442,992,0.446,0.448,271,342,0.792,113,166,279,151,100,51,168,183
954,5,1992,26,1,2,69,0,1304,275,591,0.465,12,47,0.255,263,544,0.483,0.475,179,253,0.708,105,101,206,102,66,39,100,113
954,5,1992,26,1,2,71,0,1314,276,593,0.465,12,47,0.255,264,546,0.484,0.476,179,253,0.708,105,101,206,102,67,39,100,115
959,1,1987,23,1,2,80,3,1561,159,350,0.454,12,43,0.279,147,307,0.479,0.471,94,121,0.777,41,143,184,361,70,5,153,130
959,2,1988,24,1,2,82,49,2243,306,605,0.506,17,58,0.293,289,547,0.528,0.52,152,185,0.822,71,191,262,540,107,10,156,151
959,3,1989,25,1,2,78,73,2487,440,889,0.495,27,81,0.333,413,808,0.511,0.51,147,178,0.826,75,191,266,465,129,8,111,188
959,4,1990,26,1,2,67,60,2278,483,901,0.536,40,98,0.408,443,803,0.552,0.558,173,202,0.856,86,227,313,337,117,14,125,144
959,5,1991,27,1,2,80,77,2733,544,1051,0.518,61,146,0.418,483,905,0.534,0.547,201,224,0.897,74,247,321,409,111,16,130,185
959,6,1992,28,1,2,81,81,3078,635,1240,0.512,83,189,0.439,552,1051,0.525,0.546,279,315,0.886,106,301,407,411,158,31,170,218
959,7,1993,29,1,2,79,78,2860,582,1239,0.47,97,249,0.39,485,990,0.49,0.509,250,289,0.865,84,258,342,548,131,21,222,203
959,8,1994,30,1,2,27,9,826,147,289,0.509,18,42,0.429,129,247,0.522,0.54,82,92,0.891,19,48,67,104,32,3,33,71
959,8,1994,30,1,2,53,53,1994,325,715,0.455,52,166,0.313,273,549,0.497,0.491,178,204,0.873,41,171,212,315,95,10,138,115
959,8,1994,30,1,2,80,62,2820,472,1004,0.47,70,208,0.337,402,796,0.505,0.505,260,296,0.878,60,219,279,419,127,13,171,186
959,9,1995,31,1,2,81,81,2696,482,937,0.514,89,219,0.406,393,718,0.547,0.562,284,322,0.882,53,157,210,347,129,17,145,181
959,10,1996,32,1,2,82,59,2588,442,880,0.502,104,223,0.466,338,657,0.514,0.561,259,290,0.893,62,147,209,340,106,20,127,171
959,11,1997,33,1,2,82,82,2592,413,856,0.482,72,195,0.369,341,661,0.516,0.525,293,326,0.899,60,181,241,361,124,26,134,188
959,12,1998,34,1,2,80,80,2460,399,828,0.482,56,127,0.441,343,701,0.489,0.516,285,322,0.885,65,205,270,349,109,15,132,175
959,13,1999,35,1,2,48,48,1435,214,449,0.477,34,81,0.42,180,368,0.489,0.514,125,140,0.893,33,127,160,192,52,14,82,95
959,14,2000,36,1,2,77,77,2133,358,728,0.492,66,138,0.478,292,590,0.495,0.537,171,180,0.95,49,133,182,202,66,16,113,149
961,1,1994,22,1,2,79,20,1519,272,671,0.405,35,117,0.299,237,554,0.428,0.431,89,108,0.824,19,101,120,100,34,13,99,165
961,2,1995,23,1,2,76,39,1996,398,859,0.463,158,373,0.424,240,486,0.494,0.555,147,171,0.86,29,138,167,164,61,14,113,182
961,3,1996,24,1,2,82,75,3072,564,1244,0.453,191,447,0.427,373,797,0.468,0.53,298,362,0.823,54,246,300,250,61,16,233,233
961,4,1997,25,1,2,81,81,2681,437,1032,0.423,148,384,0.385,289,648,0.446,0.495,175,218,0.803,43,197,240,179,41,18,167,233
961,5,1998,26,1,2,82,82,2848,571,1277,0.447,82,213,0.385,489,1064,0.46,0.479,285,335,0.851,43,231,274,212,63,24,200,207
961,6,1999,27,1,2,50,50,1815,294,703,0.418,57,140,0.407,237,563,0.421,0.459,168,195,0.862,20,132,152,137,35,9,130,115
961,7,2000,28,1,2,82,82,3169,614,1271,0.483,106,243,0.436,508,1028,0.494,0.525,280,334,0.838,38,233,271,224,65,14,186,219
961,8,2001,29,1,2,78,78,2858,542,1208,0.449,96,252,0.381,446,956,0.467,0.488,279,307,0.909,20,263,283,173,52,10,161,190
961,9,2002,30,1,2,77,77,2914,568,1301,0.437,136,346,0.393,432,955,0.452,0.489,295,339,0.87,37,215,252,190,54,10,170,182
961,10,2003,31,1,2,82,82,3108,652,1465,0.445,178,450,0.396,474,1015,0.467,0.506,363,395,0.919,26,205,231,220,54,7,178,191
961,11,2004,32,1,2,50,50,1799,340,781,0.435,87,202,0.431,253,579,0.437,0.491,157,172,0.913,20,101,121,99,38,2,102,105
961,12,2005,33,1,2,20,11,532,85,205,0.415,31,80,0.388,54,125,0.432,0.49,36,43,0.837,4,19,23,42,8,2,21,40
974,1,1986,23,1,2,68,0,866,152,372,0.409,3,17,0.176,149,355,0.42,0.413,49,84,0.583,49,64,113,61,26,5,63,79
977,3,2003,24,1,2,55,7,1025,172,444,0.387,36,120,0.3,136,324,0.42,0.428,31,36,0.861,17,84,101,87,44,1,46,73
977,4,2004,25,1,2,60,10,1188,161,449,0.359,51,136,0.375,110,313,0.351,0.415,36,45,0.8,28,110,138,148,65,4,63,92
977,5,2005,26,1,2,13,5,300,61,135,0.452,12,29,0.414,49,106,0.462,0.496,10,13,0.769,2,17,19,24,24,3,13,23
977,7,2007,28,1,2,56,1,946,180,421,0.428,75,175,0.429,105,246,0.427,0.517,33,36,0.917,14,78,92,67,27,3,27,69
977,10,2010,31,1,2,18,0,371,44,133,0.331,15,60,0.25,29,73,0.397,0.387,12,12,1,6,34,40,37,12,0,20,20
977,11,2011,32,1,2,56,1,978,128,321,0.399,68,175,0.389,60,146,0.411,0.505,38,40,0.95,9,83,92,62,32,3,29,68
978,1,1993,23,1,2,79,8,1274,145,325,0.446,2,7,0.286,143,318,0.45,0.449,129,194,0.665,119,196,315,69,44,43,87,253
991,1,1985,22,1,2,80,39,2062,279,626,0.446,4,20,0.2,275,606,0.454,0.449,141,170,0.829,32,132,164,350,107,8,167,209
991,9,1993,30,1,2,78,20,2034,287,659,0.436,15,75,0.2,272,584,0.466,0.447,101,130,0.777,40,103,143,317,101,11,132,236
991,10,1994,31,1,2,75,19,1619,233,535,0.436,38,96,0.396,195,439,0.444,0.471,57,76,0.75,35,92,127,219,65,11,95,168
991,11,1995,32,1,2,12,0,149,4,25,0.16,2,3,0.667,2,22,0.091,0.2,0,0,-1,2,8,10,9,7,0,12,25
991,11,1995,32,1,2,18,0,201,8,34,0.235,2,4,0.5,6,30,0.2,0.265,2,4,0.5,4,9,13,19,9,0,17,35
993,11,2004,33,1,2,33,8,661,49,143,0.343,14,50,0.28,35,93,0.376,0.392,5,8,0.625,13,54,67,85,39,6,34,45
993,12,2005,34,1,2,76,3,1144,108,302,0.358,23,84,0.274,85,218,0.39,0.396,46,58,0.793,38,85,123,130,68,13,68,125
1021,1,2009,23,1,2,78,4,1993,268,630,0.425,159,398,0.399,109,232,0.47,0.552,120,143,0.839,47,160,207,159,69,12,86,111
1021,2,2010,24,1,2,62,2,1441,160,423,0.378,98,266,0.368,62,157,0.395,0.494,85,98,0.867,35,129,164,127,62,11,72,87
1021,3,2011,25,1,2,78,3,1821,213,575,0.37,116,361,0.321,97,214,0.453,0.471,126,146,0.863,37,135,172,193,87,14,88,134
1021,4,2012,26,1,2,31,1,710,99,225,0.44,40,122,0.328,59,103,0.573,0.529,30,43,0.698,9,56,65,75,31,3,40,37
1022,6,2011,26,1,2,21,0,663,88,204,0.431,28,61,0.459,60,143,0.42,0.5,37,60,0.617,8,67,75,137,28,0,45,37
1030,1,2011,22,1,2,82,81,2541,299,602,0.497,86,219,0.393,213,383,0.556,0.568,113,147,0.769,105,416,521,155,80,17,107,114
1030,2,2012,23,1,2,66,62,1894,236,513,0.46,31,121,0.256,205,392,0.523,0.49,77,137,0.562,59,219,278,169,79,17,102,99
1032,8,2004,29,1,2,82,3,1769,203,576,0.352,52,179,0.291,151,397,0.38,0.398,122,153,0.797,30,122,152,187,103,4,79,115
1032,11,2007,32,1,2,82,61,2287,258,675,0.382,48,156,0.308,210,519,0.405,0.418,262,307,0.853,30,119,149,274,83,6,120,234
1032,17,2013,38,1,2,24,0,346,32,96,0.333,20,57,0.351,12,39,0.308,0.438,14,15,0.933,2,20,22,16,14,1,12,31
1032,17,2013,38,1,2,33,9,575,55,161,0.342,30,80,0.375,25,81,0.309,0.435,35,38,0.921,2,35,37,47,19,3,30,55
1032,18,2014,39,1,2,81,0,1428,141,361,0.391,88,229,0.384,53,132,0.402,0.512,55,71,0.775,12,110,122,117,70,3,49,157
1039,9,2004,30,1,2,72,72,2778,514,1159,0.443,150,370,0.405,364,789,0.461,0.508,164,193,0.85,78,247,325,212,84,39,83,118
1039,10,2005,31,1,2,64,64,2358,387,907,0.427,116,285,0.407,271,622,0.436,0.491,113,136,0.831,45,217,262,169,48,18,60,123
1039,11,2006,32,1,2,77,18,2038,286,695,0.412,110,279,0.394,176,416,0.423,0.491,98,115,0.852,31,216,247,116,37,7,62,97
1039,13,2008,34,1,2,82,61,2204,315,761,0.414,132,357,0.37,183,404,0.453,0.501,64,80,0.8,27,227,254,114,29,10,56,93
1048,3,1985,24,1,2,82,82,2873,610,1372,0.445,42,143,0.294,568,1229,0.462,0.46,336,415,0.81,62,140,202,406,134,41,251,226
1048,13,1995,34,1,2,48,1,831,71,212,0.335,25,88,0.284,46,124,0.371,0.394,30,43,0.698,8,46,54,126,13,6,51,73
1056,2,2012,26,1,2,48,2,713,112,271,0.413,29,83,0.349,83,188,0.441,0.467,66,91,0.725,27,75,102,54,24,4,54,56
1060,1,1980,31,1,2,73,73,2115,330,709,0.465,70,164,0.427,260,545,0.477,0.515,86,114,0.754,77,104,181,215,111,27,105,178
1060,2,1981,32,1,2,82,75,2723,314,707,0.444,36,109,0.33,278,598,0.465,0.47,64,87,0.736,72,91,163,295,100,23,127,212
1060,3,1982,33,1,2,76,53,1591,188,450,0.418,20,63,0.317,168,387,0.434,0.44,39,56,0.696,52,56,108,142,42,10,52,143
1074,1,2013,20,1,2,38,4,428,75,152,0.493,22,54,0.407,53,98,0.541,0.566,30,39,0.769,6,29,35,44,19,1,32,65
1074,2,2014,21,1,2,76,4,1503,228,544,0.419,89,237,0.376,139,307,0.453,0.501,93,123,0.756,34,168,202,112,34,7,100,179
1074,3,2015,22,1,2,11,11,379,67,137,0.489,24,47,0.511,43,90,0.478,0.577,36,50,0.72,6,21,27,23,8,0,18,30
1083,7,2006,28,1,2,24,15,659,84,190,0.442,7,13,0.538,77,177,0.435,0.461,83,109,0.761,14,57,71,83,23,6,58,62
1083,8,2007,29,1,2,44,30,1237,140,343,0.408,42,111,0.378,98,232,0.422,0.469,175,211,0.829,33,124,157,170,41,12,100,126
1088,3,2009,25,1,2,70,61,2494,399,981,0.407,111,308,0.36,288,673,0.428,0.463,230,272,0.846,34,180,214,303,72,26,150,201
1088,5,2011,27,1,2,63,24,1551,206,531,0.388,71,217,0.327,135,314,0.43,0.455,133,149,0.893,13,90,103,170,47,21,95,122
1088,6,2012,28,1,2,65,48,1682,256,644,0.398,127,329,0.386,129,315,0.41,0.496,73,85,0.859,25,113,138,146,46,24,73,130
1088,7,2013,29,1,2,82,72,2249,293,738,0.397,178,434,0.41,115,304,0.378,0.518,118,144,0.819,17,110,127,167,66,27,92,190
1088,8,2014,30,1,2,81,78,2485,361,875,0.413,189,498,0.38,172,377,0.456,0.521,157,185,0.849,36,196,232,287,67,39,145,205
1088,9,2015,31,1,2,7,0,152,26,61,0.426,14,32,0.438,12,29,0.414,0.541,10,11,0.909,1,9,10,17,3,1,5,17
1089,1,2014,22,1,2,21,0,161,16,39,0.41,5,11,0.455,11,28,0.393,0.474,2,2,1,4,19,23,6,4,2,11,23
1091,2,2013,23,1,2,69,0,967,172,409,0.421,65,156,0.417,107,253,0.423,0.5,85,99,0.859,19,52,71,92,31,3,68,64
1091,3,2014,24,1,2,41,0,463,94,198,0.475,36,73,0.493,58,125,0.464,0.566,17,19,0.895,7,38,45,61,14,3,44,28
1091,3,2014,24,1,2,49,0,519,107,227,0.471,40,84,0.476,67,143,0.469,0.559,19,21,0.905,8,44,52,64,14,3,48,35
1096,1,1980,26,1,2,68,-1,2585,737,1556,0.474,9,25,0.36,728,1531,0.476,0.477,572,760,0.753,129,109,238,283,81,32,228,195
1096,2,1981,27,1,2,65,-1,2370,516,1157,0.446,5,31,0.161,511,1126,0.454,0.448,528,649,0.814,48,111,159,361,85,11,195,183
1096,3,1982,28,1,2,78,78,2796,650,1452,0.448,10,56,0.179,640,1396,0.458,0.451,479,647,0.74,118,130,248,419,71,8,208,222
1096,4,1983,29,1,2,19,18,700,164,364,0.451,0,3,0,164,361,0.454,0.451,106,149,0.711,22,22,44,89,15,3,50,66
1096,4,1983,29,1,2,54,51,1938,485,1059,0.458,15,42,0.357,470,1017,0.462,0.465,324,434,0.747,70,87,157,201,82,12,159,175
1096,4,1983,29,1,2,73,69,2638,649,1423,0.456,15,45,0.333,634,1378,0.46,0.461,430,583,0.738,92,109,201,290,97,15,209,241
1096,5,1984,30,1,2,75,71,2375,626,1407,0.445,22,69,0.319,604,1338,0.451,0.453,395,504,0.784,89,128,217,226,94,8,154,214
1096,6,1985,31,1,2,71,50,2249,609,1328,0.459,71,193,0.368,538,1135,0.474,0.485,308,411,0.749,61,150,211,320,75,16,139,163
1096,7,1986,32,1,2,75,75,2535,652,1433,0.455,71,169,0.42,581,1264,0.46,0.48,379,486,0.78,72,146,218,314,91,19,172,186
1096,8,1987,33,1,2,20,2,285,39,123,0.317,2,9,0.222,37,114,0.325,0.325,36,47,0.766,5,14,19,30,5,4,18,26
1096,9,1988,34,1,2,58,0,682,143,350,0.409,8,35,0.229,135,315,0.429,0.42,80,100,0.8,14,30,44,60,20,3,49,74
1108,1,1981,22,1,2,15,-1,248,24,66,0.364,0,1,0,24,65,0.369,0.364,12,16,0.75,13,29,42,28,10,1,23,25
1110,1,1980,25,1,2,21,-1,404,66,161,0.41,1,9,0.111,65,152,0.428,0.413,44,51,0.863,23,19,42,72,19,9,34,19
1110,1,1980,25,1,2,55,-1,1718,364,765,0.476,23,73,0.315,341,692,0.493,0.491,127,145,0.876,47,105,152,221,54,14,129,79
1110,1,1980,25,1,2,76,-1,2122,430,926,0.464,24,82,0.293,406,844,0.481,0.477,171,196,0.872,70,124,194,293,73,23,163,98
1117,3,2012,25,1,2,57,12,793,102,271,0.376,28,82,0.341,74,189,0.392,0.428,59,96,0.615,27,81,108,126,55,2,52,58
1125,1,2005,24,1,2,8,3,146,18,52,0.346,5,18,0.278,13,34,0.382,0.394,3,4,0.75,7,8,15,18,4,1,8,15
1130,5,2010,28,1,2,25,4,575,82,176,0.466,23,59,0.39,59,117,0.504,0.531,15,17,0.882,11,55,66,45,10,19,21,49
1130,8,2013,31,1,2,40,15,710,77,205,0.376,40,109,0.367,37,96,0.385,0.473,12,14,0.857,7,61,68,43,32,31,20,66
1130,8,2013,31,1,2,58,20,1029,118,300,0.393,67,179,0.374,51,121,0.421,0.505,18,21,0.857,8,83,91,63,46,38,32,88
1143,1,1989,22,1,2,71,20,1499,176,359,0.49,0,13,0,176,346,0.509,0.49,102,127,0.803,37,119,156,243,78,9,116,141
1143,2,1990,23,1,2,73,22,1721,208,421,0.494,4,21,0.19,204,400,0.51,0.499,88,114,0.772,34,128,162,289,90,7,117,151
1143,3,1991,24,1,2,67,0,949,100,236,0.424,0,22,0,100,214,0.467,0.424,60,79,0.759,40,87,127,223,62,2,66,101
1143,4,1992,25,1,2,15,0,112,11,33,0.333,1,2,0.5,10,31,0.323,0.348,6,8,0.75,2,7,9,18,7,3,10,14
1143,4,1992,25,1,2,19,5,374,44,93,0.473,0,1,0,44,92,0.478,0.473,10,16,0.625,8,33,41,63,21,1,30,33
1143,4,1992,25,1,2,40,5,549,59,143,0.413,1,4,0.25,58,139,0.417,0.416,18,26,0.692,12,44,56,98,36,4,44,54
1156,1,2011,20,1,2,61,19,1265,179,395,0.453,41,138,0.297,138,257,0.537,0.505,77,101,0.762,37,187,224,65,62,26,70,127
1156,2,2012,21,1,2,66,66,1958,281,639,0.44,90,234,0.385,191,405,0.472,0.51,146,182,0.802,56,314,370,158,108,38,117,191
1157,1,2010,22,1,2,11,2,182,28,59,0.475,7,9,0.778,21,50,0.42,0.534,18,29,0.621,15,18,33,7,7,1,10,13
1157,2,2011,23,1,2,11,5,127,12,27,0.444,0,2,0,12,25,0.48,0.444,8,12,0.667,11,11,22,5,7,0,8,10
1157,2,2011,23,1,2,40,29,973,108,234,0.462,17,49,0.347,91,185,0.492,0.498,64,80,0.8,49,108,157,33,33,16,44,81
1157,2,2011,23,1,2,56,34,1118,121,264,0.458,17,51,0.333,104,213,0.488,0.491,72,92,0.783,62,120,182,38,40,18,55,94
1157,3,2012,24,1,2,63,31,1827,227,551,0.412,44,137,0.321,183,414,0.442,0.452,167,212,0.788,101,221,322,113,83,17,114,149
1162,1,1980,27,1,2,78,-1,2934,1024,1940,0.528,32,102,0.314,992,1838,0.54,0.536,505,593,0.852,154,249,403,202,110,79,254,208
1162,2,1981,28,1,2,82,-1,2765,850,1729,0.492,9,35,0.257,841,1694,0.496,0.494,512,620,0.826,126,293,419,260,94,56,251,212
1162,3,1982,29,1,2,79,79,2817,993,1987,0.5,10,36,0.278,983,1951,0.504,0.502,555,642,0.864,138,254,392,187,77,45,210,215
1162,4,1983,30,1,2,78,78,2830,757,1553,0.487,12,33,0.364,745,1520,0.49,0.491,517,606,0.853,111,246,357,264,88,67,247,243
1162,5,1984,31,1,2,76,76,2584,765,1561,0.49,10,24,0.417,755,1537,0.491,0.493,427,507,0.842,106,207,313,220,79,47,224,219
1162,6,1985,32,1,2,72,69,2091,600,1182,0.508,0,10,0,600,1172,0.512,0.508,324,384,0.844,79,155,234,178,66,48,198,208
1162,7,1986,33,1,2,82,75,2065,519,1100,0.472,4,19,0.211,515,1081,0.476,0.474,283,322,0.879,78,137,215,144,49,23,161,210
1166,5,2011,24,1,2,67,15,1865,264,660,0.4,118,293,0.403,146,367,0.398,0.489,134,163,0.822,24,153,177,201,48,21,80,154
1166,6,2012,25,1,2,35,7,916,87,248,0.351,55,139,0.396,32,109,0.294,0.462,34,43,0.791,11,90,101,76,26,16,45,69
1174,1,1991,22,1,2,82,36,1944,376,836,0.45,2,14,0.143,374,822,0.455,0.451,152,182,0.835,105,158,263,303,104,39,163,186
1174,2,1992,23,1,2,79,79,2906,666,1427,0.467,6,25,0.24,660,1402,0.471,0.469,284,381,0.745,165,237,402,329,154,46,180,237
1174,3,1993,24,1,2,69,67,2430,463,1032,0.449,17,62,0.274,446,970,0.46,0.457,224,290,0.772,120,220,340,268,98,36,174,191
1174,4,1994,25,1,2,79,77,2435,429,969,0.443,38,120,0.317,391,849,0.461,0.462,215,275,0.782,91,177,268,275,151,32,143,194
1174,5,1995,26,1,2,73,58,2125,392,858,0.457,63,171,0.368,329,687,0.479,0.494,155,209,0.742,99,191,290,192,117,28,138,186
1174,6,1996,27,1,2,11,10,418,67,152,0.441,9,25,0.36,58,127,0.457,0.47,49,59,0.831,16,27,43,35,22,2,21,30
1174,6,1996,27,1,2,36,36,1265,179,372,0.481,17,54,0.315,162,318,0.509,0.504,89,117,0.761,56,133,189,225,42,22,110,101
1174,6,1996,27,1,2,47,46,1683,246,524,0.469,26,79,0.329,220,445,0.494,0.494,138,176,0.784,72,160,232,260,64,24,131,131
1174,11,2001,32,1,2,31,26,892,107,323,0.331,4,14,0.286,103,309,0.333,0.337,65,90,0.722,32,99,131,87,47,7,48,64
1174,12,2002,33,1,2,65,49,1410,162,422,0.384,6,44,0.136,156,378,0.413,0.391,42,62,0.677,29,155,184,100,44,8,55,140
1174,13,2003,34,1,2,82,34,2068,286,677,0.422,19,59,0.322,267,618,0.432,0.436,123,161,0.764,51,197,248,156,78,15,108,176
1174,14,2004,35,1,2,56,35,1411,215,548,0.392,9,38,0.237,206,510,0.404,0.401,100,136,0.735,61,129,190,89,65,16,83,107
1174,15,2005,36,1,2,14,0,284,32,80,0.4,3,9,0.333,29,71,0.408,0.419,18,20,0.9,11,26,37,27,14,4,9,37
1182,1,2003,25,1,2,69,5,1431,174,397,0.438,51,148,0.345,123,249,0.494,0.503,126,171,0.737,47,114,161,138,96,17,100,170
1182,2,2004,26,1,2,77,38,2260,330,789,0.418,88,245,0.359,242,544,0.445,0.474,239,298,0.802,86,258,344,291,136,16,161,181
1182,3,2005,27,1,2,74,74,2193,367,780,0.471,97,258,0.376,270,522,0.517,0.533,355,442,0.803,75,254,329,288,119,27,172,190
1182,4,2006,28,1,2,65,56,1813,309,669,0.462,83,217,0.382,226,452,0.5,0.524,280,360,0.778,42,188,230,235,101,26,121,156
1182,5,2007,29,1,2,75,36,2060,396,854,0.464,128,323,0.396,268,531,0.505,0.539,320,372,0.86,59,268,327,263,109,27,157,155
1182,6,2008,30,1,2,74,23,2299,453,984,0.46,156,389,0.401,297,595,0.499,0.54,380,442,0.86,63,291,354,332,109,33,200,173
1182,7,2009,31,1,2,44,7,1181,223,491,0.454,69,209,0.33,154,282,0.546,0.524,168,190,0.884,24,174,198,157,64,16,88,90
1182,8,2010,32,1,2,75,21,2150,398,903,0.441,132,350,0.377,266,553,0.481,0.514,309,355,0.87,68,216,284,370,103,24,154,154
1182,9,2011,33,1,2,80,79,2426,441,1018,0.433,154,441,0.349,287,577,0.497,0.509,357,410,0.871,42,253,295,393,123,28,174,163
1182,10,2012,34,1,2,34,7,792,150,285,0.526,52,126,0.413,98,159,0.616,0.618,88,101,0.871,18,98,116,151,24,12,64,56
1182,11,2013,35,1,2,60,0,1393,229,539,0.425,83,235,0.353,146,304,0.48,0.502,164,206,0.796,30,171,201,274,80,13,132,114
1182,12,2014,36,1,2,68,3,1550,294,627,0.469,90,258,0.349,204,369,0.553,0.541,160,188,0.851,30,172,202,293,70,17,139,128
1182,13,2015,37,1,2,8,0,207,34,85,0.4,10,33,0.303,24,52,0.462,0.459,30,37,0.811,2,19,21,32,10,1,14,19
1183,1,2003,25,1,2,49,35,1187,207,478,0.433,46,130,0.354,161,348,0.463,0.481,88,107,0.822,18,90,108,70,22,6,94,104
1183,1,2003,25,1,2,76,62,2148,350,803,0.436,85,249,0.341,265,554,0.478,0.489,150,183,0.82,36,202,238,137,52,8,145,159
1183,2,2004,26,1,2,25,18,606,128,297,0.431,14,39,0.359,114,258,0.442,0.455,68,77,0.883,14,48,62,42,15,5,40,46
1183,3,2005,27,1,2,81,44,1660,283,632,0.448,38,105,0.362,245,527,0.465,0.478,111,137,0.81,25,157,182,137,46,11,90,155
1183,4,2006,28,1,2,37,36,956,166,383,0.433,18,59,0.305,148,324,0.457,0.457,43,57,0.754,15,55,70,63,16,4,63,87
1183,5,2007,29,1,2,61,6,1188,176,381,0.462,52,122,0.426,124,259,0.479,0.53,71,87,0.816,24,105,129,63,28,5,64,122
1183,6,2008,30,1,2,12,0,110,13,41,0.317,5,15,0.333,8,26,0.308,0.378,6,8,0.75,1,13,14,11,3,1,8,9
1183,6,2008,30,1,2,22,0,279,41,102,0.402,12,34,0.353,29,68,0.426,0.461,1,1,1,6,25,31,16,13,1,21,24
1183,6,2008,30,1,2,22,0,442,79,159,0.497,19,50,0.38,60,109,0.55,0.557,16,17,0.941,9,42,51,35,8,2,23,49
1183,6,2008,30,1,2,56,0,831,133,302,0.44,36,99,0.364,97,203,0.478,0.5,23,26,0.885,16,80,96,62,24,4,52,82
1187,1,1980,24,1,2,75,-1,800,188,364,0.516,2,10,0.2,186,354,0.525,0.519,63,73,0.863,21,45,66,85,35,7,38,79
1187,3,1982,26,1,2,49,0,833,158,291,0.543,1,2,0.5,157,289,0.543,0.545,59,67,0.881,5,56,61,87,26,3,27,80
1187,4,1983,27,1,2,73,4,1124,230,444,0.518,0,1,0,230,443,0.519,0.518,74,89,0.831,16,74,90,125,30,9,52,132
1187,5,1984,28,1,2,81,0,1503,312,554,0.563,1,2,0.5,311,552,0.563,0.564,56,70,0.8,17,87,104,171,46,5,63,146
1187,6,1985,29,1,2,60,5,1126,228,388,0.588,0,2,0,228,386,0.591,0.588,62,76,0.816,20,61,81,122,27,0,55,74
1187,7,1986,30,1,2,38,1,573,94,190,0.495,0,0,-1,94,190,0.495,0.495,47,49,0.959,4,53,57,39,9,3,18,42
1194,1,2000,21,1,2,30,1,446,66,171,0.386,12,45,0.267,54,126,0.429,0.421,51,70,0.729,15,23,38,27,15,4,28,28
1194,2,2001,22,1,2,57,7,929,141,336,0.42,9,46,0.196,132,290,0.455,0.433,47,69,0.681,39,92,131,69,49,10,54,92
1194,3,2002,23,1,2,55,25,1156,192,456,0.421,30,91,0.33,162,365,0.444,0.454,78,103,0.757,36,133,169,84,45,14,76,89
1194,4,2003,24,1,2,76,42,1890,277,648,0.427,56,158,0.354,221,490,0.451,0.471,127,162,0.784,62,220,282,141,71,15,108,146
1194,5,2004,25,1,2,14,4,178,25,65,0.385,4,14,0.286,21,51,0.412,0.415,10,14,0.714,4,25,29,15,10,2,19,17
1194,5,2004,25,1,2,55,26,1465,205,524,0.391,36,105,0.343,169,419,0.403,0.426,110,142,0.775,54,183,237,115,40,17,83,106
1194,5,2004,25,1,2,69,30,1643,230,589,0.39,40,119,0.336,190,470,0.404,0.424,120,156,0.769,58,208,266,130,50,19,102,123
1201,1,2014,19,1,2,52,0,533,76,167,0.455,5,36,0.139,71,131,0.542,0.47,37,55,0.673,25,62,87,20,20,11,44,45
1203,1,2005,21,1,2,82,3,2002,434,1056,0.411,134,331,0.405,300,725,0.414,0.474,233,270,0.863,55,160,215,164,53,10,186,224
1203,2,2006,22,1,2,80,47,2482,486,1152,0.422,166,382,0.435,320,770,0.416,0.494,211,268,0.787,43,176,219,240,75,5,180,238
1203,3,2007,23,1,2,82,51,2704,609,1338,0.455,155,375,0.413,454,963,0.471,0.513,380,440,0.864,35,223,258,296,64,17,249,252
1203,4,2008,24,1,2,72,27,2291,464,1069,0.434,142,346,0.41,322,723,0.445,0.5,266,293,0.908,40,181,221,213,55,8,150,171
1203,5,2009,25,1,2,82,76,2999,598,1315,0.455,173,422,0.41,425,893,0.476,0.521,330,382,0.864,52,231,283,279,71,22,200,184
1203,6,2010,26,1,2,62,17,1730,291,699,0.416,75,234,0.321,216,465,0.465,0.47,198,230,0.861,26,93,119,166,49,6,118,147
1203,7,2011,27,1,2,82,27,2131,339,770,0.44,107,266,0.402,232,504,0.46,0.51,136,160,0.85,41,154,195,171,48,16,141,178
1203,8,2012,28,1,2,52,21,1398,234,530,0.442,63,147,0.429,171,383,0.446,0.501,117,136,0.86,14,107,121,127,34,11,115,114
1203,9,2013,29,1,2,75,0,1560,310,760,0.408,113,292,0.387,197,468,0.421,0.482,107,127,0.843,18,112,130,141,35,16,136,134
1203,10,2014,30,1,2,19,0,279,37,108,0.343,8,29,0.276,29,79,0.367,0.38,17,21,0.81,3,24,27,21,10,2,21,18
1203,11,2015,31,1,2,9,0,151,20,54,0.37,4,14,0.286,16,40,0.4,0.407,14,17,0.824,2,10,12,15,0,0,10,14
1204,1,2009,20,1,2,78,65,2677,411,901,0.456,131,337,0.389,280,564,0.496,0.529,299,350,0.854,45,156,201,215,78,35,164,172
1204,2,2010,21,1,2,62,60,2229,352,784,0.449,119,321,0.371,233,463,0.503,0.525,222,299,0.742,25,135,160,186,69,14,144,96
1204,3,2011,22,1,2,56,56,2112,427,949,0.45,106,291,0.364,321,658,0.488,0.506,287,348,0.825,45,119,164,244,71,18,151,115
1204,5,2013,24,1,2,42,40,1264,235,584,0.402,56,173,0.324,179,411,0.436,0.45,187,222,0.842,10,67,77,137,45,8,117,75
1204,6,2014,25,1,2,64,64,2057,356,817,0.436,101,258,0.391,255,559,0.456,0.498,175,223,0.785,30,135,165,208,74,12,134,114
1204,7,2015,26,1,2,8,8,257,23,70,0.329,6,26,0.231,17,44,0.386,0.371,13,18,0.722,5,16,21,14,10,3,12,25
1205,1,1985,22,1,2,63,1,682,110,287,0.383,2,9,0.222,108,278,0.388,0.387,37,49,0.755,26,35,61,88,33,6,69,61
1205,2,1986,23,1,2,60,1,704,130,345,0.377,7,28,0.25,123,317,0.388,0.387,45,56,0.804,24,44,68,60,33,10,62,91
1205,3,1987,24,1,2,70,4,1130,221,545,0.406,14,48,0.292,207,497,0.416,0.418,70,95,0.737,64,62,126,139,61,13,102,106
1211,1,2012,23,1,2,40,0,419,68,174,0.391,28,75,0.373,40,99,0.404,0.471,11,12,0.917,5,26,31,20,4,0,21,32
1215,1,1994,23,1,2,70,6,889,122,305,0.4,2,25,0.08,120,280,0.429,0.403,92,110,0.836,21,65,86,66,61,4,65,54
1215,2,1995,24,1,2,50,7,775,95,223,0.426,6,28,0.214,89,195,0.456,0.439,55,73,0.753,19,43,62,66,29,6,48,76
1215,3,1996,25,1,2,8,3,128,17,32,0.531,7,14,0.5,10,18,0.556,0.641,15,17,0.882,5,10,15,11,5,0,17,16
1215,3,1996,25,1,2,45,2,485,61,161,0.379,25,68,0.368,36,93,0.387,0.457,37,51,0.725,12,30,42,41,20,1,29,48
1215,3,1996,25,1,2,53,5,613,78,193,0.404,32,82,0.39,46,111,0.414,0.487,52,68,0.765,17,40,57,52,25,1,46,64
1215,4,1997,26,1,2,28,0,197,29,80,0.363,9,31,0.29,20,49,0.408,0.419,26,40,0.65,2,11,13,11,12,1,10,12
1217,1,1992,24,1,2,78,9,1718,305,682,0.447,55,141,0.39,250,541,0.462,0.488,126,170,0.741,72,159,231,175,96,21,91,193
1217,2,1993,25,1,2,80,11,1508,256,560,0.457,42,141,0.298,214,419,0.511,0.495,96,131,0.733,61,129,190,164,86,6,120,185
1217,3,1994,26,1,2,21,0,128,21,57,0.368,3,13,0.231,18,44,0.409,0.395,13,17,0.765,4,8,12,13,4,5,5,11
1220,1,2006,23,1,2,13,0,117,14,33,0.424,0,1,0,14,32,0.438,0.424,8,9,0.889,4,13,17,3,3,2,7,23
1220,1,2006,23,1,2,22,0,175,21,54,0.389,2,10,0.2,19,44,0.432,0.407,14,15,0.933,5,22,27,7,5,2,13,31
1220,2,2007,24,1,2,14,1,165,17,40,0.425,3,11,0.273,14,29,0.483,0.463,8,9,0.889,6,15,21,5,4,1,13,25
1220,4,2009,26,1,2,52,6,684,106,256,0.414,20,66,0.303,86,190,0.453,0.453,50,62,0.806,21,75,96,33,10,4,45,82
1220,5,2010,27,1,2,70,8,804,119,240,0.496,16,50,0.32,103,190,0.542,0.529,42,65,0.646,24,111,135,23,20,10,36,94
1220,6,2011,28,1,2,59,28,959,81,200,0.405,5,21,0.238,76,179,0.425,0.418,31,38,0.816,17,106,123,40,14,1,38,106
1230,1,1998,22,1,2,30,3,472,77,202,0.381,18,46,0.391,59,156,0.378,0.426,55,65,0.846,9,36,45,34,15,11,30,73
1230,2,1999,23,1,2,30,3,337,53,182,0.291,12,42,0.286,41,140,0.293,0.324,28,37,0.757,7,21,28,12,12,1,29,30
1241,1,2010,22,1,2,20,0,115,15,39,0.385,6,22,0.273,9,17,0.529,0.462,4,6,0.667,8,9,17,5,6,3,5,9
1241,2,2012,24,1,2,66,38,1522,211,477,0.442,102,234,0.436,109,243,0.449,0.549,79,100,0.79,54,174,228,86,58,46,67,107
1241,3,2013,25,1,2,80,80,2201,297,663,0.448,177,413,0.429,120,250,0.48,0.581,67,79,0.848,36,208,244,141,92,54,94,124
1241,4,2014,26,1,2,68,59,1651,218,505,0.432,132,318,0.415,86,187,0.46,0.562,50,63,0.794,25,204,229,104,65,61,76,107
1241,5,2015,27,1,2,9,9,261,31,78,0.397,15,47,0.319,16,31,0.516,0.494,11,11,1,7,24,31,9,11,6,10,22
1242,1,2006,23,1,2,27,0,135,6,28,0.214,0,2,0,6,26,0.231,0.214,13,21,0.619,10,14,24,7,3,0,5,13
1254,1,2004,22,1,2,53,0,767,143,357,0.401,19,61,0.311,124,296,0.419,0.427,59,81,0.728,16,49,65,53,26,5,59,83
1254,2,2005,23,1,2,57,21,1066,155,423,0.366,30,105,0.286,125,318,0.393,0.402,97,125,0.776,22,111,133,100,34,6,75,121
1254,3,2006,24,1,2,10,2,153,28,66,0.424,10,19,0.526,18,47,0.383,0.5,4,5,0.8,1,14,15,5,2,0,12,13
1254,4,2007,25,1,2,74,36,1842,357,868,0.411,51,157,0.325,306,711,0.43,0.441,74,111,0.667,42,116,158,112,56,4,106,144
1254,5,2008,26,1,2,74,74,1970,379,870,0.436,51,179,0.285,328,691,0.475,0.465,112,148,0.757,32,150,182,151,54,22,109,119
1254,6,2009,27,1,2,81,60,1828,286,658,0.435,51,161,0.317,235,497,0.473,0.473,62,85,0.729,29,97,126,158,53,13,64,154
1254,7,2010,28,1,2,73,18,1553,248,543,0.457,47,136,0.346,201,407,0.494,0.5,95,114,0.833,20,109,129,152,32,11,67,135
1254,8,2011,29,1,2,77,13,1674,270,609,0.443,54,155,0.348,216,454,0.476,0.488,78,100,0.78,22,139,161,74,36,13,67,143
1254,9,2012,30,1,2,53,2,922,153,325,0.471,50,113,0.442,103,212,0.486,0.548,48,56,0.857,15,65,80,40,23,6,33,74
1254,10,2013,31,1,2,72,60,1188,178,386,0.461,71,166,0.428,107,220,0.486,0.553,23,32,0.719,17,80,97,55,29,12,31,96
1254,11,2014,32,1,2,55,9,869,102,271,0.376,41,121,0.339,61,150,0.407,0.452,28,34,0.824,12,66,78,50,22,11,34,96
1259,1,2007,27,1,2,41,0,432,61,141,0.433,18,52,0.346,43,89,0.483,0.496,27,32,0.844,2,25,27,53,17,1,18,32
1265,2,1981,27,1,2,75,-1,2616,500,1103,0.453,45,136,0.331,455,967,0.471,0.474,244,290,0.841,67,152,219,300,68,17,144,161
1265,3,1982,28,1,2,71,62,2164,376,857,0.439,28,82,0.341,348,775,0.449,0.455,165,193,0.855,57,138,195,149,44,23,96,151
1265,5,1984,30,1,2,64,3,923,178,395,0.451,15,53,0.283,163,342,0.477,0.47,75,84,0.893,30,51,81,75,27,4,45,95
1266,1,2000,25,1,2,72,47,1927,175,413,0.424,16,57,0.281,159,356,0.447,0.443,119,158,0.753,128,244,372,177,116,15,93,222
1266,3,2002,27,1,2,58,34,1383,179,359,0.499,16,54,0.296,163,305,0.534,0.521,41,49,0.837,68,161,229,106,75,12,42,142
1266,4,2003,28,1,2,74,48,1373,146,337,0.433,6,24,0.25,140,313,0.447,0.442,27,32,0.844,88,176,264,105,77,6,47,157
1266,5,2004,29,1,2,19,1,133,5,18,0.278,1,2,0.5,4,16,0.25,0.306,0,4,0,1,18,19,10,7,2,3,17
1266,7,2006,31,1,2,52,45,1245,98,204,0.48,0,2,0,98,202,0.485,0.48,41,53,0.774,75,152,227,89,51,9,39,113
1266,9,2008,33,1,2,22,2,222,24,60,0.4,0,0,-1,24,60,0.4,0.4,3,7,0.429,19,18,37,22,12,1,16,19
1266,9,2008,33,1,2,35,2,307,30,76,0.395,0,0,-1,30,76,0.395,0.395,5,9,0.556,28,31,59,27,17,2,21,27
1279,1,2006,26,1,2,12,0,108,19,38,0.5,5,15,0.333,14,23,0.609,0.566,9,14,0.643,1,16,17,9,7,0,9,14
1281,3,1982,26,1,2,81,11,1892,420,822,0.511,2,14,0.143,418,808,0.517,0.512,188,229,0.821,55,127,182,276,72,39,148,191
1281,5,1984,28,1,2,76,6,1119,166,362,0.459,2,9,0.222,164,353,0.465,0.461,64,83,0.771,24,97,121,108,43,7,71,151
1293,1,1983,22,1,2,76,32,2081,470,1008,0.466,5,25,0.2,465,983,0.473,0.469,206,282,0.73,87,173,260,280,72,10,205,248
1293,2,1984,23,1,2,82,42,2449,583,1229,0.474,4,32,0.125,579,1197,0.484,0.476,321,396,0.811,61,174,235,254,109,11,220,218
1293,3,1985,24,1,2,79,0,2101,525,1111,0.473,7,30,0.233,518,1081,0.479,0.476,205,251,0.817,57,151,208,191,71,5,154,192
1293,4,1986,25,1,2,35,0,723,203,470,0.432,0,8,0,203,462,0.439,0.432,163,198,0.823,20,48,68,67,22,5,67,86
1293,5,1987,26,1,2,49,5,924,200,491,0.407,1,10,0.1,199,481,0.414,0.408,119,155,0.768,34,49,83,79,43,8,71,113
1293,6,1988,27,1,2,67,7,1282,328,755,0.434,2,12,0.167,326,743,0.439,0.436,243,313,0.776,62,92,154,109,69,4,123,128
1293,7,1989,28,1,2,69,51,1722,448,964,0.465,1,9,0.111,447,955,0.468,0.465,217,286,0.759,69,135,204,154,90,6,122,152
1293,8,1990,29,1,2,30,2,491,97,240,0.404,1,5,0.2,96,235,0.409,0.406,52,66,0.788,18,33,51,34,12,0,34,63
1293,9,1991,30,1,2,30,0,299,73,155,0.471,0,1,0,73,154,0.474,0.471,38,62,0.613,11,21,32,16,7,1,19,25
1300,1,2004,23,1,2,56,15,1039,203,411,0.494,11,36,0.306,192,375,0.512,0.507,60,78,0.769,66,80,146,116,53,12,44,51
1300,2,2005,24,1,2,60,17,1412,220,504,0.437,7,35,0.2,213,469,0.454,0.443,98,133,0.737,87,129,216,128,83,14,86,124
1300,3,2006,25,1,2,62,29,1766,246,512,0.48,4,19,0.211,242,493,0.491,0.484,138,183,0.754,81,143,224,172,67,13,100,143
1300,4,2007,26,1,2,45,4,800,129,281,0.459,6,26,0.231,123,255,0.482,0.47,56,80,0.7,26,56,82,57,27,7,55,56
1300,5,2008,27,1,2,74,1,1546,241,561,0.43,27,102,0.265,214,459,0.466,0.454,97,139,0.698,66,146,212,137,79,18,112,121
1300,9,2012,31,1,2,38,0,484,52,143,0.364,0,10,0,52,133,0.391,0.364,17,23,0.739,16,50,66,47,21,9,28,36
1302,1,1996,25,1,2,19,18,542,83,184,0.451,34,78,0.436,49,106,0.462,0.543,55,72,0.764,12,34,46,47,15,3,37,49
1302,2,1997,26,1,2,13,9,438,73,174,0.42,22,60,0.367,51,114,0.447,0.483,48,57,0.842,8,26,34,25,15,1,22,37
1302,2,1997,26,1,2,43,33,1351,175,396,0.442,63,176,0.358,112,220,0.509,0.521,73,94,0.777,21,81,102,77,39,8,94,123
1302,2,1997,26,1,2,56,42,1789,248,570,0.435,85,236,0.36,163,334,0.488,0.51,121,151,0.801,29,107,136,102,54,9,116,160
1334,1,1993,22,1,2,50,2,815,110,251,0.438,6,19,0.316,104,232,0.448,0.45,43,54,0.796,13,43,56,83,22,4,45,71
1334,2,1994,23,1,2,56,27,1333,238,505,0.471,53,132,0.402,185,373,0.496,0.524,85,103,0.825,23,44,67,165,40,4,76,118
1334,3,1995,24,1,2,82,4,1697,296,617,0.48,131,288,0.455,165,329,0.502,0.586,97,120,0.808,30,80,110,150,35,11,87,146
1334,4,1996,25,1,2,74,14,1773,275,566,0.486,127,267,0.476,148,299,0.495,0.598,112,129,0.868,35,88,123,103,31,8,63,120
1334,5,1997,26,1,2,36,0,623,74,184,0.402,16,70,0.229,58,114,0.509,0.446,17,23,0.739,11,29,40,34,11,2,21,40
1334,6,1998,27,1,2,81,30,2378,350,767,0.456,101,230,0.439,249,537,0.464,0.522,97,116,0.836,34,135,169,157,43,5,88,117
1334,7,1999,28,1,2,50,21,1378,174,397,0.438,65,144,0.451,109,253,0.431,0.52,44,50,0.88,3,83,86,89,21,3,57,76
1334,10,2002,31,1,2,51,17,1231,146,326,0.448,57,126,0.452,89,200,0.445,0.535,16,21,0.762,7,70,77,107,28,3,44,58
1334,11,2003,32,1,2,43,1,328,31,79,0.392,12,36,0.333,19,43,0.442,0.468,5,6,0.833,6,30,36,29,5,0,11,23
1335,3,1982,26,1,2,82,70,2664,538,1153,0.467,5,27,0.185,533,1126,0.473,0.469,315,394,0.799,72,106,178,346,76,11,186,176
1335,4,1983,27,1,2,53,33,1465,258,567,0.455,5,18,0.278,253,549,0.461,0.459,164,206,0.796,37,91,128,315,43,7,114,100
1335,7,1986,30,1,2,27,7,402,46,107,0.43,1,2,0.5,45,105,0.429,0.435,51,59,0.864,2,17,19,112,13,0,38,32
1335,7,1986,30,1,2,39,0,612,102,237,0.43,2,11,0.182,100,226,0.442,0.435,67,79,0.848,6,30,36,105,24,4,40,44
1335,7,1986,30,1,2,66,7,1014,148,344,0.43,3,13,0.231,145,331,0.438,0.435,118,138,0.855,8,47,55,217,37,4,78,76
1349,2,1981,26,1,2,78,-1,2182,593,1101,0.539,7,17,0.412,586,1084,0.541,0.542,209,250,0.836,63,137,200,302,97,12,222,192
1349,4,1983,28,1,2,80,79,2491,665,1289,0.516,7,23,0.304,658,1266,0.52,0.519,184,225,0.818,63,134,197,397,117,12,188,186
1349,5,1984,29,1,2,78,70,2546,652,1274,0.512,20,87,0.23,632,1187,0.532,0.52,233,270,0.863,38,164,202,429,107,12,213,202
1349,6,1985,30,1,2,23,9,570,139,309,0.45,3,10,0.3,136,299,0.455,0.455,64,73,0.877,6,29,35,98,18,0,50,42
1349,7,1986,31,1,2,70,62,2239,624,1287,0.485,18,76,0.237,606,1211,0.5,0.492,257,305,0.843,54,149,203,361,99,3,219,153
1349,8,1987,32,1,2,79,79,2646,779,1515,0.514,21,81,0.259,758,1434,0.529,0.521,288,334,0.862,90,154,244,364,96,5,226,184
1349,10,1989,34,1,2,81,0,1857,536,1076,0.498,20,69,0.29,516,1007,0.512,0.507,175,199,0.879,41,110,151,190,72,5,132,187
1349,11,1990,35,1,2,69,0,1635,497,1033,0.481,6,46,0.13,491,987,0.497,0.484,207,227,0.912,46,133,179,155,59,9,102,160
1349,12,1991,36,1,2,32,1,439,87,195,0.446,1,3,0.333,86,192,0.448,0.449,21,23,0.913,19,39,58,41,18,0,25,42
1349,12,1991,36,1,2,39,13,1044,316,667,0.474,10,33,0.303,306,634,0.483,0.481,86,94,0.915,52,71,123,84,62,3,63,108
1349,12,1991,36,1,2,71,14,1483,403,862,0.468,11,36,0.306,392,826,0.475,0.474,107,117,0.915,71,110,181,125,80,3,88,150
1350,1,1999,19,1,2,46,1,557,81,200,0.405,2,12,0.167,79,188,0.42,0.41,45,59,0.763,40,44,84,58,30,7,54,46
1350,2,2000,20,1,2,48,4,570,94,187,0.503,0,4,0,94,183,0.514,0.503,39,51,0.765,29,54,83,62,30,8,46,39
1350,4,2003,23,1,2,79,76,3131,602,1470,0.41,74,204,0.363,528,1266,0.417,0.435,348,465,0.748,97,293,390,436,125,36,277,180
1350,5,2004,24,1,2,22,22,796,134,311,0.431,17,48,0.354,117,263,0.445,0.458,51,75,0.68,18,103,121,111,25,8,68,51
1350,6,2005,25,1,2,82,11,2696,481,1041,0.462,61,180,0.339,420,861,0.488,0.491,286,351,0.815,66,183,249,246,89,27,205,174
1350,7,2006,26,1,2,42,42,1747,329,709,0.464,40,125,0.32,289,584,0.495,0.492,129,164,0.787,40,147,187,221,49,9,115,91
1350,7,2006,26,1,2,78,78,3207,584,1304,0.448,73,242,0.302,511,1062,0.481,0.476,275,345,0.797,65,286,351,394,91,17,213,190
1350,10,2009,29,1,2,36,9,785,83,245,0.339,35,111,0.315,48,134,0.358,0.41,31,36,0.861,9,51,60,82,19,5,39,63
1359,1,2013,25,1,2,72,6,920,105,241,0.436,31,82,0.378,74,159,0.465,0.5,35,44,0.795,23,115,138,138,41,6,81,87
1369,6,1999,27,1,2,22,0,271,27,74,0.365,15,34,0.441,12,40,0.3,0.466,5,7,0.714,5,17,22,26,5,3,14,28
1369,6,1999,27,1,2,26,0,291,31,85,0.365,16,39,0.41,15,46,0.326,0.459,5,7,0.714,7,17,24,27,7,3,16,30
1370,5,2001,27,1,2,82,11,2288,383,923,0.415,54,168,0.321,329,755,0.436,0.444,185,235,0.787,76,185,261,160,75,17,101,171
1370,6,2002,28,1,2,22,16,570,60,172,0.349,20,67,0.299,40,105,0.381,0.407,22,30,0.733,20,59,79,51,22,6,19,38
1370,6,2002,28,1,2,41,1,877,166,416,0.399,47,147,0.32,119,269,0.442,0.456,56,67,0.836,38,86,124,81,31,4,40,60
1370,6,2002,28,1,2,63,17,1447,226,588,0.384,67,214,0.313,159,374,0.425,0.441,78,97,0.804,58,145,203,132,53,10,59,98
1370,8,2004,30,1,2,33,11,509,70,184,0.38,20,66,0.303,50,118,0.424,0.435,37,44,0.841,16,43,59,28,27,7,17,46
1370,9,2005,31,1,2,56,1,1340,246,591,0.416,72,202,0.356,174,389,0.447,0.477,103,136,0.757,28,102,130,104,47,3,54,123
1371,1,2014,23,1,2,72,4,1271,122,296,0.412,57,155,0.368,65,141,0.461,0.508,38,48,0.792,29,94,123,187,33,5,60,121
1385,1,2010,20,1,2,77,65,1664,255,512,0.498,4,16,0.25,251,496,0.506,0.502,148,194,0.763,66,157,223,53,43,18,62,176
1385,2,2011,21,1,2,82,82,2851,539,1154,0.467,5,52,0.096,534,1102,0.485,0.469,327,402,0.813,75,240,315,148,85,31,144,217
1385,3,2012,22,1,2,63,63,2206,381,903,0.422,24,92,0.261,357,811,0.44,0.435,268,331,0.81,40,171,211,128,48,17,123,162
1385,4,2013,23,1,2,82,82,3013,548,1231,0.445,34,120,0.283,514,1111,0.463,0.459,355,427,0.831,48,272,320,204,76,24,151,173
1385,5,2014,24,1,2,79,79,3017,604,1407,0.429,64,210,0.305,540,1197,0.451,0.452,519,630,0.824,51,292,343,313,86,28,176,197
1385,6,2015,25,1,2,10,10,340,69,167,0.413,2,11,0.182,67,156,0.429,0.419,72,87,0.828,7,35,42,25,19,1,17,18
1387,1,2004,21,1,2,76,37,1919,140,313,0.447,6,26,0.231,134,287,0.467,0.457,56,93,0.602,111,231,342,182,59,37,126,191
1387,2,2005,22,1,2,66,25,1201,124,294,0.422,9,50,0.18,115,244,0.471,0.437,57,77,0.74,54,116,170,149,37,18,87,123
1388,1,2007,24,1,2,64,19,1177,100,292,0.342,49,170,0.288,51,122,0.418,0.426,35,53,0.66,27,83,110,55,30,7,37,132
1388,2,2008,25,1,2,54,14,542,55,134,0.41,21,66,0.318,34,68,0.5,0.489,22,31,0.71,23,39,62,37,8,3,16,61
1392,1,1999,23,1,2,50,50,1558,215,462,0.465,71,164,0.433,144,298,0.483,0.542,46,72,0.639,26,57,83,95,27,11,66,90
1392,2,2000,24,1,2,82,82,3103,554,1270,0.436,119,291,0.409,435,979,0.444,0.483,269,324,0.83,78,201,279,208,116,45,165,226
1392,3,2001,25,1,2,70,69,2618,425,1020,0.417,86,230,0.374,339,790,0.429,0.459,206,270,0.763,70,159,229,233,62,27,162,207
1392,4,2002,26,1,2,4,4,124,15,48,0.313,8,21,0.381,7,27,0.259,0.396,5,6,0.833,3,9,12,9,3,1,8,12
1414,2,2004,25,1,2,71,16,1478,247,637,0.388,59,198,0.298,188,439,0.428,0.434,111,139,0.799,30,118,148,137,82,4,104,111
1414,3,2005,26,1,2,63,4,1054,186,447,0.416,48,147,0.327,138,300,0.46,0.47,87,97,0.897,32,87,119,111,43,4,68,98
1414,4,2006,27,1,2,76,42,1920,357,821,0.435,65,170,0.382,292,651,0.449,0.474,156,194,0.804,30,147,177,149,58,6,113,157
1414,5,2007,28,1,2,26,5,683,110,259,0.425,27,83,0.325,83,176,0.472,0.477,41,44,0.932,11,62,73,41,27,2,24,65
1414,5,2007,28,1,2,55,1,1243,189,444,0.426,52,143,0.364,137,301,0.455,0.484,60,72,0.833,16,69,85,82,49,7,77,112
1414,5,2007,28,1,2,81,6,1926,299,703,0.425,79,226,0.35,220,477,0.461,0.482,101,116,0.871,27,131,158,123,76,9,101,177
1421,3,2003,22,1,2,55,1,969,128,329,0.389,50,139,0.36,78,190,0.411,0.465,44,57,0.772,9,63,72,89,24,6,60,93
1421,7,2007,26,1,2,66,2,1435,188,458,0.41,31,96,0.323,157,362,0.434,0.444,114,141,0.809,22,64,86,112,52,15,72,125
1421,12,2012,31,1,2,46,2,662,66,163,0.405,27,81,0.333,39,82,0.476,0.488,23,31,0.742,3,36,39,51,13,2,34,57
1425,1,1982,25,1,2,64,9,1031,181,389,0.465,18,59,0.305,163,330,0.494,0.488,67,102,0.657,27,63,90,146,48,9,92,147
1428,2,2011,24,1,2,81,9,1971,314,755,0.416,143,383,0.373,171,372,0.46,0.511,85,107,0.794,65,179,244,244,89,4,89,177
1435,6,2014,27,1,2,76,75,2668,552,1093,0.505,122,299,0.408,430,794,0.542,0.561,316,416,0.76,69,176,245,447,104,22,213,206
1435,7,2015,28,1,2,10,10,325,58,126,0.46,9,31,0.29,49,95,0.516,0.496,25,29,0.862,6,25,31,28,9,1,17,19
1439,1,1997,23,1,2,15,0,132,13,43,0.302,0,9,0,13,34,0.382,0.302,10,14,0.714,12,10,22,6,3,2,6,10
1441,1,1984,21,1,2,82,3,1408,252,559,0.451,1,4,0.25,251,555,0.452,0.452,123,169,0.728,112,123,235,153,107,29,123,209
1441,2,1985,22,1,2,80,43,2555,573,1161,0.494,8,37,0.216,565,1124,0.503,0.497,223,294,0.759,217,259,476,441,177,68,223,265
1441,3,1986,23,1,2,75,58,2576,542,1142,0.475,12,60,0.2,530,1082,0.49,0.48,293,381,0.769,171,250,421,600,197,46,282,270
1441,4,1987,24,1,2,82,82,3114,707,1408,0.502,11,47,0.234,696,1361,0.511,0.506,357,470,0.76,227,291,518,566,204,71,253,281
1441,5,1988,25,1,2,81,80,3060,849,1679,0.506,11,52,0.212,838,1627,0.515,0.509,476,587,0.811,261,272,533,467,203,52,236,250
1441,6,1989,26,1,2,78,78,3064,829,1672,0.496,27,104,0.26,802,1568,0.511,0.504,438,548,0.799,289,326,615,450,213,54,250,269
1441,7,1990,27,1,2,73,73,2683,670,1357,0.494,30,106,0.283,640,1251,0.512,0.505,333,430,0.774,208,299,507,432,145,51,191,222
1441,8,1991,28,1,2,82,82,2852,645,1338,0.482,61,191,0.319,584,1147,0.509,0.505,416,524,0.794,212,334,546,493,144,60,232,226
1441,9,1992,29,1,2,76,76,2751,694,1476,0.47,114,338,0.337,580,1138,0.51,0.509,401,505,0.794,166,334,500,512,138,70,240,229
1441,11,1994,31,1,2,68,68,2334,473,1105,0.428,71,219,0.324,402,886,0.454,0.46,286,368,0.777,154,291,445,333,98,34,167,202
1441,12,1995,32,1,2,35,34,1300,266,526,0.506,60,168,0.357,206,358,0.575,0.563,157,194,0.809,68,178,246,154,62,23,89,89
1441,12,1995,32,1,2,41,41,1428,305,712,0.428,87,240,0.363,218,472,0.462,0.489,207,248,0.835,84,150,234,208,74,22,97,117
1441,12,1995,32,1,2,76,75,2728,571,1238,0.461,147,408,0.36,424,830,0.511,0.521,364,442,0.824,152,328,480,362,136,45,186,206
1441,13,1996,33,1,2,52,51,1997,331,764,0.433,78,235,0.332,253,529,0.478,0.484,265,338,0.784,97,276,373,302,105,24,134,153
1441,14,1997,34,1,2,62,62,2271,397,899,0.442,119,335,0.355,278,564,0.493,0.508,201,268,0.75,118,255,373,354,119,36,156,151
1441,15,1998,35,1,2,70,70,2473,452,1059,0.427,106,334,0.317,346,725,0.477,0.477,277,346,0.801,105,241,346,382,126,42,189,193
1451,5,2012,26,1,2,65,60,2020,312,643,0.485,80,209,0.383,232,434,0.535,0.547,119,164,0.726,95,206,301,112,49,19,72,107
1451,8,2015,29,1,2,9,8,182,15,42,0.357,5,18,0.278,10,24,0.417,0.417,3,4,0.75,3,14,17,11,5,2,5,11
1452,1,1980,23,1,2,67,-1,1331,282,598,0.472,15,53,0.283,267,545,0.49,0.484,45,66,0.682,29,69,98,117,41,11,79,102
1452,2,1981,24,1,2,32,0,114,30,73,0.411,6,10,0.6,24,63,0.381,0.452,13,14,0.929,2,3,5,6,5,0,10,8
1452,2,1981,24,1,2,50,0,451,104,234,0.444,8,16,0.5,96,218,0.44,0.462,31,41,0.756,17,27,44,36,17,4,35,27
1452,3,1982,25,1,2,21,0,146,34,77,0.442,0,1,0,34,76,0.447,0.442,4,12,0.333,6,9,15,12,3,1,2,9
1453,1,1986,22,1,2,82,45,1957,287,597,0.481,5,16,0.313,282,581,0.485,0.485,190,238,0.798,60,59,119,390,66,11,158,200
1453,2,1987,23,1,2,79,75,2439,369,749,0.493,9,22,0.409,360,727,0.495,0.499,184,246,0.748,50,117,167,352,83,5,171,194
1453,3,1988,24,1,2,82,82,2732,453,960,0.472,4,19,0.211,449,941,0.477,0.474,251,308,0.815,63,137,200,387,87,15,172,155
1453,4,1989,25,1,2,69,67,2408,456,903,0.505,14,29,0.483,442,874,0.506,0.513,260,306,0.85,57,115,172,390,63,5,178,103
1453,5,1990,26,1,2,75,71,2578,508,1058,0.48,22,55,0.4,486,1003,0.485,0.491,297,330,0.9,60,152,212,368,63,2,145,129
1453,6,1991,27,1,2,80,80,3046,622,1292,0.481,14,45,0.311,608,1247,0.488,0.487,371,417,0.89,62,125,187,443,89,7,189,135
1453,7,1992,28,1,2,82,82,3192,587,1311,0.448,49,120,0.408,538,1191,0.452,0.466,412,475,0.867,82,106,188,375,71,12,193,145
1453,8,1993,29,1,2,77,77,3094,677,1454,0.466,112,299,0.375,565,1155,0.489,0.504,343,397,0.864,63,85,148,308,78,7,138,141
1453,9,1994,30,1,2,69,69,2591,505,1118,0.452,124,320,0.388,381,798,0.477,0.507,276,330,0.836,35,116,151,261,63,4,159,118
1453,10,1995,31,1,2,67,67,2544,417,970,0.43,103,338,0.305,314,632,0.497,0.483,277,344,0.805,47,111,158,368,72,7,219,153
1453,12,1997,33,1,2,79,79,2923,385,875,0.44,166,384,0.432,219,491,0.446,0.535,222,256,0.867,38,153,191,318,57,1,128,97
1453,13,1998,34,1,2,72,72,2326,329,791,0.416,158,426,0.371,171,365,0.468,0.516,127,154,0.825,14,90,104,253,44,2,84,99
1453,14,1999,35,1,2,38,38,1116,144,350,0.411,89,221,0.403,55,129,0.426,0.539,51,61,0.836,12,56,68,134,23,2,53,51
1458,1,1995,22,1,2,58,0,613,96,250,0.384,22,73,0.301,74,177,0.418,0.428,50,77,0.649,32,30,62,57,13,4,50,78
1458,2,1996,23,1,2,67,12,1284,274,655,0.418,74,207,0.357,200,448,0.446,0.475,154,257,0.599,58,57,115,99,42,13,77,128
1458,3,1997,24,1,2,18,0,227,27,77,0.351,3,24,0.125,24,53,0.453,0.37,15,23,0.652,3,11,14,22,10,1,15,36
1458,3,1997,24,1,2,24,1,278,33,96,0.344,4,28,0.143,29,68,0.426,0.365,16,25,0.64,3,13,16,25,10,2,16,45
1459,1,1980,24,1,2,82,-1,1841,240,551,0.436,0,3,0,240,548,0.438,0.436,84,111,0.757,132,192,324,147,102,31,91,145
1459,2,1981,25,1,2,82,-1,1427,146,354,0.412,0,2,0,146,352,0.415,0.412,79,121,0.653,133,168,301,81,66,29,56,141
1459,3,1982,26,1,2,82,80,2519,258,504,0.512,0,1,0,258,503,0.513,0.512,153,215,0.712,211,348,559,188,135,36,123,210
1459,4,1983,27,1,2,82,80,2640,254,527,0.482,0,1,0,254,526,0.483,0.482,119,163,0.73,231,384,615,189,147,25,113,218
1459,5,1984,28,1,2,80,74,2705,174,370,0.47,0,1,0,174,369,0.472,0.47,106,145,0.731,195,379,574,228,173,32,97,233
1459,6,1985,29,1,2,81,81,2290,175,358,0.489,0,2,0,175,356,0.492,0.489,84,116,0.724,169,216,385,153,140,14,65,213
1459,7,1986,30,1,2,82,82,2401,172,379,0.454,0,1,0,172,378,0.455,0.454,68,88,0.773,143,234,377,171,155,16,51,228
1459,8,1987,31,1,2,81,53,1932,118,276,0.428,0,2,0,118,274,0.431,0.428,36,55,0.655,91,174,265,147,100,21,33,160
1459,9,1988,32,1,2,82,1,1534,70,156,0.449,0,1,0,70,155,0.452,0.449,40,52,0.769,110,130,240,87,101,11,26,152
1459,10,1989,33,1,2,34,1,321,12,35,0.343,0,0,-1,12,35,0.343,0.343,9,12,0.75,30,30,60,25,12,1,6,35
1459,12,1991,35,1,2,17,3,217,21,47,0.447,1,4,0.25,20,43,0.465,0.457,9,10,0.9,20,22,42,24,12,1,7,30
1462,5,2007,26,1,2,43,43,1529,218,480,0.454,34,120,0.283,184,360,0.511,0.49,133,168,0.792,44,200,244,111,46,10,78,120
1462,5,2007,26,1,2,82,49,2580,384,850,0.452,70,224,0.313,314,626,0.502,0.493,211,269,0.784,84,347,431,228,84,22,149,203
1462,6,2008,27,1,2,82,82,2953,532,1117,0.476,165,389,0.424,367,728,0.504,0.55,336,403,0.834,59,365,424,288,86,31,190,208
1462,7,2009,28,1,2,18,14,495,93,232,0.401,32,90,0.356,61,142,0.43,0.47,53,65,0.815,14,54,68,44,12,9,38,36
1462,9,2011,30,1,2,61,44,1683,240,520,0.462,102,254,0.402,138,266,0.519,0.56,100,125,0.8,28,248,276,105,40,30,69,107
1463,1,2008,19,1,2,80,80,2768,587,1366,0.43,59,205,0.288,528,1161,0.455,0.451,391,448,0.873,70,278,348,192,78,75,232,122
1489,1,2008,27,1,2,82,30,2117,308,766,0.402,156,432,0.361,152,334,0.455,0.504,124,146,0.849,34,176,210,177,48,1,134,94
1493,1,2014,22,1,2,24,0,142,8,39,0.205,3,18,0.167,5,21,0.238,0.244,7,8,0.875,3,12,15,13,0,1,13,13
1497,1,2011,26,1,2,80,1,1685,285,632,0.451,129,308,0.419,156,324,0.481,0.553,84,104,0.808,21,175,196,96,27,4,78,148
1497,2,2012,27,1,2,56,7,1206,212,486,0.436,83,198,0.419,129,288,0.448,0.522,50,64,0.781,12,106,118,117,27,2,60,75
1497,3,2013,28,1,2,68,17,1484,246,597,0.412,89,251,0.355,157,346,0.454,0.487,64,74,0.865,13,130,143,129,30,2,69,93
1497,4,2014,29,1,2,22,1,507,85,194,0.438,28,69,0.406,57,125,0.456,0.51,49,51,0.961,2,38,40,37,11,0,25,39
1497,4,2014,29,1,2,30,2,607,108,277,0.39,40,111,0.36,68,166,0.41,0.462,45,54,0.833,8,42,50,46,7,0,39,26
1497,4,2014,29,1,2,52,3,1114,193,471,0.41,68,180,0.378,125,291,0.43,0.482,94,105,0.895,10,80,90,83,18,0,64,65
1497,5,2015,30,1,2,10,0,248,39,98,0.398,12,28,0.429,27,70,0.386,0.459,32,36,0.889,4,29,33,19,6,0,11,16
1501,1,1997,24,1,2,10,0,113,16,37,0.432,0,6,0,16,31,0.516,0.432,8,10,0.8,3,5,8,17,9,0,8,12
1503,2,2000,24,1,2,73,39,2317,364,915,0.398,94,281,0.335,270,634,0.426,0.449,151,191,0.791,82,193,275,121,75,31,102,205
1503,3,2001,25,1,2,14,12,333,40,123,0.325,10,46,0.217,30,77,0.39,0.366,18,23,0.783,16,26,42,11,10,4,10,28
1509,1,1993,25,1,2,33,1,311,42,113,0.372,1,8,0.125,41,105,0.39,0.376,34,60,0.567,19,18,37,57,23,1,32,42
1513,1,1980,31,1,2,78,-1,2510,611,1329,0.46,45,152,0.296,566,1177,0.481,0.477,367,415,0.884,101,163,264,314,115,4,231,195
1513,2,1981,32,1,2,79,-1,2911,632,1272,0.497,10,30,0.333,622,1242,0.501,0.501,414,466,0.888,78,141,219,299,87,9,248,237
1513,3,1982,33,1,2,76,32,1507,286,615,0.465,7,23,0.304,279,592,0.471,0.471,126,147,0.857,36,55,91,170,33,3,104,194
1514,10,1996,32,1,2,82,82,2690,321,649,0.495,61,162,0.377,260,487,0.534,0.542,186,232,0.802,66,134,200,154,90,15,108,257
1514,15,2001,37,1,2,82,17,2049,291,695,0.419,59,176,0.335,232,519,0.447,0.461,254,297,0.855,34,142,176,115,63,10,106,229
1516,5,2005,30,1,2,74,69,1832,182,424,0.429,19,53,0.358,163,371,0.439,0.452,55,69,0.797,78,142,220,91,50,18,61,144
1516,6,2006,31,1,2,36,3,353,17,57,0.298,3,13,0.231,14,44,0.318,0.325,11,16,0.688,21,35,56,9,5,10,12,47
1516,8,2008,33,1,2,41,13,650,71,158,0.449,15,45,0.333,56,113,0.496,0.497,20,26,0.769,41,73,114,14,27,7,31,64
1516,8,2008,33,1,2,49,13,698,76,174,0.437,16,49,0.327,60,125,0.48,0.483,20,26,0.769,47,78,125,18,28,8,34,69
1518,2,1982,23,1,2,80,1,1322,252,555,0.454,0,5,0,252,550,0.458,0.454,85,150,0.567,67,94,161,89,66,4,101,184
1518,3,1983,24,1,2,9,2,148,26,59,0.441,0,1,0,26,58,0.448,0.441,11,17,0.647,8,18,26,11,6,0,11,17
1548,1,2005,21,1,2,82,82,2686,269,546,0.493,47,142,0.331,222,404,0.55,0.536,156,210,0.743,89,375,464,246,138,48,139,204
1548,3,2007,23,1,2,76,76,3062,443,991,0.447,48,155,0.31,395,836,0.472,0.471,452,551,0.82,77,357,434,432,152,33,261,200
1548,9,2013,29,1,2,80,80,2779,396,879,0.451,91,287,0.317,305,592,0.515,0.502,155,270,0.574,82,341,423,433,139,52,206,127
1548,11,2015,31,1,2,9,0,256,19,52,0.365,4,20,0.2,15,32,0.469,0.404,6,13,0.462,6,21,27,26,9,1,15,15
1560,5,2009,27,1,2,71,0,861,69,208,0.332,39,114,0.342,30,94,0.319,0.425,34,43,0.791,19,57,76,43,36,7,23,76
1560,6,2010,28,1,2,26,0,236,26,55,0.473,12,24,0.5,14,31,0.452,0.582,6,7,0.857,5,21,26,17,10,2,5,25
1560,6,2010,28,1,2,44,0,326,35,83,0.422,14,35,0.4,21,48,0.438,0.506,9,12,0.75,6,28,34,27,19,2,11,39
1560,7,2011,29,1,2,25,0,155,16,38,0.421,7,16,0.438,9,22,0.409,0.513,2,2,1,2,14,16,7,6,1,5,17
1560,8,2012,30,1,2,34,0,354,26,73,0.356,18,53,0.34,8,20,0.4,0.479,1,8,0.125,1,23,24,10,14,0,9,36
1560,9,2013,31,1,2,53,5,698,62,144,0.431,37,88,0.42,25,56,0.446,0.559,9,16,0.563,16,41,57,32,23,3,20,73
1561,2,1998,22,1,2,80,80,3150,649,1407,0.461,70,235,0.298,579,1172,0.494,0.486,390,535,0.729,86,210,296,494,176,25,244,200
1561,3,1999,23,1,2,48,48,1990,435,1056,0.412,58,199,0.291,377,857,0.44,0.439,356,474,0.751,66,170,236,223,110,7,167,98
1561,4,2000,24,1,2,70,70,2853,729,1733,0.421,89,261,0.341,640,1472,0.435,0.446,442,620,0.713,71,196,267,328,144,5,230,162
1561,5,2001,25,1,2,71,71,2979,762,1813,0.42,98,306,0.32,664,1507,0.441,0.447,585,719,0.814,50,223,273,325,178,20,237,147
1561,6,2002,26,1,2,60,59,2622,665,1669,0.398,78,268,0.291,587,1401,0.419,0.422,475,585,0.812,44,225,269,331,168,13,237,102
1561,7,2003,27,1,2,82,82,3485,804,1940,0.414,84,303,0.277,720,1637,0.44,0.436,570,736,0.774,68,276,344,454,225,13,286,149
1561,8,2004,28,1,2,48,47,2040,435,1125,0.387,57,199,0.286,378,926,0.408,0.412,339,455,0.745,34,144,178,324,115,5,209,87
1561,11,2007,31,1,2,50,49,2121,430,947,0.454,50,144,0.347,380,803,0.473,0.48,331,436,0.759,16,136,152,359,90,12,202,74
1561,11,2007,31,1,2,65,64,2761,581,1313,0.442,62,197,0.315,519,1116,0.465,0.466,485,610,0.795,23,170,193,468,123,13,268,95
1561,12,2008,32,1,2,82,82,3424,712,1556,0.458,95,275,0.345,617,1281,0.482,0.488,645,797,0.809,47,196,243,586,160,12,245,109
1561,13,2009,33,1,2,3,3,123,18,40,0.45,2,8,0.25,16,32,0.5,0.475,18,25,0.72,3,5,8,20,3,1,10,3
1561,14,2010,34,1,2,25,24,798,121,290,0.417,8,24,0.333,113,266,0.425,0.431,98,119,0.824,15,60,75,102,18,2,57,43
1561,14,2010,34,1,2,28,24,865,136,316,0.43,9,25,0.36,127,291,0.436,0.445,104,131,0.794,16,63,79,113,19,2,64,48
1566,1,2006,26,1,2,19,0,135,14,41,0.341,3,12,0.25,11,29,0.379,0.378,13,15,0.867,3,7,10,5,7,0,8,10
1567,1,1980,22,1,2,27,-1,155,21,50,0.42,0,1,0,21,49,0.429,0.42,9,18,0.5,7,15,22,20,4,0,9,16
1567,1,1980,22,1,2,23,-1,526,77,149,0.517,0,4,0,77,145,0.531,0.517,29,33,0.879,25,24,49,33,20,3,26,34
1567,1,1980,22,1,2,50,-1,681,98,199,0.492,0,5,0,98,194,0.505,0.492,38,51,0.745,32,39,71,53,24,3,35,50
1567,2,1981,23,1,2,62,-1,1666,278,600,0.463,0,9,0,278,591,0.47,0.463,79,123,0.642,92,137,229,162,55,7,70,114
1567,2,1981,23,1,2,65,-1,1682,279,606,0.46,0,9,0,279,597,0.467,0.46,80,125,0.64,92,138,230,163,56,7,70,117
1567,3,1982,24,1,2,13,3,150,19,59,0.322,0,2,0,19,57,0.333,0.322,6,8,0.75,8,10,18,14,5,1,4,6
1577,3,2002,22,1,2,63,52,1615,235,530,0.443,46,139,0.331,189,391,0.483,0.487,201,251,0.801,54,177,231,112,41,19,116,155
1577,4,2003,23,1,2,64,57,2006,343,773,0.444,62,177,0.35,281,596,0.471,0.484,325,405,0.802,77,245,322,123,55,16,147,194
1577,6,2005,25,1,2,66,60,2436,425,986,0.431,51,168,0.304,374,818,0.457,0.457,563,657,0.857,70,324,394,225,70,8,195,191
1586,1,1989,23,1,2,54,5,1354,181,432,0.419,27,82,0.329,154,350,0.44,0.45,78,127,0.614,62,147,209,130,63,14,48,139
1586,2,1990,24,1,2,73,23,2244,296,698,0.424,19,80,0.238,277,618,0.448,0.438,198,260,0.762,144,286,430,188,100,32,82,177
1586,5,1993,27,1,2,82,82,3199,509,1096,0.464,167,438,0.381,342,658,0.52,0.541,203,261,0.778,120,263,383,311,138,33,133,180
1586,6,1994,28,1,2,80,76,3207,476,1138,0.418,192,503,0.382,284,635,0.447,0.503,176,238,0.739,120,229,349,275,129,43,137,153
1586,10,1998,32,1,2,72,22,1928,184,439,0.419,111,295,0.376,73,144,0.507,0.546,40,51,0.784,48,220,268,157,68,15,65,139
1586,11,1999,33,1,2,48,48,1624,118,298,0.396,68,203,0.335,50,95,0.526,0.51,33,46,0.717,21,187,208,150,38,7,55,100
1586,12,2000,34,1,2,69,69,2308,170,422,0.403,110,304,0.362,60,118,0.508,0.533,56,69,0.812,27,306,333,206,89,17,62,156
1586,13,2001,35,1,2,53,19,1306,87,259,0.336,57,181,0.315,30,78,0.385,0.446,36,44,0.818,20,146,166,88,53,15,35,98
1586,14,2002,36,1,2,65,1,1180,99,289,0.343,79,235,0.336,20,54,0.37,0.479,23,39,0.59,28,148,176,90,48,15,35,104
1593,1,1984,22,1,2,81,2,1976,408,918,0.444,24,74,0.324,384,844,0.455,0.458,142,172,0.826,57,98,155,151,23,13,110,162
1593,2,1985,23,1,2,76,61,2613,605,1213,0.499,15,72,0.208,590,1141,0.517,0.505,211,250,0.844,60,146,206,184,52,9,107,176
1593,3,1986,24,1,2,80,80,2992,735,1522,0.483,3,17,0.176,732,1505,0.486,0.484,322,371,0.868,66,222,288,191,70,12,168,180
1593,4,1987,25,1,2,80,79,2763,689,1509,0.457,4,26,0.154,685,1483,0.462,0.458,376,425,0.885,50,168,218,298,75,13,182,154
1593,5,1988,26,1,2,80,80,2655,648,1360,0.476,10,24,0.417,638,1336,0.478,0.48,335,380,0.882,44,162,206,237,51,13,172,198
1593,6,1989,27,1,2,76,75,2418,677,1410,0.48,1,19,0.053,676,1391,0.486,0.48,296,340,0.871,55,124,179,219,39,14,165,155
1593,7,1990,28,1,2,75,74,2567,781,1592,0.491,1,6,0.167,780,1586,0.492,0.491,257,293,0.877,54,152,206,243,48,6,125,116
1593,8,1991,29,1,2,69,69,2466,525,1034,0.508,1,6,0.167,524,1028,0.51,0.508,231,252,0.917,36,170,206,143,50,6,108,128
1593,9,1992,30,1,2,81,81,2922,691,1353,0.511,1,12,0.083,690,1341,0.515,0.511,256,285,0.898,49,184,233,180,56,5,140,126
1593,10,1993,31,1,2,79,59,2558,595,1205,0.494,3,9,0.333,592,1196,0.495,0.495,236,277,0.852,31,142,173,128,42,4,125,117
1593,11,1994,32,1,2,27,23,903,187,389,0.481,4,6,0.667,183,383,0.478,0.486,76,94,0.809,23,61,84,59,14,0,28,46
1593,11,1994,32,1,2,50,50,1657,338,692,0.488,3,6,0.5,335,686,0.488,0.491,129,153,0.843,28,87,115,66,26,5,57,77
1593,11,1994,32,1,2,77,73,2560,525,1081,0.486,7,12,0.583,518,1069,0.485,0.489,205,247,0.83,51,148,199,125,40,5,85,123
1593,12,1995,33,1,2,19,19,660,144,284,0.507,11,28,0.393,133,256,0.52,0.526,51,59,0.864,11,44,55,29,15,0,29,35
1593,13,1996,34,1,2,7,0,103,13,33,0.394,0,0,-1,13,33,0.394,0.394,5,6,0.833,0,8,8,7,3,0,3,6
1593,13,1996,34,1,2,25,3,407,63,160,0.394,5,16,0.313,58,144,0.403,0.409,24,26,0.923,8,24,32,19,13,0,19,19
1593,13,1996,34,1,2,32,3,510,76,193,0.394,5,16,0.313,71,177,0.401,0.407,29,32,0.906,8,32,40,26,16,0,22,25
1602,1,1980,32,1,2,26,4,442,123,249,0.494,3,4,0.75,120,245,0.49,0.5,50,55,0.909,10,28,38,29,9,2,37,49
1602,1,1980,32,1,2,17,-1,522,121,294,0.412,7,11,0.636,114,283,0.403,0.423,41,50,0.82,7,33,40,54,15,4,45,30
1602,1,1980,32,1,2,43,4,964,244,543,0.449,10,15,0.667,234,528,0.443,0.459,91,105,0.867,17,61,78,83,24,6,82,79
1612,2,2007,24,1,2,40,2,361,32,89,0.36,4,18,0.222,28,71,0.394,0.382,31,45,0.689,8,21,29,13,12,5,19,22
1619,3,2011,26,1,2,52,1,542,71,182,0.39,39,99,0.394,32,83,0.386,0.497,28,40,0.7,20,54,74,18,18,6,16,52
1624,1,1990,23,1,2,69,23,1351,170,414,0.411,2,15,0.133,168,399,0.421,0.413,91,129,0.705,78,81,159,44,41,16,47,97
1629,2,2006,22,1,2,72,41,1913,262,546,0.48,66,179,0.369,196,367,0.534,0.54,188,222,0.847,58,203,261,97,55,9,81,138
1629,3,2007,23,1,2,80,80,2818,505,1067,0.473,127,333,0.381,378,734,0.515,0.533,481,570,0.844,69,273,342,173,98,11,135,181
1629,4,2008,24,1,2,61,57,2216,417,914,0.456,107,266,0.402,310,648,0.478,0.515,502,578,0.869,48,225,273,129,62,5,131,150
1629,5,2009,25,1,2,51,46,1947,341,811,0.42,115,277,0.415,226,534,0.423,0.491,457,527,0.867,29,154,183,138,61,8,146,116
1629,6,2010,26,1,2,22,21,774,135,339,0.398,39,110,0.355,96,229,0.419,0.456,127,155,0.819,20,74,94,57,23,4,35,51
1629,6,2010,26,1,2,24,22,859,154,354,0.435,31,100,0.31,123,254,0.484,0.479,171,185,0.924,9,61,70,54,23,2,57,45
1629,6,2010,26,1,2,46,43,1633,289,693,0.417,70,210,0.333,219,483,0.453,0.468,298,340,0.876,29,135,164,111,46,6,92,96
1629,7,2011,27,1,2,80,80,2603,553,1267,0.436,176,459,0.383,377,808,0.467,0.506,594,669,0.888,28,230,258,198,80,15,184,155
1629,8,2012,28,1,2,40,40,1264,222,537,0.413,78,225,0.347,144,312,0.462,0.486,160,179,0.894,13,93,106,110,28,3,70,70
1629,9,2013,29,1,2,77,0,2136,350,778,0.45,158,371,0.426,192,407,0.472,0.551,219,246,0.89,31,147,178,106,72,8,101,138
1629,10,2014,30,1,2,68,68,2177,440,1023,0.43,115,297,0.387,325,726,0.448,0.486,303,340,0.891,34,169,203,121,66,6,106,123
1629,11,2015,31,1,2,8,7,233,44,100,0.44,19,43,0.442,25,57,0.439,0.535,40,42,0.952,4,25,29,15,4,0,15,20
1636,9,2009,31,1,2,39,19,1064,124,285,0.435,0,3,0,124,282,0.44,0.435,46,85,0.541,41,116,157,46,15,30,56,96
1637,1,2010,23,1,2,82,48,2025,273,565,0.483,63,165,0.382,210,400,0.525,0.539,160,193,0.829,50,141,191,124,64,15,93,152
1637,2,2011,24,1,2,82,69,2758,440,979,0.449,154,378,0.407,286,601,0.476,0.528,266,315,0.844,48,210,258,164,102,9,138,195
1637,3,2012,25,1,2,66,53,2228,314,763,0.412,129,337,0.383,185,426,0.434,0.496,147,171,0.86,56,168,224,113,96,15,73,148
1637,4,2013,26,1,2,69,69,2403,352,808,0.436,169,425,0.398,183,383,0.478,0.54,149,187,0.797,35,156,191,174,90,18,109,172
1637,5,2014,27,1,2,82,82,2780,445,1009,0.441,201,511,0.393,244,498,0.49,0.541,252,301,0.837,51,238,289,197,76,14,110,176
1637,6,2015,28,1,2,10,10,328,58,129,0.45,27,78,0.346,31,51,0.608,0.554,19,26,0.731,10,32,42,27,8,3,12,24
1645,1,1989,23,1,2,79,36,2065,357,827,0.432,32,129,0.248,325,698,0.466,0.451,181,243,0.745,49,153,202,301,86,8,178,136
1645,2,1990,24,1,2,30,10,869,142,321,0.442,13,53,0.245,129,268,0.481,0.463,77,116,0.664,15,72,87,150,42,5,72,69
1645,2,1990,24,1,2,49,2,1118,133,306,0.435,15,52,0.288,118,254,0.465,0.459,59,95,0.621,35,106,141,146,42,5,71,79
1645,2,1990,24,1,2,79,12,1987,275,627,0.439,28,105,0.267,247,522,0.473,0.461,136,211,0.645,50,178,228,296,84,10,143,148
1645,3,1991,25,1,2,82,79,2870,504,1247,0.404,172,510,0.337,332,737,0.45,0.473,217,296,0.733,41,197,238,303,127,15,171,179
1645,4,1992,26,1,2,80,80,2700,502,1216,0.413,162,473,0.342,340,743,0.458,0.479,206,267,0.772,37,206,243,326,104,28,178,200
1645,5,1993,27,1,2,71,68,2251,349,858,0.407,120,361,0.332,229,497,0.461,0.477,164,228,0.719,29,192,221,297,86,8,140,124
1645,6,1994,28,1,2,75,73,2571,380,976,0.389,120,403,0.298,260,573,0.454,0.451,143,191,0.749,42,187,229,380,125,20,185,143
1645,7,1995,29,1,2,64,54,2038,306,777,0.394,143,441,0.324,163,336,0.485,0.486,99,144,0.688,18,146,164,274,75,13,137,157
1645,9,1997,31,1,2,72,31,2068,340,906,0.375,115,372,0.309,225,534,0.421,0.439,134,180,0.744,27,132,159,153,87,19,121,168
1645,10,1998,32,1,2,11,0,169,26,78,0.333,6,26,0.231,20,52,0.385,0.372,23,26,0.885,5,8,13,12,2,1,12,20
1645,10,1998,32,1,2,31,0,467,77,180,0.428,31,86,0.36,46,94,0.489,0.514,25,34,0.735,9,35,44,40,14,3,28,51
1645,10,1998,32,1,2,42,0,636,103,258,0.399,37,112,0.33,66,146,0.452,0.471,48,60,0.8,14,43,57,52,16,4,40,71
1645,11,1999,33,1,2,46,1,1007,164,421,0.39,80,231,0.346,84,190,0.442,0.485,84,114,0.737,13,72,85,76,30,3,67,111
1645,12,2000,34,1,2,47,0,989,169,490,0.345,67,223,0.3,102,267,0.382,0.413,108,148,0.73,15,64,79,75,38,9,53,83
1647,1,1992,23,1,2,21,0,215,28,94,0.298,14,39,0.359,14,55,0.255,0.372,20,30,0.667,3,12,15,32,14,1,28,32
1647,1,1992,23,1,2,24,0,255,30,99,0.303,15,41,0.366,15,58,0.259,0.379,24,36,0.667,3,13,16,35,16,2,31,41
1654,4,2013,25,1,2,27,0,572,70,166,0.422,19,50,0.38,51,116,0.44,0.479,28,41,0.683,4,24,28,109,12,1,48,36
1658,1,2009,21,1,2,82,82,3120,562,1283,0.438,145,378,0.384,417,905,0.461,0.495,247,281,0.879,56,252,308,262,91,13,226,204
1658,2,2010,22,1,2,82,82,3113,542,1183,0.458,136,355,0.383,406,828,0.49,0.516,212,262,0.809,61,250,311,242,98,17,176,174
1658,3,2011,23,1,2,71,17,1869,304,747,0.407,96,264,0.364,208,483,0.431,0.471,99,131,0.756,35,135,170,145,73,26,99,127
1658,4,2012,24,1,2,66,0,1771,300,736,0.408,100,275,0.364,200,461,0.434,0.476,133,172,0.773,30,180,210,169,71,23,124,137
1658,5,2013,25,1,2,82,82,2913,461,1026,0.449,142,349,0.407,319,677,0.471,0.519,191,233,0.82,36,255,291,361,93,23,210,195
1658,6,2014,26,1,2,52,23,1346,224,550,0.407,84,227,0.37,140,323,0.433,0.484,76,88,0.864,24,100,124,113,28,13,95,111
1658,7,2015,27,1,2,9,0,222,36,93,0.387,14,44,0.318,22,49,0.449,0.462,17,21,0.81,6,15,21,31,8,2,14,22
1660,1,2006,21,1,2,79,12,1362,241,535,0.45,67,180,0.372,174,355,0.49,0.513,78,106,0.736,29,114,143,63,44,22,86,176
1660,2,2007,22,1,2,37,0,554,62,177,0.35,20,75,0.267,42,102,0.412,0.407,40,58,0.69,14,33,47,38,26,7,40,71
1660,3,2008,23,1,2,75,24,2020,428,944,0.453,142,349,0.407,286,595,0.481,0.529,116,155,0.748,50,156,206,162,66,18,172,234
1660,4,2009,24,1,2,24,1,465,87,196,0.444,25,70,0.357,62,126,0.492,0.508,47,60,0.783,10,37,47,36,20,8,19,40
1660,4,2009,24,1,2,34,2,636,105,292,0.36,38,119,0.319,67,173,0.387,0.425,60,81,0.741,11,52,63,32,27,6,45,63
1660,4,2009,24,1,2,58,3,1101,192,488,0.393,63,189,0.333,129,299,0.431,0.458,107,141,0.759,21,89,110,68,47,14,64,103
1674,1,2014,22,1,2,38,0,476,74,178,0.416,30,80,0.375,44,98,0.449,0.5,23,34,0.676,7,41,48,27,14,2,35,53
1674,2,2015,23,1,2,10,0,126,14,38,0.368,10,21,0.476,4,17,0.235,0.5,10,15,0.667,2,8,10,12,4,1,7,13
1688,7,1988,28,1,2,11,0,117,22,52,0.423,5,19,0.263,17,33,0.515,0.471,2,6,0.333,4,12,16,13,5,0,7,6
1688,8,1989,29,1,2,80,49,2027,434,917,0.473,93,255,0.365,341,662,0.515,0.524,77,144,0.535,73,116,189,116,80,12,124,184
1691,4,2001,21,1,2,77,77,3087,788,1724,0.457,59,166,0.355,729,1558,0.468,0.474,430,587,0.733,192,388,580,352,116,118,198,160
1691,5,2002,22,1,2,76,76,2912,715,1586,0.451,103,283,0.364,612,1303,0.47,0.483,415,555,0.748,150,447,597,400,119,73,189,139
1691,6,2003,23,1,2,75,74,2954,829,1813,0.457,173,448,0.386,656,1365,0.481,0.505,576,726,0.793,121,367,488,411,124,59,195,156
1691,7,2004,24,1,2,67,67,2675,653,1566,0.417,174,513,0.339,479,1053,0.455,0.473,398,500,0.796,95,307,402,370,93,42,179,129
1691,10,2007,27,1,2,71,71,2539,638,1480,0.431,126,381,0.331,512,1099,0.466,0.474,345,488,0.707,56,322,378,458,92,36,213,136
1691,11,2008,28,1,2,66,62,2440,548,1307,0.419,86,295,0.292,462,1012,0.457,0.452,245,358,0.684,42,297,339,387,68,30,160,91
1691,12,2009,29,1,2,35,35,1181,188,485,0.388,44,117,0.376,144,368,0.391,0.433,125,156,0.801,20,134,154,175,42,15,69,38
1691,13,2010,30,1,2,24,24,627,84,216,0.389,15,62,0.242,69,154,0.448,0.424,43,57,0.754,22,67,89,93,15,12,43,38
1691,13,2010,30,1,2,30,24,673,91,235,0.387,16,64,0.25,75,171,0.439,0.421,47,63,0.746,22,72,94,99,15,14,44,40
1691,14,2011,31,1,2,72,39,1686,227,514,0.442,30,88,0.341,197,426,0.462,0.471,90,129,0.698,49,202,251,252,66,34,102,101
1697,1,2008,22,1,2,70,1,695,39,103,0.379,1,6,0.167,38,97,0.392,0.383,14,32,0.438,53,86,139,40,20,26,40,76
1706,1,1995,22,1,2,45,20,827,116,261,0.444,11,28,0.393,105,233,0.451,0.466,50,73,0.685,35,94,129,89,36,16,39,97
1706,2,1996,23,1,2,81,73,2259,337,722,0.467,38,117,0.325,299,605,0.494,0.493,152,199,0.764,86,218,304,205,92,21,135,205
1706,3,1997,24,1,2,41,8,775,53,156,0.34,23,55,0.418,30,101,0.297,0.413,41,49,0.837,13,80,93,84,34,15,48,61
1706,3,1997,24,1,2,42,3,850,97,209,0.464,18,48,0.375,79,161,0.491,0.507,51,61,0.836,27,101,128,77,43,7,42,69
1706,3,1997,24,1,2,83,11,1625,150,365,0.411,41,103,0.398,109,262,0.416,0.467,92,110,0.836,40,181,221,161,77,22,90,130
1706,5,1999,26,1,2,50,4,959,95,237,0.401,6,31,0.194,89,206,0.432,0.414,44,62,0.71,27,113,140,100,63,3,57,90
1706,6,2000,27,1,2,82,14,1952,244,593,0.411,44,121,0.364,200,472,0.424,0.449,121,146,0.829,47,199,246,240,108,18,113,194
1706,7,2001,28,1,2,76,33,2394,338,714,0.473,53,170,0.312,285,544,0.524,0.511,149,194,0.768,33,278,311,377,106,8,203,178
1706,8,2002,29,1,2,48,16,1471,220,490,0.449,51,128,0.398,169,362,0.467,0.501,96,122,0.787,26,166,192,179,56,14,93,74
1706,11,2005,32,1,2,68,3,1118,61,142,0.43,20,62,0.323,41,80,0.513,0.5,10,16,0.625,20,152,172,103,48,17,31,116
1708,1,2014,20,1,2,82,55,2187,255,679,0.376,95,297,0.32,160,382,0.419,0.446,115,143,0.804,53,182,235,82,45,18,96,201
1708,2,2015,21,1,2,10,10,307,34,76,0.447,17,42,0.405,17,34,0.5,0.559,13,15,0.867,4,32,36,8,4,3,13,23
1714,4,1990,25,1,2,82,69,2338,207,438,0.473,11,31,0.355,196,407,0.482,0.485,98,153,0.641,127,276,403,598,140,37,187,289
1714,5,1991,26,1,2,78,0,1434,132,305,0.433,17,48,0.354,115,257,0.447,0.461,57,93,0.613,71,180,251,371,104,20,122,211
1714,12,1998,33,1,2,18,1,279,23,67,0.343,15,34,0.441,8,33,0.242,0.455,1,1,1,13,27,40,55,14,4,12,41
1731,1,1994,22,1,2,38,0,285,28,88,0.318,5,24,0.208,23,64,0.359,0.347,12,27,0.444,17,18,35,16,15,13,18,34
1737,1,2010,22,1,2,19,0,233,40,91,0.44,19,50,0.38,21,41,0.512,0.544,13,18,0.722,4,23,27,17,5,1,5,19
1737,1,2010,22,1,2,41,0,486,64,177,0.362,23,82,0.28,41,95,0.432,0.427,18,21,0.857,5,67,72,22,13,4,20,33
1737,1,2010,22,1,2,60,0,719,104,268,0.388,42,132,0.318,62,136,0.456,0.466,31,39,0.795,9,90,99,39,18,5,25,52
1737,2,2011,23,1,2,74,64,2062,242,570,0.425,138,348,0.397,104,222,0.468,0.546,152,170,0.894,21,150,171,78,63,4,60,97
1737,3,2012,24,1,2,66,50,1644,191,467,0.409,97,266,0.365,94,201,0.468,0.513,77,85,0.906,17,144,161,54,40,3,29,82
1737,4,2013,25,1,2,78,10,1663,205,530,0.387,122,342,0.357,83,188,0.441,0.502,86,96,0.896,37,134,171,69,58,5,52,103
1737,5,2014,26,1,2,77,70,2556,413,892,0.463,162,404,0.401,251,488,0.514,0.554,221,258,0.857,30,164,194,138,111,4,111,119
1746,1,1980,30,1,2,36,-1,387,90,166,0.542,0,6,0,90,160,0.563,0.542,39,49,0.796,3,20,23,38,10,0,36,54
1748,1,1998,21,1,2,80,62,2662,515,1145,0.45,3,28,0.107,512,1117,0.458,0.451,188,224,0.839,109,171,280,176,125,17,132,213
1748,2,1999,22,1,2,41,40,1551,305,707,0.431,5,30,0.167,300,677,0.443,0.435,83,105,0.79,37,118,155,104,67,12,89,81
1748,3,2000,23,1,2,31,31,969,188,468,0.402,0,9,0,188,459,0.41,0.402,94,119,0.79,35,63,98,54,42,8,64,76
1748,3,2000,23,1,2,37,37,1408,272,612,0.444,15,39,0.385,257,573,0.449,0.457,119,151,0.788,29,123,152,104,33,15,87,75
1748,3,2000,23,1,2,68,68,2377,460,1080,0.426,15,48,0.313,445,1032,0.431,0.433,213,270,0.789,64,186,250,158,75,23,151,151
1748,4,2001,24,1,2,61,61,2535,500,1121,0.446,14,46,0.304,486,1075,0.452,0.452,188,228,0.825,72,164,236,201,78,27,129,148
1748,5,2002,25,1,2,13,1,213,25,67,0.373,1,5,0.2,24,62,0.387,0.381,11,11,1,6,17,23,10,2,3,9,22
1748,5,2002,25,1,2,40,40,1503,286,717,0.399,17,57,0.298,269,660,0.408,0.411,84,108,0.778,44,111,155,118,30,10,79,86
1748,5,2002,25,1,2,53,41,1716,311,784,0.397,18,62,0.29,293,722,0.406,0.408,95,119,0.798,50,128,178,128,32,13,88,108
1748,6,2003,26,1,2,72,3,1671,244,597,0.409,3,16,0.188,241,581,0.415,0.411,65,81,0.802,32,122,154,112,49,14,54,123
1748,7,2004,27,1,2,39,0,516,90,211,0.427,2,7,0.286,88,204,0.431,0.431,13,17,0.765,10,39,49,22,14,5,26,37
1753,1,2013,21,1,2,27,0,475,62,141,0.44,14,45,0.311,48,96,0.5,0.489,27,32,0.844,4,46,50,28,15,4,11,53
1761,2,2007,19,1,2,37,13,373,40,116,0.345,7,32,0.219,33,84,0.393,0.375,14,23,0.609,11,24,35,25,11,4,28,60
1761,3,2008,20,1,2,60,13,689,113,236,0.479,30,77,0.39,83,159,0.522,0.542,41,52,0.788,16,62,78,53,32,8,27,98
1761,4,2009,21,1,2,72,72,1623,258,562,0.459,63,179,0.352,195,383,0.509,0.515,78,89,0.876,45,122,167,107,46,15,64,187
1761,7,2012,24,1,2,56,14,1145,177,465,0.381,46,150,0.307,131,315,0.416,0.43,108,136,0.794,27,89,116,69,46,18,53,122
1761,9,2014,26,1,2,51,34,984,178,409,0.435,83,211,0.393,95,198,0.48,0.537,64,75,0.853,18,85,103,52,46,15,44,103
1761,10,2015,27,1,2,6,5,146,16,65,0.246,5,30,0.167,11,35,0.314,0.285,9,9,1,1,8,9,11,1,2,11,14
1773,13,2012,35,1,2,66,7,1809,242,552,0.438,18,83,0.217,224,469,0.478,0.455,137,169,0.811,53,168,221,441,63,9,177,133
1773,15,2014,37,1,2,28,0,412,40,87,0.46,2,3,0.667,38,84,0.452,0.471,25,30,0.833,12,45,57,97,19,2,28,43
1773,15,2014,37,1,2,30,2,570,66,144,0.458,9,18,0.5,57,126,0.452,0.49,35,47,0.745,16,57,73,100,15,7,33,32
1773,15,2014,37,1,2,58,2,982,106,231,0.459,11,21,0.524,95,210,0.452,0.483,60,77,0.779,28,102,130,197,34,9,61,75
1776,6,2006,25,1,2,74,9,2268,354,760,0.466,138,339,0.407,216,421,0.513,0.557,168,210,0.8,42,355,397,200,52,27,140,173
1776,7,2007,26,1,2,70,69,2740,465,1010,0.46,202,498,0.406,263,512,0.514,0.56,161,203,0.793,52,326,378,298,54,18,179,138
1776,8,2008,27,1,2,70,70,2474,414,824,0.502,155,359,0.432,259,465,0.557,0.596,164,212,0.774,51,416,467,240,35,16,182,145
1776,10,2010,29,1,2,54,50,1805,217,433,0.501,82,171,0.48,135,262,0.515,0.596,70,85,0.824,55,281,336,212,39,12,115,131
1776,11,2011,30,1,2,41,2,838,81,202,0.401,43,118,0.364,38,84,0.452,0.507,23,34,0.676,38,146,184,51,20,2,41,88
1776,12,2012,31,1,2,39,2,752,91,209,0.435,53,117,0.453,38,92,0.413,0.562,2,5,0.4,22,106,128,42,14,6,30,58
1778,1,1988,22,1,2,82,1,1840,306,627,0.488,61,172,0.355,245,455,0.538,0.537,149,186,0.801,95,95,190,132,53,19,101,157
1778,2,1989,23,1,2,74,70,2536,398,831,0.479,98,244,0.402,300,587,0.511,0.538,287,340,0.844,73,219,292,227,93,29,143,170
1778,3,1990,24,1,2,82,82,3192,661,1287,0.514,150,362,0.414,511,925,0.552,0.572,544,627,0.868,95,200,295,311,110,18,222,175
1778,4,1991,25,1,2,82,82,2972,596,1164,0.512,112,322,0.348,484,842,0.575,0.56,551,600,0.918,81,200,281,331,109,13,163,165
1778,5,1992,26,1,2,82,82,3120,562,1121,0.501,129,341,0.378,433,780,0.555,0.559,442,515,0.858,82,236,318,314,105,26,157,210
1778,6,1993,27,1,2,82,82,2954,571,1193,0.479,167,419,0.399,404,774,0.522,0.549,427,485,0.88,67,191,258,262,120,26,145,182
1778,7,1994,28,1,2,79,79,2638,524,1042,0.503,123,292,0.421,401,750,0.535,0.562,403,444,0.908,30,182,212,248,119,24,175,193
1778,8,1995,29,1,2,81,81,2665,505,1092,0.462,195,470,0.415,310,622,0.498,0.552,383,427,0.897,30,180,210,242,98,16,151,157
1778,9,1996,30,1,2,76,76,2621,504,1066,0.473,168,410,0.41,336,656,0.512,0.552,430,498,0.863,38,176,214,253,77,13,189,175
1778,10,1997,31,1,2,81,81,2966,552,1244,0.444,229,536,0.427,323,708,0.456,0.536,418,475,0.88,53,233,286,273,75,25,166,172
1778,11,1998,32,1,2,81,81,2795,516,1081,0.477,164,382,0.429,352,699,0.504,0.553,382,440,0.868,46,186,232,171,78,11,128,148
1778,12,1999,33,1,2,50,50,1787,294,671,0.438,106,275,0.385,188,396,0.475,0.517,226,247,0.915,25,110,135,112,37,9,76,101
1778,13,2000,34,1,2,81,81,2987,466,1041,0.448,165,404,0.408,301,637,0.473,0.527,373,406,0.919,50,189,239,187,85,25,129,126
1778,14,2001,35,1,2,81,81,3181,517,1176,0.44,170,464,0.366,347,712,0.487,0.512,323,348,0.928,38,247,285,260,81,15,133,162
1778,15,2002,36,1,2,79,79,2889,414,913,0.453,180,443,0.406,234,470,0.498,0.552,296,325,0.911,23,196,219,253,88,10,120,143
1778,16,2003,37,1,2,70,70,2117,281,637,0.441,113,318,0.355,168,319,0.527,0.53,207,230,0.9,21,151,172,170,62,4,66,89
1778,17,2004,38,1,2,80,80,2254,260,594,0.438,134,334,0.401,126,260,0.485,0.551,146,165,0.885,18,170,188,249,65,11,68,96
1778,18,2005,39,1,2,66,66,2105,314,719,0.437,96,298,0.322,218,421,0.518,0.503,250,268,0.933,18,138,156,146,50,5,77,109
1785,1,1995,23,1,2,63,8,945,155,301,0.515,2,12,0.167,153,289,0.529,0.518,65,78,0.833,49,88,137,66,32,16,44,89
1785,2,1996,24,1,2,78,47,1761,320,640,0.5,7,27,0.259,313,613,0.511,0.505,99,130,0.762,93,164,257,146,36,11,78,161
1785,4,1998,26,1,2,69,16,1126,140,321,0.436,6,31,0.194,134,290,0.462,0.445,59,86,0.686,55,95,150,88,53,11,43,100
1785,5,1999,27,1,2,44,7,765,85,204,0.417,8,28,0.286,77,176,0.438,0.436,36,48,0.75,31,86,117,50,20,6,38,69
1789,1,1993,21,1,2,73,0,1383,292,615,0.475,3,9,0.333,289,606,0.477,0.477,163,214,0.762,74,73,147,73,34,8,92,130
1789,2,1994,22,1,2,63,31,1358,254,532,0.477,4,6,0.667,250,526,0.475,0.481,149,180,0.828,75,81,156,95,31,13,95,132
1789,4,1996,24,1,2,19,0,136,23,52,0.442,2,10,0.2,21,42,0.5,0.462,13,13,1,4,8,12,8,0,0,14,23
1800,2,2000,24,1,2,81,8,2496,437,1016,0.43,104,292,0.356,333,724,0.46,0.481,299,353,0.847,59,229,288,208,87,32,186,171
1800,3,2001,25,1,2,79,49,3002,527,1214,0.434,90,252,0.357,437,962,0.454,0.471,394,474,0.831,83,314,397,195,84,26,165,169
1800,4,2002,26,1,2,74,74,3116,595,1358,0.438,149,377,0.395,446,981,0.455,0.493,267,314,0.85,63,237,300,187,109,37,180,189
1800,5,2003,27,1,2,73,73,3044,463,1067,0.434,112,318,0.352,351,749,0.469,0.486,242,282,0.858,70,233,303,208,95,36,166,185
1800,6,2004,28,1,2,80,80,3229,460,1081,0.426,164,420,0.39,296,661,0.448,0.501,176,217,0.811,40,322,362,258,107,33,180,179
1800,7,2005,29,1,2,23,21,726,128,296,0.432,58,125,0.464,70,171,0.409,0.53,55,69,0.797,11,52,63,42,23,9,41,49
1800,7,2005,29,1,2,43,43,1662,280,636,0.44,92,217,0.424,188,419,0.449,0.513,113,136,0.831,34,132,166,146,51,21,92,103
1800,7,2005,29,1,2,66,64,2388,408,932,0.438,150,342,0.439,258,590,0.437,0.518,168,205,0.82,45,184,229,188,74,30,133,152
1800,9,2007,31,1,2,78,73,2841,388,882,0.44,101,246,0.411,287,636,0.451,0.497,200,239,0.837,52,215,267,198,92,24,145,186
1800,10,2008,32,1,2,77,38,2702,377,870,0.433,67,192,0.349,310,678,0.457,0.472,163,199,0.819,50,225,275,202,78,34,123,152
1800,11,2009,33,1,2,11,11,365,63,146,0.432,12,35,0.343,51,111,0.459,0.473,13,18,0.722,9,20,29,12,15,2,18,21
1809,1,1980,24,1,2,55,-1,1467,259,510,0.508,0,0,-1,259,510,0.508,0.508,81,104,0.779,28,69,97,238,53,10,143,135
1809,1,1980,24,1,2,61,-1,1549,273,546,0.5,0,0,-1,273,546,0.5,0.5,83,106,0.783,31,73,104,254,53,11,155,146
1813,1,1980,35,1,2,51,-1,633,161,352,0.457,0,0,-1,161,352,0.457,0.457,56,64,0.875,16,20,36,67,21,3,28,46
1819,2,2013,23,1,2,75,21,1682,237,598,0.396,67,197,0.34,170,401,0.424,0.452,47,59,0.797,48,119,167,206,51,23,105,122
1819,3,2014,24,1,2,79,3,1506,195,456,0.428,57,161,0.354,138,295,0.468,0.49,52,68,0.765,29,107,136,112,60,13,55,106
1836,8,1996,30,1,2,66,33,1424,265,606,0.437,63,197,0.32,202,409,0.494,0.489,98,127,0.772,100,129,229,77,63,20,71,140
1838,1,1990,22,1,2,36,1,153,23,68,0.338,2,7,0.286,21,61,0.344,0.353,24,30,0.8,7,13,20,11,2,0,23,20
1839,1,2009,23,1,2,67,17,1515,255,534,0.478,86,184,0.467,169,350,0.483,0.558,80,92,0.87,78,121,199,80,36,12,52,130
1839,3,2011,25,1,2,58,47,1856,279,620,0.45,110,260,0.423,169,360,0.469,0.539,96,107,0.897,37,135,172,68,19,7,54,135
1839,4,2012,26,1,2,62,18,1636,272,658,0.413,106,286,0.371,166,372,0.446,0.494,97,104,0.933,31,96,127,61,46,9,70,86
1839,6,2014,28,1,2,76,9,1426,238,520,0.458,88,195,0.451,150,325,0.462,0.542,72,87,0.828,29,111,140,59,38,12,51,102
1841,1,1990,22,1,2,37,3,402,48,161,0.298,7,30,0.233,41,131,0.313,0.32,43,62,0.694,7,25,32,67,18,4,51,30
1845,1,1996,23,1,2,44,3,573,112,247,0.453,18,55,0.327,94,192,0.49,0.49,49,75,0.653,36,25,61,50,29,8,44,54
1845,2,1997,24,1,2,67,18,1214,171,441,0.388,41,141,0.291,130,300,0.433,0.434,64,99,0.646,43,76,119,129,48,24,81,83
1854,1,2014,21,1,2,37,0,290,57,124,0.46,3,11,0.273,54,113,0.478,0.472,26,40,0.65,24,29,53,6,8,1,16,24
1854,2,2015,22,1,2,9,0,112,27,49,0.551,3,4,0.75,24,45,0.533,0.582,13,23,0.565,11,9,20,3,1,0,7,7
1857,1,1986,22,1,2,55,30,1391,287,620,0.463,5,27,0.185,282,593,0.476,0.467,189,211,0.896,42,73,115,105,70,23,75,130
1857,2,1987,23,1,2,82,82,2377,477,928,0.514,19,63,0.302,458,865,0.529,0.524,269,326,0.825,39,142,181,261,98,36,154,217
1857,15,2000,36,1,2,47,2,582,80,187,0.428,45,110,0.409,35,77,0.455,0.548,37,41,0.902,14,62,76,37,28,9,28,60
1864,1,1980,31,1,2,76,-1,2676,624,1267,0.493,1,25,0.04,623,1242,0.502,0.493,271,302,0.897,68,82,150,299,143,9,162,269
1873,2,2005,25,1,2,49,6,883,131,363,0.361,24,95,0.253,107,268,0.399,0.394,59,80,0.738,15,83,98,65,30,11,57,59
1873,3,2006,26,1,2,28,25,1027,142,317,0.448,20,65,0.308,122,252,0.484,0.479,73,104,0.702,15,52,67,77,38,7,56,64
1873,3,2006,26,1,2,48,2,1085,179,451,0.397,17,76,0.224,162,375,0.432,0.416,99,138,0.717,18,68,86,120,30,4,79,69
1873,3,2006,26,1,2,76,27,2112,321,768,0.418,37,141,0.262,284,627,0.453,0.442,172,242,0.711,33,120,153,197,68,11,135,133
1873,4,2007,27,1,2,69,18,1477,177,438,0.404,24,83,0.289,153,355,0.431,0.432,87,120,0.725,26,87,113,187,49,13,90,96
1873,6,2009,29,1,2,80,2,1975,355,795,0.447,87,242,0.36,268,553,0.485,0.501,177,233,0.76,22,146,168,158,88,17,128,173
1873,7,2010,30,1,2,29,1,680,108,272,0.397,28,90,0.311,80,182,0.44,0.449,48,63,0.762,13,72,85,51,18,4,26,49
1873,7,2010,30,1,2,46,1,993,160,411,0.389,41,131,0.313,119,280,0.425,0.439,93,131,0.71,15,83,98,84,28,12,65,77
1873,7,2010,30,1,2,75,2,1673,268,683,0.392,69,221,0.312,199,462,0.431,0.443,141,194,0.727,28,155,183,135,46,16,91,126
1891,6,2009,27,1,2,80,12,1831,261,604,0.432,98,229,0.428,163,375,0.435,0.513,34,42,0.81,26,137,163,105,22,3,70,144
1891,9,2012,30,1,2,27,0,269,21,55,0.382,8,27,0.296,13,28,0.464,0.455,4,4,1,2,12,14,11,3,0,6,21
1924,5,1993,27,1,2,47,0,440,48,112,0.429,6,24,0.25,42,88,0.477,0.455,20,22,0.909,5,33,38,59,8,1,25,34
1924,5,1993,27,1,2,52,0,481,53,122,0.434,6,26,0.231,47,96,0.49,0.459,22,24,0.917,5,40,45,70,10,1,27,36
1930,19,2013,39,1,2,76,48,2043,152,409,0.372,114,325,0.351,38,84,0.452,0.511,40,48,0.833,50,273,323,249,125,25,76,125
1936,1,1981,22,1,2,12,-1,106,14,45,0.311,0,0,-1,14,45,0.311,0.311,10,13,0.769,0,9,9,10,2,1,8,9
1936,1,1981,22,1,2,29,-1,247,38,96,0.396,0,0,-1,38,96,0.396,0.396,4,5,0.8,7,17,24,35,9,5,22,24
1936,1,1981,22,1,2,41,-1,353,52,141,0.369,0,0,-1,52,141,0.369,0.369,14,18,0.778,7,26,33,45,11,6,30,33
1939,1,1991,24,1,2,62,22,1004,159,418,0.38,19,65,0.292,140,353,0.397,0.403,92,119,0.773,42,77,119,76,30,8,77,158
1939,2,1992,25,1,2,34,0,277,44,111,0.396,4,13,0.308,40,98,0.408,0.414,20,31,0.645,13,19,32,17,10,6,15,37
1944,1,1996,22,1,2,62,1,868,110,255,0.431,5,34,0.147,105,221,0.475,0.441,54,77,0.701,43,67,110,88,21,13,60,76
1953,1,2007,22,1,2,48,12,967,139,304,0.457,13,46,0.283,126,258,0.488,0.479,78,98,0.796,29,68,97,41,53,1,46,57
1953,2,2009,24,1,2,50,3,277,31,69,0.449,7,18,0.389,24,51,0.471,0.5,33,38,0.868,10,28,38,10,12,0,22,34
1963,2,1981,28,1,2,82,-1,2385,546,1025,0.533,3,19,0.158,543,1006,0.54,0.534,341,410,0.832,191,219,410,157,84,12,177,155
1963,4,1983,30,1,2,80,54,2262,512,984,0.52,3,19,0.158,509,965,0.527,0.522,343,408,0.841,152,172,324,192,66,8,193,143
1963,6,1985,32,1,2,16,0,189,31,69,0.449,1,1,1,30,68,0.441,0.457,13,16,0.813,10,12,22,21,2,1,13,14
1982,5,2008,26,1,2,50,0,1075,165,348,0.474,73,188,0.388,92,160,0.575,0.579,88,96,0.917,9,90,99,68,22,23,47,125
1982,5,2008,26,1,2,75,0,1732,255,575,0.443,111,296,0.375,144,279,0.516,0.54,119,130,0.915,21,151,172,101,42,29,75,192
1982,7,2010,28,1,2,52,0,952,138,280,0.493,59,110,0.536,79,170,0.465,0.598,39,49,0.796,10,101,111,89,26,12,42,76
1982,8,2011,29,1,2,82,0,1649,242,557,0.434,120,289,0.415,122,268,0.455,0.542,77,87,0.885,12,138,150,124,35,20,60,156
1982,9,2012,30,1,2,65,7,1469,178,412,0.432,118,271,0.435,60,141,0.426,0.575,55,66,0.833,26,133,159,112,36,15,53,110
1982,11,2014,32,1,2,71,71,2408,289,609,0.475,185,392,0.472,104,217,0.479,0.626,87,94,0.926,22,260,282,208,70,24,102,147
1982,12,2015,33,1,2,9,9,307,39,80,0.488,30,52,0.577,9,28,0.321,0.675,21,23,0.913,2,37,39,27,6,7,12,22
1997,1,1981,24,1,2,25,0,100,11,47,0.234,1,4,0.25,10,43,0.233,0.245,7,10,0.7,2,10,12,9,2,1,10,20
2027,2,2014,21,1,2,78,0,1538,263,609,0.432,88,247,0.356,175,362,0.483,0.504,51,64,0.797,27,162,189,115,56,26,61,143
2027,3,2015,22,1,2,5,5,171,27,68,0.397,7,23,0.304,20,45,0.444,0.449,7,9,0.778,4,27,31,11,5,1,11,15
2031,1,2013,21,1,2,23,0,280,33,95,0.347,4,16,0.25,29,79,0.367,0.368,8,15,0.533,3,14,17,20,7,0,16,27
2031,1,2013,21,1,2,24,0,297,27,68,0.397,10,21,0.476,17,47,0.362,0.471,12,19,0.632,5,24,29,12,6,0,10,25
2031,1,2013,21,1,2,47,0,577,60,163,0.368,14,37,0.378,46,126,0.365,0.411,20,34,0.588,8,38,46,32,13,0,26,52
2031,2,2014,22,1,2,53,0,695,63,160,0.394,36,90,0.4,27,70,0.386,0.506,29,36,0.806,8,41,49,43,11,1,27,54
2038,1,2000,23,1,2,10,0,145,15,40,0.375,8,19,0.421,7,21,0.333,0.475,11,11,1,4,11,15,11,5,0,6,16
2038,2,2001,24,1,2,65,5,1116,135,313,0.431,51,124,0.411,84,189,0.444,0.513,68,76,0.895,12,77,89,81,38,9,52,114
2038,3,2002,25,1,2,44,0,477,70,176,0.398,27,74,0.365,43,102,0.422,0.474,42,46,0.913,13,42,55,60,13,5,40,49
2062,9,1988,30,1,2,80,54,2150,291,666,0.437,19,88,0.216,272,578,0.471,0.451,218,251,0.869,22,126,148,405,124,9,130,162
2062,10,1989,31,1,2,55,3,627,65,188,0.346,5,41,0.122,60,147,0.408,0.359,44,60,0.733,13,40,53,127,25,5,62,61
2067,1,2009,23,1,2,77,42,1939,243,540,0.45,82,203,0.404,161,337,0.478,0.526,78,94,0.83,18,160,178,91,76,14,69,157
2067,2,2010,24,1,2,71,66,2375,338,775,0.436,76,225,0.338,262,550,0.476,0.485,133,153,0.869,60,192,252,121,93,20,76,130
2067,3,2011,25,1,2,81,1,1723,253,576,0.439,71,174,0.408,182,402,0.453,0.501,95,120,0.792,51,158,209,100,58,18,68,102
2067,4,2012,26,1,2,58,26,1757,251,580,0.433,87,217,0.401,164,363,0.452,0.508,71,86,0.826,26,133,159,88,68,22,64,106
2067,5,2013,27,1,2,78,39,1941,246,530,0.464,58,156,0.372,188,374,0.503,0.519,62,72,0.861,31,159,190,143,89,21,84,139
2067,6,2014,28,1,2,30,0,504,90,183,0.492,23,52,0.442,67,131,0.511,0.555,18,22,0.818,8,41,49,32,20,9,25,37
2067,6,2014,28,1,2,49,47,1469,205,431,0.476,49,142,0.345,156,289,0.54,0.532,81,90,0.9,21,117,138,83,45,19,48,90
2067,6,2014,28,1,2,79,47,1973,295,614,0.48,72,194,0.371,223,420,0.531,0.539,99,112,0.884,29,158,187,115,65,28,73,127
2067,7,2015,29,1,2,8,6,266,41,76,0.539,15,25,0.6,26,51,0.51,0.638,22,24,0.917,7,20,27,19,10,2,7,13
2072,1,2012,21,1,2,19,0,243,23,59,0.39,2,10,0.2,21,49,0.429,0.407,14,17,0.824,9,17,26,31,8,4,17,22
2072,2,2013,22,1,2,16,12,289,29,76,0.382,8,24,0.333,21,52,0.404,0.434,12,20,0.6,15,24,39,20,12,6,10,30
2086,1,1996,22,1,2,30,0,323,53,141,0.376,36,101,0.356,17,40,0.425,0.504,34,43,0.791,12,40,52,31,6,1,23,31
2086,2,1997,23,1,2,73,47,2111,314,684,0.459,183,442,0.414,131,242,0.541,0.593,86,105,0.819,38,179,217,161,50,18,109,168
2086,3,1998,24,1,2,81,81,2621,363,854,0.425,153,378,0.405,210,476,0.441,0.515,141,179,0.788,72,220,292,180,58,16,99,219
2086,4,1999,25,1,2,12,2,190,31,79,0.392,12,35,0.343,19,44,0.432,0.468,8,11,0.727,4,12,16,10,3,1,7,18
2086,5,2000,26,1,2,53,13,1434,228,560,0.407,89,228,0.39,139,332,0.419,0.487,84,106,0.792,37,116,153,136,41,15,80,127
2086,6,2001,27,1,2,80,58,2331,336,846,0.397,147,382,0.385,189,464,0.407,0.484,153,192,0.797,47,184,231,190,65,18,102,170
2086,7,2002,28,1,2,71,19,1665,315,769,0.41,89,240,0.371,226,529,0.427,0.467,94,120,0.783,38,145,183,130,59,25,91,105
2086,8,2003,29,1,2,63,24,1929,325,809,0.402,92,252,0.365,233,557,0.418,0.459,156,194,0.804,48,164,212,144,59,21,103,156
2086,9,2004,30,1,2,73,70,2233,394,933,0.422,106,289,0.367,288,644,0.447,0.479,144,182,0.791,46,154,200,151,61,12,101,177
2086,10,2006,32,1,2,14,0,220,33,88,0.375,15,43,0.349,18,45,0.4,0.46,11,18,0.611,3,16,19,23,13,2,20,18
2086,10,2006,32,1,2,12,6,238,42,103,0.408,10,35,0.286,32,68,0.471,0.456,5,13,0.385,2,26,28,18,8,2,11,21
2086,10,2006,32,1,2,26,6,458,75,191,0.393,25,78,0.321,50,113,0.442,0.458,16,31,0.516,5,42,47,41,21,4,31,39
2099,1,1988,24,1,2,50,0,310,27,87,0.31,0,1,0,27,86,0.314,0.31,29,48,0.604,17,34,51,14,13,4,19,36
2099,2,1989,25,1,2,42,0,336,58,121,0.479,1,3,0.333,57,118,0.483,0.483,19,39,0.487,35,26,61,15,11,3,24,28
2101,1,1988,22,1,2,49,0,405,90,193,0.466,0,4,0,90,189,0.476,0.466,40,57,0.702,28,35,63,26,16,15,30,54
2101,3,1990,24,1,2,79,54,2522,540,1089,0.496,4,15,0.267,536,1074,0.499,0.498,256,317,0.808,109,238,347,225,88,63,120,216
2101,4,1991,25,1,2,79,79,2878,598,1219,0.491,1,13,0.077,597,1206,0.495,0.491,281,340,0.826,119,291,410,201,98,85,147,234
2101,5,1992,26,1,2,82,82,3070,703,1397,0.503,5,21,0.238,698,1376,0.507,0.505,292,343,0.851,117,277,394,185,125,105,136,258
2101,6,1993,27,1,2,80,80,3144,663,1410,0.47,14,60,0.233,649,1350,0.481,0.475,326,376,0.867,88,259,347,298,118,77,133,248
2103,1,1990,23,1,2,79,4,1326,250,514,0.486,0,14,0,250,500,0.5,0.486,130,174,0.747,49,102,151,116,55,13,95,145
2103,2,1991,24,1,2,29,25,860,166,378,0.439,14,47,0.298,152,331,0.459,0.458,59,69,0.855,49,63,112,72,46,8,33,65
2103,3,1992,25,1,2,68,10,1176,173,376,0.46,1,9,0.111,172,367,0.469,0.461,99,118,0.839,36,82,118,74,43,12,72,131
2103,4,1993,26,1,2,48,12,752,124,276,0.449,2,6,0.333,122,270,0.452,0.453,81,102,0.794,35,67,102,52,28,11,49,60
2103,5,1994,27,1,2,13,0,126,20,51,0.392,2,2,1,18,49,0.367,0.412,16,25,0.64,8,14,22,11,7,1,5,16
2105,2,2013,24,1,2,39,1,290,21,47,0.447,7,19,0.368,14,28,0.5,0.521,9,18,0.5,13,40,53,15,18,3,14,33
2134,1,1999,24,1,2,47,32,1218,169,379,0.446,12,44,0.273,157,335,0.469,0.462,87,135,0.644,69,97,166,62,49,14,82,128
2134,2,2000,25,1,2,65,0,781,111,261,0.425,3,18,0.167,108,243,0.444,0.431,67,109,0.615,59,65,124,44,32,17,53,94
2134,3,2001,26,1,2,47,38,1108,142,326,0.436,6,29,0.207,136,297,0.458,0.445,90,123,0.732,30,130,160,73,41,18,56,110
2134,3,2001,26,1,2,70,48,1565,211,478,0.441,19,52,0.365,192,426,0.451,0.461,109,156,0.699,55,179,234,107,62,30,83,156
2134,4,2002,27,1,2,67,0,581,59,156,0.378,14,33,0.424,45,123,0.366,0.423,37,55,0.673,29,51,80,39,18,1,36,73
2138,1,1995,22,1,2,37,2,672,106,223,0.475,3,14,0.214,103,209,0.493,0.482,57,88,0.648,24,47,71,101,28,1,57,42
2158,10,2003,32,1,2,81,32,1497,147,359,0.409,28,79,0.354,119,280,0.425,0.448,41,74,0.554,139,214,353,104,66,19,52,136
2159,1,1992,23,1,2,55,3,819,93,223,0.417,3,8,0.375,90,215,0.419,0.424,35,46,0.761,30,55,85,83,37,9,44,107
2159,2,1993,24,1,2,40,8,324,30,59,0.508,0,1,0,30,58,0.517,0.508,26,38,0.684,12,23,35,25,11,6,24,44
2163,1,1996,23,1,2,64,29,1253,156,400,0.39,10,56,0.179,146,344,0.424,0.403,77,108,0.713,65,103,168,63,44,11,62,95
2164,1,1998,22,1,2,30,0,234,26,69,0.377,0,3,0,26,66,0.394,0.377,12,15,0.8,14,19,33,17,9,1,9,15
2164,2,1999,23,1,2,18,1,165,24,56,0.429,0,1,0,24,55,0.436,0.429,8,8,1,18,16,34,12,2,3,8,22
2206,8,2006,33,1,2,70,23,1069,75,174,0.431,1,3,0.333,74,171,0.433,0.434,41,49,0.837,13,85,98,101,33,3,29,103
2206,10,2008,35,1,2,40,0,300,29,69,0.42,0,1,0,29,68,0.426,0.42,12,15,0.8,4,15,19,38,10,0,5,28
2227,4,1995,25,1,2,70,60,2296,403,820,0.491,2,22,0.091,401,798,0.503,0.493,194,313,0.62,203,299,502,246,80,30,204,205
2239,3,2002,23,1,2,28,1,272,30,79,0.38,1,7,0.143,29,72,0.403,0.386,18,23,0.783,3,20,23,29,9,1,16,23
2240,2,2013,26,1,2,14,0,208,24,63,0.381,7,17,0.412,17,46,0.37,0.437,14,21,0.667,1,16,17,28,1,0,13,14
2247,2,1981,25,1,2,73,-1,1317,191,388,0.492,0,0,-1,191,388,0.492,0.492,94,128,0.734,101,93,194,106,67,13,84,112
2268,8,2006,30,1,2,26,20,736,139,256,0.543,1,6,0.167,138,250,0.552,0.545,65,112,0.58,45,45,90,67,34,9,68,71
2272,2,2005,21,1,2,65,9,862,120,276,0.435,30,78,0.385,90,198,0.455,0.489,44,64,0.688,15,56,71,49,29,4,47,121
2272,3,2006,22,1,2,53,19,813,87,212,0.41,35,96,0.365,52,116,0.448,0.493,32,49,0.653,16,64,80,25,19,6,42,103
2272,4,2007,23,1,2,67,28,1534,222,490,0.453,60,148,0.405,162,342,0.474,0.514,100,126,0.794,23,135,158,105,55,17,102,145
2272,5,2008,24,1,2,51,45,1188,146,403,0.362,34,114,0.298,112,289,0.388,0.404,53,77,0.688,35,93,128,82,29,6,55,117
2272,8,2011,27,1,2,17,0,149,12,26,0.462,5,10,0.5,7,16,0.438,0.558,2,5,0.4,1,13,14,3,5,0,6,15
2272,10,2013,29,1,2,39,1,528,42,119,0.353,18,60,0.3,24,59,0.407,0.429,1,6,0.167,7,49,56,32,24,5,14,59
2279,1,1980,22,1,2,72,-1,1270,189,460,0.411,1,22,0.045,188,438,0.429,0.412,64,90,0.711,25,84,109,144,48,5,93,97
2279,2,1981,23,1,2,79,-1,2701,585,1092,0.536,2,30,0.067,583,1062,0.549,0.537,182,248,0.734,74,137,211,299,140,9,131,172
2279,3,1982,24,1,2,82,82,2756,662,1258,0.526,8,35,0.229,654,1223,0.535,0.529,220,287,0.767,75,146,221,276,129,12,144,159
2279,4,1983,25,1,2,81,81,2740,682,1323,0.515,4,25,0.16,678,1298,0.522,0.517,388,478,0.812,68,106,174,231,140,17,156,160
2279,5,1984,26,1,2,81,81,2686,680,1322,0.514,17,59,0.288,663,1263,0.525,0.521,345,410,0.841,68,105,173,251,122,10,142,165
2279,6,1985,27,1,2,68,57,2253,508,988,0.514,6,39,0.154,502,949,0.529,0.517,196,248,0.79,69,153,222,264,101,5,108,115
2279,7,1986,28,1,2,75,31,1931,372,792,0.47,20,62,0.323,352,730,0.482,0.482,217,244,0.889,42,106,148,278,94,5,112,156
2279,8,1987,29,1,2,72,1,1798,337,733,0.46,26,98,0.265,311,635,0.49,0.477,174,216,0.806,41,98,139,237,76,12,108,134
2279,9,1988,30,1,2,17,1,263,43,107,0.402,3,8,0.375,40,99,0.404,0.416,14,18,0.778,8,10,18,27,7,1,11,29
2279,9,1988,30,1,2,28,2,538,94,191,0.492,2,13,0.154,92,178,0.517,0.497,54,61,0.885,7,20,27,49,23,4,28,44
2279,9,1988,30,1,2,45,3,801,137,298,0.46,5,21,0.238,132,277,0.477,0.468,68,79,0.861,15,30,45,76,30,5,39,73
2285,1,1993,23,1,2,77,11,1656,297,634,0.468,46,118,0.39,251,516,0.486,0.505,162,206,0.786,64,115,179,166,60,14,123,193
2285,2,1994,24,1,2,30,30,923,176,409,0.43,14,63,0.222,162,346,0.468,0.447,57,71,0.803,48,61,109,94,43,8,59,93
2285,3,1995,25,1,2,73,24,1559,285,659,0.432,84,216,0.389,201,443,0.454,0.496,102,128,0.797,62,106,168,122,52,13,82,143
2285,4,1996,26,1,2,73,12,1608,272,602,0.452,105,254,0.413,167,348,0.48,0.539,61,86,0.709,45,92,137,118,59,10,56,139
2285,5,1997,27,1,2,72,57,2291,402,1011,0.398,128,343,0.373,274,668,0.41,0.461,109,133,0.82,54,193,247,256,105,17,157,168
2285,6,1998,28,1,2,8,8,202,35,72,0.486,5,19,0.263,30,53,0.566,0.521,4,6,0.667,6,14,20,23,9,0,6,16
2285,6,1998,28,1,2,30,24,991,155,348,0.445,48,106,0.453,107,242,0.442,0.514,32,41,0.78,31,72,103,114,52,6,45,81
2285,6,1998,28,1,2,38,32,1193,190,420,0.452,53,125,0.424,137,295,0.464,0.515,36,47,0.766,37,86,123,137,61,6,51,97
2285,7,1999,29,1,2,28,28,810,103,272,0.379,34,114,0.298,69,158,0.437,0.441,30,41,0.732,30,54,84,78,35,6,38,60
2285,8,2000,30,1,2,82,22,2073,316,725,0.436,85,255,0.333,231,470,0.491,0.494,87,109,0.798,58,174,232,195,62,10,85,171
2285,9,2001,31,1,2,75,41,2126,308,732,0.421,100,256,0.391,208,476,0.437,0.489,75,87,0.862,44,148,192,192,91,18,105,166
2285,10,2002,32,1,2,82,0,2060,288,684,0.421,111,283,0.392,177,401,0.441,0.502,50,58,0.862,37,169,206,177,61,11,76,137
2285,11,2003,33,1,2,82,39,2245,252,609,0.414,87,212,0.41,165,397,0.416,0.485,39,50,0.78,40,201,241,244,72,13,82,161
2285,12,2004,34,1,2,75,0,1391,156,348,0.448,68,141,0.482,88,207,0.425,0.546,51,61,0.836,31,122,153,120,56,10,77,103
2285,13,2005,35,1,2,40,0,529,56,150,0.373,25,65,0.385,31,85,0.365,0.457,16,18,0.889,14,51,65,57,18,2,28,39
2304,1,1995,23,1,2,78,56,1800,309,638,0.484,116,266,0.436,193,372,0.519,0.575,80,101,0.792,67,134,201,105,48,24,79,149
2304,2,1996,24,1,2,82,47,2609,390,877,0.445,117,313,0.374,273,564,0.484,0.511,148,192,0.771,56,265,321,138,55,22,89,148
2304,3,1997,25,1,2,80,42,2326,409,903,0.453,171,414,0.413,238,489,0.487,0.548,91,114,0.798,68,224,292,123,86,20,76,102
2304,4,1998,26,1,2,82,82,3198,440,957,0.46,192,447,0.43,248,510,0.486,0.56,132,170,0.776,65,298,363,188,129,49,110,108
2304,5,1999,27,1,2,45,42,1342,198,437,0.453,75,200,0.375,123,237,0.519,0.539,32,53,0.604,19,123,142,80,37,16,41,52
2304,6,2000,28,1,2,79,38,2056,280,654,0.428,106,250,0.424,174,404,0.431,0.509,61,77,0.792,44,223,267,146,40,19,60,119
2304,7,2001,29,1,2,44,22,958,128,292,0.438,34,84,0.405,94,208,0.452,0.497,24,30,0.8,11,119,130,64,27,11,40,62
2304,8,2002,30,1,2,78,78,2793,467,944,0.495,143,322,0.444,324,622,0.521,0.57,99,124,0.798,50,244,294,173,77,37,74,93
2304,9,2003,31,1,2,66,44,1941,274,601,0.456,100,231,0.433,174,370,0.47,0.539,79,97,0.814,24,168,192,112,42,19,56,64
2304,10,2004,32,1,2,9,0,132,13,39,0.333,8,19,0.421,5,20,0.25,0.436,6,6,1,2,23,25,5,3,1,4,5
2304,10,2004,32,1,2,16,0,284,33,107,0.308,11,43,0.256,22,64,0.344,0.36,6,8,0.75,2,16,18,23,5,2,16,11
2304,10,2004,32,1,2,33,0,621,80,168,0.476,36,76,0.474,44,92,0.478,0.583,19,25,0.76,12,62,74,38,11,6,18,22
2304,10,2004,32,1,2,58,0,1037,126,314,0.401,55,138,0.399,71,176,0.403,0.489,31,39,0.795,16,101,117,66,19,9,38,38
2309,1,2001,23,1,2,80,49,1809,290,673,0.431,63,165,0.382,227,508,0.447,0.478,104,145,0.717,112,147,259,105,63,20,78,164
2309,5,2005,27,1,2,82,61,2510,356,848,0.42,129,335,0.385,227,513,0.442,0.496,188,226,0.832,71,269,340,169,91,18,93,219
2309,6,2006,28,1,2,82,77,3140,478,1096,0.436,177,448,0.395,301,648,0.465,0.517,241,294,0.82,65,316,381,190,104,15,126,223
2309,8,2008,30,1,2,76,76,1796,215,516,0.417,113,287,0.394,102,229,0.445,0.526,65,85,0.765,36,170,206,67,47,7,41,125
2309,9,2009,31,1,2,43,9,515,73,183,0.399,33,85,0.388,40,98,0.408,0.489,12,19,0.632,13,71,84,16,15,2,15,51
2309,10,2010,32,1,2,46,39,973,116,301,0.385,62,171,0.363,54,130,0.415,0.488,33,54,0.611,17,109,126,41,25,5,27,81
2314,1,1990,25,1,2,77,0,967,207,427,0.485,34,74,0.459,173,353,0.49,0.525,135,160,0.844,50,61,111,116,23,2,96,134
2314,2,1991,26,1,2,18,0,133,32,71,0.451,1,6,0.167,31,65,0.477,0.458,15,22,0.682,10,8,18,20,6,0,12,21
2314,2,1991,26,1,2,43,0,882,211,422,0.5,22,59,0.373,189,363,0.521,0.526,99,115,0.861,41,51,92,66,37,1,69,111
2314,2,1991,26,1,2,61,0,1015,243,493,0.493,23,65,0.354,220,428,0.514,0.516,114,137,0.832,51,59,110,86,43,1,81,132
2314,3,1992,27,1,2,82,82,3027,668,1315,0.508,123,277,0.444,545,1038,0.525,0.555,232,287,0.808,97,161,258,252,105,11,215,248
2314,4,1993,28,1,2,70,67,2660,587,1134,0.518,75,167,0.449,512,967,0.529,0.551,315,362,0.87,42,148,190,247,94,13,204,237
2315,1,1980,23,1,2,28,-1,541,126,260,0.485,2,4,0.5,124,256,0.484,0.488,73,83,0.88,26,44,70,32,15,4,49,52
2315,1,1980,23,1,2,50,-1,971,224,473,0.474,2,5,0.4,222,468,0.474,0.476,104,120,0.867,49,66,115,70,19,3,70,106
2315,1,1980,23,1,2,78,-1,1512,350,733,0.477,4,9,0.444,346,724,0.478,0.48,177,203,0.872,75,110,185,102,34,7,119,158
2315,2,1981,24,1,2,82,-1,2269,474,965,0.491,8,28,0.286,466,937,0.497,0.495,224,267,0.839,90,156,246,184,65,15,165,262
2315,3,1982,25,1,2,27,8,566,104,214,0.486,4,13,0.308,100,201,0.498,0.495,36,45,0.8,28,43,71,53,16,2,33,61
2315,3,1982,25,1,2,54,1,617,129,293,0.44,1,18,0.056,128,275,0.465,0.442,49,64,0.766,33,50,83,61,20,6,33,91
2315,3,1982,25,1,2,81,9,1183,233,507,0.46,5,31,0.161,228,476,0.479,0.464,85,109,0.78,61,93,154,114,36,8,66,152
2315,4,1983,26,1,2,62,4,599,120,267,0.449,3,14,0.214,117,253,0.462,0.455,43,56,0.768,39,45,84,60,30,8,49,92
2320,1,1986,24,1,2,70,18,880,117,286,0.409,1,12,0.083,116,274,0.423,0.411,44,74,0.595,29,60,89,71,45,1,62,86
2320,2,1987,25,1,2,60,6,469,75,176,0.426,1,10,0.1,74,166,0.446,0.429,31,44,0.705,16,34,50,64,21,2,32,60
2325,1,1993,23,1,2,31,0,139,38,82,0.463,2,5,0.4,36,77,0.468,0.476,15,25,0.6,6,11,17,10,10,2,18,19
2325,2,1994,24,1,2,72,53,1531,242,514,0.471,1,12,0.083,241,502,0.48,0.472,113,157,0.72,71,141,212,133,67,12,63,135
2325,3,1995,25,1,2,80,79,2500,338,816,0.414,19,55,0.345,319,761,0.419,0.426,183,235,0.779,90,175,265,180,115,25,113,206
2325,4,1996,26,1,2,72,69,2530,386,826,0.467,93,211,0.441,293,615,0.476,0.524,186,240,0.775,62,199,261,271,102,27,126,192
2325,5,1997,27,1,2,69,65,2375,328,766,0.428,85,216,0.394,243,550,0.442,0.484,125,174,0.718,63,182,245,233,113,21,135,174
2325,6,1998,28,1,2,62,61,1887,246,552,0.446,44,114,0.386,202,438,0.461,0.486,106,140,0.757,59,157,216,187,81,18,108,181
2325,7,1999,29,1,2,43,43,1574,215,497,0.433,68,172,0.395,147,325,0.452,0.501,115,168,0.685,39,135,174,149,60,25,92,124
2325,8,2000,30,1,2,28,9,825,152,335,0.454,30,91,0.33,122,244,0.5,0.499,47,65,0.723,17,54,71,79,41,8,48,72
2326,4,2002,24,1,2,82,82,3302,707,1598,0.442,210,520,0.404,497,1078,0.461,0.508,520,643,0.809,81,485,566,261,154,86,241,237
2326,5,2003,25,1,2,79,79,3096,663,1592,0.416,118,391,0.302,545,1201,0.454,0.454,604,753,0.802,106,472,578,349,139,62,288,227
2326,6,2004,26,1,2,80,80,3099,602,1497,0.402,115,384,0.299,487,1113,0.438,0.441,517,631,0.819,69,453,522,410,131,52,303,234
2326,9,2007,29,1,2,47,46,1740,373,850,0.439,107,275,0.389,266,575,0.463,0.502,320,402,0.796,39,238,277,194,48,13,152,122
2327,1,1983,23,1,2,39,1,265,33,88,0.375,1,7,0.143,32,81,0.395,0.381,18,32,0.563,15,20,35,14,8,4,18,42
2327,2,1984,24,1,2,69,35,1280,268,570,0.47,0,9,0,268,561,0.478,0.47,149,173,0.861,59,76,135,60,27,13,81,143
2327,3,1985,25,1,2,44,3,882,165,307,0.537,1,4,0.25,164,303,0.541,0.539,102,124,0.823,49,68,117,94,34,5,63,117
2327,4,1986,26,1,2,81,8,2147,429,798,0.538,3,23,0.13,426,775,0.55,0.539,266,310,0.858,94,137,231,177,83,6,107,252
2327,5,1987,27,1,2,79,31,2505,575,1077,0.534,3,28,0.107,572,1049,0.545,0.535,387,440,0.88,117,149,266,144,64,24,120,222
2327,6,1988,28,1,2,37,0,965,248,486,0.51,3,14,0.214,245,472,0.519,0.513,107,122,0.877,30,53,83,73,21,7,57,94
2327,7,1989,29,1,2,75,4,2078,527,1018,0.518,8,36,0.222,519,982,0.529,0.522,255,297,0.859,82,115,197,156,77,19,112,193
2327,8,1990,30,1,2,59,0,1709,503,987,0.51,46,133,0.346,457,854,0.535,0.533,307,366,0.839,64,103,167,133,50,7,129,158
2327,9,1991,31,1,2,32,2,840,202,436,0.463,9,23,0.391,193,413,0.467,0.474,148,160,0.925,30,44,74,72,22,2,54,80
2327,9,1991,31,1,2,46,0,1327,359,720,0.499,37,93,0.398,322,627,0.514,0.524,282,311,0.907,37,80,117,96,38,11,93,90
2327,9,1991,31,1,2,78,2,2167,561,1156,0.485,46,116,0.397,515,1040,0.495,0.505,430,471,0.913,67,124,191,168,60,13,147,170
2327,10,1992,32,1,2,78,78,2658,620,1306,0.475,33,123,0.268,587,1183,0.496,0.487,417,455,0.916,93,140,233,241,86,20,189,213
2327,11,1993,33,1,2,77,72,2218,524,1071,0.489,42,113,0.372,482,958,0.503,0.509,313,352,0.889,58,134,192,220,100,7,160,167
2327,12,1994,34,1,2,51,0,1022,272,577,0.471,6,32,0.188,266,545,0.488,0.477,189,211,0.896,29,54,83,91,42,5,64,84
2327,14,1996,36,1,2,76,2,1404,264,590,0.447,35,104,0.337,229,486,0.471,0.477,174,205,0.849,40,96,136,101,57,6,93,188
2327,15,1997,37,1,2,33,10,600,120,260,0.462,12,39,0.308,108,221,0.489,0.485,83,92,0.902,17,36,53,31,14,5,38,49
2327,15,1997,37,1,2,27,17,650,119,237,0.502,30,56,0.536,89,181,0.492,0.565,56,63,0.889,19,49,68,49,14,4,30,48
2327,15,1997,37,1,2,60,27,1250,239,497,0.481,42,95,0.442,197,402,0.49,0.523,139,155,0.897,36,85,121,80,28,9,68,97
2327,16,1998,38,1,2,39,0,442,52,143,0.364,4,13,0.308,48,130,0.369,0.378,43,52,0.827,19,26,45,34,9,0,21,35
2328,1,1995,24,1,2,81,11,1208,201,456,0.441,74,198,0.374,127,258,0.492,0.522,90,115,0.783,63,70,133,77,37,15,63,150
2328,2,1996,25,1,2,65,1,784,98,242,0.405,38,114,0.333,60,128,0.469,0.483,67,82,0.817,40,63,103,48,24,10,45,83
2328,3,1997,26,1,2,65,0,747,134,298,0.45,51,120,0.425,83,178,0.466,0.535,69,84,0.821,49,56,105,52,33,10,46,85
2328,4,1998,27,1,2,67,35,1740,257,568,0.452,106,259,0.409,151,309,0.489,0.546,140,170,0.824,70,166,236,85,51,12,80,137
2328,5,1999,28,1,2,49,38,1242,180,417,0.432,65,165,0.394,115,252,0.456,0.51,88,102,0.863,39,101,140,53,44,6,53,86
2328,7,2001,30,1,2,81,40,2144,291,672,0.433,120,297,0.404,171,375,0.456,0.522,158,181,0.873,54,187,241,96,46,19,76,123
2328,8,2002,31,1,2,71,64,1718,207,471,0.439,111,238,0.466,96,233,0.412,0.557,101,113,0.894,43,141,184,112,41,12,64,110
2328,9,2003,32,1,2,62,26,1360,210,446,0.471,80,201,0.398,130,245,0.531,0.561,101,122,0.828,44,112,156,70,33,9,56,92
2328,11,2005,34,1,2,68,11,841,111,258,0.43,57,134,0.425,54,124,0.435,0.541,45,56,0.804,15,64,79,51,29,1,37,67
2328,12,2006,35,1,2,29,1,228,24,61,0.393,9,33,0.273,15,28,0.536,0.467,2,5,0.4,4,19,23,13,6,1,11,20
2329,2,1981,24,1,2,36,-1,431,55,133,0.414,19,48,0.396,36,85,0.424,0.485,11,14,0.786,13,28,41,75,15,2,17,26
2329,2,1981,24,1,2,42,-1,461,57,138,0.413,19,48,0.396,38,90,0.422,0.482,11,14,0.786,13,29,42,77,15,2,22,28
2330,6,2009,26,1,2,54,25,1329,176,426,0.413,80,223,0.359,96,203,0.473,0.507,78,110,0.709,44,132,176,65,31,24,56,126
2330,8,2011,28,1,2,38,4,689,98,250,0.392,51,149,0.342,47,101,0.465,0.494,36,51,0.706,9,67,76,23,19,18,25,66
2330,8,2011,28,1,2,57,4,1107,143,365,0.392,85,236,0.36,58,129,0.45,0.508,39,57,0.684,15,111,126,33,29,21,39,101
2330,9,2012,29,1,2,42,6,921,104,270,0.385,61,182,0.335,43,88,0.489,0.498,20,31,0.645,18,112,130,25,21,10,33,81
2340,1,2004,21,1,2,49,1,473,53,129,0.411,9,32,0.281,44,97,0.454,0.446,38,60,0.633,14,41,55,68,13,3,36,70
2349,4,2014,25,1,2,15,2,270,31,79,0.392,11,34,0.324,20,45,0.444,0.462,21,26,0.808,10,16,26,20,5,1,15,18
2349,5,2015,26,1,2,9,0,141,8,33,0.242,5,21,0.238,3,12,0.25,0.318,9,12,0.75,3,10,13,7,1,0,2,13
2359,1,2001,22,1,2,26,0,169,17,54,0.315,3,11,0.273,14,43,0.326,0.343,22,27,0.815,8,17,25,5,4,2,17,12
2359,2,2002,23,1,2,23,0,179,28,84,0.333,6,26,0.231,22,58,0.379,0.369,31,41,0.756,2,14,16,5,6,0,11,7
2362,5,2004,27,1,2,82,82,2451,368,770,0.478,112,290,0.386,256,480,0.533,0.551,278,335,0.83,92,311,403,122,137,40,112,248
2362,10,2009,32,1,2,75,0,2140,216,524,0.412,116,314,0.369,100,210,0.476,0.523,120,146,0.822,38,324,362,82,58,21,79,216
2368,1,1983,24,1,2,79,18,1528,213,466,0.457,1,9,0.111,212,457,0.464,0.458,105,176,0.597,83,198,281,207,99,47,162,174
2368,2,1984,25,1,2,81,18,1730,276,528,0.523,2,9,0.222,274,519,0.528,0.525,120,200,0.6,102,180,282,252,86,50,157,241
2368,6,1988,29,1,2,75,75,2484,345,702,0.491,8,39,0.205,337,663,0.508,0.497,285,357,0.798,130,245,375,523,112,34,198,233
2368,7,1989,30,1,2,67,62,2170,307,648,0.474,12,55,0.218,295,593,0.497,0.483,187,241,0.776,73,189,262,439,119,44,184,221
2368,8,1990,31,1,2,57,2,1400,239,506,0.472,6,43,0.14,233,463,0.503,0.478,144,190,0.758,59,113,172,244,71,23,109,149
2368,9,1991,32,1,2,70,18,1683,201,426,0.472,16,57,0.281,185,369,0.501,0.491,110,133,0.827,50,126,176,271,63,32,130,174
2368,10,1992,33,1,2,56,7,759,60,161,0.373,3,21,0.143,57,140,0.407,0.382,28,41,0.683,22,73,95,142,29,19,64,86
2368,11,1993,34,1,2,18,0,268,29,66,0.439,0,4,0,29,62,0.468,0.439,21,27,0.778,8,23,31,30,11,5,23,36
2377,6,2011,27,1,2,59,0,717,74,210,0.352,20,69,0.29,54,141,0.383,0.4,29,39,0.744,22,39,61,56,42,5,55,106
2377,9,2014,30,1,2,31,2,377,28,92,0.304,9,43,0.209,19,49,0.388,0.353,9,13,0.692,8,35,43,66,25,2,26,50
2381,1,2009,22,1,2,47,0,366,31,101,0.307,14,48,0.292,17,53,0.321,0.376,17,21,0.81,9,34,43,39,15,3,19,34
2390,1,2006,22,1,2,79,4,1599,189,428,0.442,20,76,0.263,169,352,0.48,0.465,128,160,0.8,18,142,160,219,41,2,102,138
2390,3,2008,24,1,2,82,16,2229,267,620,0.431,65,190,0.342,202,430,0.47,0.483,215,248,0.867,31,203,234,313,61,1,178,129
2390,4,2009,25,1,2,82,53,2716,386,853,0.453,78,221,0.353,308,632,0.487,0.498,224,263,0.852,44,232,276,338,88,17,184,179
2390,6,2011,27,1,2,70,2,1375,212,515,0.412,29,84,0.345,183,431,0.425,0.44,142,168,0.845,14,117,131,183,40,6,76,77
2390,6,2011,27,1,2,83,15,1722,260,637,0.408,33,108,0.306,227,529,0.429,0.434,182,214,0.85,20,153,173,242,54,6,110,102
2390,8,2013,29,1,2,79,4,2349,387,857,0.452,82,203,0.404,305,654,0.466,0.499,167,198,0.843,21,222,243,439,60,11,157,134
2392,7,2004,30,1,2,50,0,1185,263,592,0.444,81,219,0.37,182,373,0.488,0.513,82,109,0.752,55,119,174,105,49,8,63,106
2392,8,2005,31,1,2,25,0,536,109,255,0.427,33,96,0.344,76,159,0.478,0.492,50,58,0.862,23,62,85,59,14,2,28,58
2392,10,2007,33,1,2,56,2,1330,204,518,0.394,54,165,0.327,150,353,0.425,0.446,130,168,0.774,42,136,178,141,50,6,78,98
2392,11,2008,34,1,2,46,0,891,116,296,0.392,53,144,0.368,63,152,0.414,0.481,40,49,0.816,23,87,110,76,32,3,31,59
2392,11,2008,34,1,2,72,5,1389,204,506,0.403,81,226,0.358,123,280,0.439,0.483,64,81,0.79,33,148,181,139,45,5,59,96
2400,2,1994,23,1,2,82,82,3066,637,1432,0.445,17,60,0.283,620,1372,0.452,0.451,285,347,0.821,169,219,388,374,87,25,334,161
2400,3,1995,24,1,2,51,51,1982,484,1026,0.472,35,110,0.318,449,916,0.49,0.489,306,380,0.805,120,140,260,191,28,12,160,92
2400,4,1996,25,1,2,82,82,2820,569,1308,0.435,121,333,0.363,448,975,0.459,0.481,345,418,0.825,173,237,410,235,47,22,191,165
2400,5,1997,26,1,2,46,46,1676,260,588,0.442,46,139,0.331,214,449,0.477,0.481,148,188,0.787,81,146,227,156,57,15,107,113
2400,5,1997,26,1,2,77,77,2831,444,1029,0.431,86,247,0.348,358,782,0.458,0.473,252,310,0.813,132,279,411,316,86,32,208,194
2400,6,1998,27,1,2,31,31,1258,230,572,0.402,22,79,0.278,208,493,0.422,0.421,103,128,0.805,61,112,173,158,38,2,118,74
2400,6,1998,27,1,2,48,47,1788,246,535,0.46,39,112,0.348,207,423,0.489,0.496,126,154,0.818,69,158,227,223,41,6,145,112
2400,6,1998,27,1,2,79,78,3046,476,1107,0.43,61,191,0.319,415,916,0.453,0.458,229,282,0.812,130,270,400,381,79,8,263,186
2400,7,1999,28,1,2,49,9,1175,152,370,0.411,25,90,0.278,127,280,0.454,0.445,85,101,0.842,36,123,159,128,43,6,82,80
2412,1,1982,22,1,2,38,0,412,69,146,0.473,0,0,-1,69,146,0.473,0.473,32,39,0.821,28,23,51,22,11,3,18,43
2412,1,1982,22,1,2,49,0,478,79,172,0.459,0,0,-1,79,172,0.459,0.459,38,49,0.776,35,28,63,27,14,3,24,48
2412,2,1983,23,1,2,78,3,1309,199,426,0.467,2,13,0.154,197,413,0.477,0.469,92,126,0.73,87,92,179,105,64,11,83,132
2413,3,2003,24,1,2,80,58,2254,356,818,0.435,95,297,0.32,261,521,0.501,0.493,139,183,0.76,66,220,286,183,125,30,176,202
2413,6,2006,27,1,2,81,81,2910,472,1148,0.411,117,339,0.345,355,809,0.439,0.462,268,341,0.786,48,264,312,225,104,43,203,195
2413,7,2007,28,1,2,37,32,1186,180,430,0.419,41,138,0.297,139,292,0.476,0.466,120,146,0.822,17,78,95,114,33,20,81,87
2413,10,2010,31,1,2,72,72,2829,544,1285,0.423,118,353,0.334,426,932,0.457,0.469,312,397,0.786,72,294,366,258,118,37,233,181
2413,10,2010,31,1,2,81,81,3129,600,1418,0.423,129,393,0.328,471,1025,0.46,0.469,338,434,0.779,78,323,401,300,132,43,259,197
2413,11,2011,32,1,2,67,67,2405,435,1059,0.411,121,359,0.337,314,700,0.449,0.468,249,305,0.816,53,251,304,241,80,28,209,161
2421,1,2004,19,1,2,79,79,3122,622,1492,0.417,63,217,0.29,559,1275,0.438,0.438,347,460,0.754,99,333,432,465,130,58,273,149
2426,5,2007,28,1,2,70,13,1555,136,325,0.418,32,85,0.376,104,240,0.433,0.468,67,88,0.761,54,130,184,145,75,16,88,172
2426,6,2008,29,1,2,75,56,2189,227,528,0.43,46,127,0.362,181,401,0.451,0.473,121,163,0.742,38,184,222,311,97,32,128,180
2426,7,2009,30,1,2,53,0,605,48,145,0.331,11,28,0.393,37,117,0.316,0.369,29,41,0.707,23,42,65,74,29,11,49,62
2428,2,2007,30,1,2,37,1,664,91,221,0.412,32,86,0.372,59,135,0.437,0.484,59,64,0.922,10,38,48,111,13,0,59,53
2428,2,2007,30,1,2,63,3,973,128,322,0.398,44,130,0.338,84,192,0.438,0.466,86,95,0.905,15,54,69,172,26,1,90,75
2434,2,2013,23,1,2,47,0,291,35,83,0.422,1,2,0.5,34,81,0.42,0.428,10,18,0.556,5,16,21,28,9,1,19,18
2434,2,2013,23,1,2,59,1,441,49,121,0.405,1,2,0.5,48,119,0.403,0.409,12,22,0.545,8,24,32,44,15,2,21,22
2438,1,2013,21,1,2,61,2,902,131,294,0.446,53,138,0.384,78,156,0.5,0.536,59,70,0.843,17,77,94,56,12,10,40,37
2438,2,2014,22,1,2,13,0,158,16,42,0.381,4,18,0.222,12,24,0.5,0.429,4,4,1,3,19,22,11,1,1,11,11
2455,5,2002,27,1,2,34,0,366,37,90,0.411,4,12,0.333,33,78,0.423,0.433,16,25,0.64,10,19,29,48,31,1,20,30
2460,1,1983,26,1,2,48,0,447,53,135,0.393,0,2,0,53,133,0.398,0.393,38,48,0.792,40,29,69,24,22,4,25,62
2460,2,1984,27,1,2,25,0,176,20,50,0.4,1,1,1,19,49,0.388,0.41,14,22,0.636,6,6,12,14,8,2,12,24
2461,1,1993,22,1,2,42,0,356,57,149,0.383,3,14,0.214,54,135,0.4,0.393,40,59,0.678,18,30,48,13,8,1,28,23
2461,2,1994,23,1,2,17,0,119,17,54,0.315,0,1,0,17,53,0.321,0.315,13,21,0.619,9,7,16,4,4,0,9,7
2464,1,1980,25,1,2,81,-1,2937,574,1361,0.422,12,58,0.207,562,1303,0.431,0.426,380,487,0.78,173,241,414,332,144,82,227,267
2464,3,1982,27,1,2,80,77,2937,577,1228,0.47,8,42,0.19,569,1186,0.48,0.473,399,495,0.806,142,268,410,369,105,55,233,253
2464,5,1984,29,1,2,80,78,2665,384,878,0.437,4,32,0.125,380,846,0.449,0.44,281,330,0.852,87,193,280,338,93,57,172,251
2467,1,1980,24,1,2,79,-1,2622,590,1212,0.487,5,13,0.385,585,1199,0.488,0.489,280,338,0.828,95,105,200,370,120,24,189,216
2467,2,1981,25,1,2,75,-1,2693,573,1136,0.504,6,20,0.3,567,1116,0.508,0.507,279,356,0.784,60,119,179,407,126,11,197,188
2467,3,1982,26,1,2,68,57,2314,455,1011,0.45,7,30,0.233,448,981,0.457,0.454,294,385,0.764,63,128,191,358,102,16,186,188
2467,4,1983,27,1,2,61,57,1813,389,858,0.453,14,41,0.341,375,817,0.459,0.462,186,237,0.785,26,98,124,318,61,6,156,138
2467,5,1984,28,1,2,67,43,1893,353,798,0.442,16,43,0.372,337,755,0.446,0.452,164,213,0.77,31,115,146,374,58,7,173,155
2467,6,1985,29,1,2,73,66,2367,453,946,0.479,22,72,0.306,431,874,0.493,0.49,265,332,0.798,38,154,192,566,43,7,244,184
2467,7,1986,30,1,2,32,4,615,129,293,0.44,24,65,0.369,105,228,0.461,0.481,33,45,0.733,13,33,46,114,8,1,60,56
2467,7,1986,30,1,2,39,5,862,155,328,0.473,5,20,0.25,150,308,0.487,0.48,79,110,0.718,17,58,75,219,10,1,90,72
2467,7,1986,30,1,2,71,9,1477,284,621,0.457,29,85,0.341,255,536,0.476,0.481,112,155,0.723,30,91,121,333,18,2,150,128
2467,8,1987,31,1,2,24,0,508,85,186,0.457,5,15,0.333,80,171,0.468,0.47,42,55,0.764,11,35,46,115,12,1,41,36
2481,1,2002,20,1,2,29,27,913,121,288,0.42,14,42,0.333,107,246,0.435,0.444,21,27,0.778,35,83,118,105,26,11,43,55
2481,1,2002,20,1,2,48,33,1003,130,296,0.439,24,88,0.273,106,208,0.51,0.48,20,26,0.769,40,99,139,74,33,9,28,59
2481,1,2002,20,1,2,77,60,1916,251,584,0.43,38,130,0.292,213,454,0.469,0.462,41,53,0.774,75,182,257,179,59,20,71,114
2481,2,2003,21,1,2,82,34,2255,316,796,0.397,75,205,0.366,241,591,0.408,0.444,96,124,0.774,57,207,264,210,62,19,108,143
2481,3,2004,22,1,2,82,77,3331,555,1291,0.43,83,272,0.305,472,1019,0.463,0.462,174,232,0.75,80,305,385,362,93,26,199,177
2481,5,2006,24,1,2,82,82,3340,632,1395,0.453,128,360,0.356,504,1035,0.487,0.499,261,330,0.791,98,237,335,536,103,31,267,187
2481,6,2007,25,1,2,57,57,2359,536,1139,0.471,119,312,0.381,417,827,0.504,0.523,235,314,0.748,53,186,239,249,60,11,176,115
2481,7,2008,26,1,2,82,82,3343,647,1497,0.432,169,444,0.381,478,1053,0.454,0.489,316,379,0.834,83,284,367,474,84,18,223,168
2481,8,2009,27,1,2,79,79,3124,620,1420,0.437,149,414,0.36,471,1006,0.468,0.489,299,362,0.826,65,281,346,455,84,19,195,176
2481,9,2010,28,1,2,76,76,2886,635,1386,0.458,129,350,0.369,506,1036,0.488,0.505,220,269,0.818,74,279,353,369,82,5,145,145
2481,10,2011,29,1,2,72,72,2554,514,1161,0.443,89,300,0.297,425,861,0.494,0.481,195,243,0.802,59,232,291,338,47,7,146,131
2481,11,2012,30,1,2,60,60,2127,423,931,0.454,125,322,0.388,298,609,0.489,0.521,158,186,0.849,53,168,221,232,48,13,116,75
2481,12,2013,31,1,2,72,72,2642,445,1052,0.423,148,395,0.375,297,657,0.452,0.493,132,161,0.82,53,165,218,253,49,14,123,99
2481,13,2014,32,1,2,79,79,2575,462,1018,0.454,162,404,0.401,300,614,0.489,0.533,159,195,0.815,48,222,270,216,47,10,120,129
2481,14,2015,33,1,2,9,9,302,67,142,0.472,14,35,0.4,53,107,0.495,0.521,24,30,0.8,8,43,51,35,9,0,13,20
2489,1,2013,23,1,2,51,0,619,72,180,0.4,36,94,0.383,36,86,0.419,0.5,23,32,0.719,20,90,110,47,11,9,29,51
2489,2,2014,24,1,2,38,0,342,33,96,0.344,8,41,0.195,25,55,0.455,0.385,17,22,0.773,7,44,51,16,6,1,14,23
2489,2,2014,24,1,2,45,0,392,36,113,0.319,9,47,0.191,27,66,0.409,0.358,19,26,0.731,9,46,55,20,6,2,15,26
2496,1,1980,23,1,2,38,-1,325,45,115,0.391,0,1,0,45,114,0.395,0.391,31,39,0.795,19,36,55,54,19,4,42,40
2496,3,1982,25,1,2,7,0,104,9,22,0.409,0,1,0,9,21,0.429,0.409,9,12,0.75,7,8,15,11,6,2,5,8
2496,3,1982,25,1,2,67,15,1191,208,422,0.493,3,11,0.273,205,411,0.499,0.496,98,130,0.754,75,69,144,160,50,23,91,93
2496,3,1982,25,1,2,74,15,1295,217,444,0.489,3,12,0.25,214,432,0.495,0.492,107,142,0.754,82,77,159,171,56,25,96,101
2496,4,1983,26,1,2,82,51,2511,520,1013,0.513,11,40,0.275,509,973,0.523,0.519,245,315,0.778,167,186,353,301,93,49,152,263
2496,5,1984,27,1,2,82,0,1909,426,901,0.473,4,19,0.211,422,882,0.478,0.475,207,275,0.753,130,107,237,271,44,19,135,196
2496,6,1985,28,1,2,82,16,2093,428,942,0.454,5,27,0.185,423,915,0.462,0.457,190,247,0.769,134,118,252,325,71,20,135,205
2496,7,1986,29,1,2,79,12,1978,465,996,0.467,2,13,0.154,463,983,0.471,0.468,165,214,0.771,119,107,226,269,80,23,88,180
2496,8,1987,30,1,2,78,8,2166,533,1154,0.462,4,14,0.286,529,1140,0.464,0.464,158,201,0.786,123,134,257,300,92,16,133,159
2496,9,1988,31,1,2,82,1,1935,425,959,0.443,5,24,0.208,420,935,0.449,0.446,147,217,0.677,90,141,231,267,58,18,152,164
2496,10,1989,32,1,2,82,21,2073,462,996,0.464,13,44,0.295,449,952,0.472,0.47,193,263,0.734,109,146,255,242,74,17,105,155
2496,11,1990,33,1,2,82,12,1972,334,775,0.431,5,34,0.147,329,741,0.444,0.434,131,196,0.668,108,148,256,255,71,13,123,143
2496,12,1991,34,1,2,82,28,2390,406,936,0.434,11,34,0.324,395,902,0.438,0.44,135,209,0.646,110,170,280,271,75,15,118,166
2496,13,1992,35,1,2,60,23,1350,202,499,0.405,19,60,0.317,183,439,0.417,0.424,55,85,0.647,67,115,182,145,41,14,74,93
2498,1,2011,23,1,2,79,63,2069,271,682,0.397,103,289,0.356,168,393,0.427,0.473,64,92,0.696,51,189,240,148,58,54,95,163
2505,1,1995,23,1,2,11,0,139,15,44,0.341,2,12,0.167,13,32,0.406,0.364,13,16,0.813,6,5,11,16,6,0,9,19
2508,1,2004,23,1,2,20,0,154,15,53,0.283,1,4,0.25,14,49,0.286,0.292,5,11,0.455,7,16,23,12,5,6,12,23
2508,2,2005,24,1,2,52,7,649,83,190,0.437,23,60,0.383,60,130,0.462,0.497,44,64,0.688,11,58,69,21,13,11,29,81
2508,4,2007,26,1,2,78,25,1671,220,461,0.477,5,12,0.417,215,449,0.479,0.483,138,174,0.793,47,106,153,68,39,22,92,192
2508,5,2008,27,1,2,25,0,206,23,53,0.434,1,6,0.167,22,47,0.468,0.443,34,51,0.667,7,28,35,12,8,6,10,28
2508,6,2009,28,1,2,79,71,1426,154,336,0.458,11,17,0.647,143,319,0.448,0.475,110,151,0.728,58,110,168,78,49,19,68,199
2508,8,2011,30,1,2,45,2,589,100,214,0.467,14,39,0.359,86,175,0.491,0.5,69,90,0.767,4,61,65,33,20,7,31,70
2508,10,2013,32,1,2,28,4,381,32,82,0.39,3,12,0.25,29,70,0.414,0.409,21,31,0.677,11,20,31,20,12,1,16,46
2509,1,1999,23,1,2,29,5,476,39,123,0.317,19,61,0.311,20,62,0.323,0.394,11,22,0.5,9,33,42,41,18,5,29,30
2514,10,2008,31,1,2,67,3,1336,151,363,0.416,115,276,0.417,36,87,0.414,0.574,20,28,0.714,5,67,72,126,19,1,36,66
2522,1,1995,23,1,2,64,58,1981,342,744,0.46,91,246,0.37,251,498,0.504,0.521,122,169,0.722,79,170,249,128,131,41,75,175
2522,2,1996,24,1,2,70,66,2184,337,685,0.492,83,227,0.366,254,458,0.555,0.553,136,184,0.739,45,188,233,246,129,45,99,162
2522,3,1997,25,1,2,80,80,2998,473,1081,0.438,152,389,0.391,321,692,0.464,0.508,276,337,0.819,90,236,326,270,189,49,169,226
2522,4,1998,26,1,2,80,80,2910,486,1005,0.484,143,368,0.389,343,637,0.538,0.555,234,306,0.765,85,217,302,246,160,55,146,164
2522,5,1999,27,1,2,20,20,724,96,227,0.423,20,64,0.313,76,163,0.466,0.467,59,80,0.738,20,56,76,61,35,24,21,42
2522,6,2000,28,1,2,72,72,2807,478,1119,0.427,128,341,0.375,350,778,0.45,0.484,362,419,0.864,81,262,343,305,192,49,160,176
2522,7,2001,29,1,2,63,58,2282,388,871,0.445,90,238,0.378,298,633,0.471,0.497,228,270,0.844,75,217,292,171,110,58,135,183
2522,8,2002,30,1,2,81,81,3156,517,1198,0.432,149,382,0.39,368,816,0.451,0.494,297,355,0.837,61,317,378,262,117,77,148,258
2522,9,2003,31,1,2,47,47,1789,291,688,0.423,98,241,0.407,193,447,0.432,0.494,189,230,0.822,35,191,226,173,64,31,85,137
2522,10,2004,32,1,2,81,81,2998,473,1156,0.409,177,479,0.37,296,677,0.437,0.486,278,333,0.835,38,270,308,258,92,34,129,226
2522,12,2006,34,1,2,75,75,2437,292,722,0.404,133,374,0.356,159,348,0.457,0.497,168,215,0.781,35,244,279,177,131,27,93,201
2522,13,2007,35,1,2,29,14,561,57,151,0.377,22,74,0.297,35,77,0.455,0.45,25,34,0.735,14,47,61,33,22,2,23,54
2522,13,2007,35,1,2,35,27,1033,121,271,0.446,56,148,0.378,65,123,0.528,0.55,34,41,0.829,17,112,129,76,46,8,24,70
2522,13,2007,35,1,2,64,41,1594,178,422,0.422,78,222,0.351,100,200,0.5,0.514,59,75,0.787,31,159,190,109,68,10,47,124
2522,14,2008,36,1,2,47,33,922,66,180,0.367,34,116,0.293,32,64,0.5,0.461,10,14,0.714,18,114,132,69,26,8,29,72
2523,1,2003,23,1,2,19,1,115,9,24,0.375,2,7,0.286,7,17,0.412,0.417,3,4,0.75,4,5,9,5,6,1,6,13
2523,2,2004,24,1,2,81,2,1508,123,311,0.395,27,89,0.303,96,222,0.432,0.439,124,149,0.832,25,101,126,173,65,18,73,132
2523,3,2005,25,1,2,77,14,2268,275,647,0.425,87,229,0.38,188,418,0.45,0.492,176,207,0.85,34,208,242,196,61,31,114,171
2523,4,2006,26,1,2,68,2,1837,233,559,0.417,63,187,0.337,170,372,0.457,0.473,122,160,0.763,18,152,170,154,55,20,107,142
2523,5,2007,27,1,2,24,3,449,43,112,0.384,7,27,0.259,36,85,0.424,0.415,22,26,0.846,7,26,33,53,18,4,17,41
2523,5,2007,27,1,2,39,9,870,96,249,0.386,32,101,0.317,64,148,0.432,0.45,73,88,0.83,16,66,82,55,30,12,50,80
2523,5,2007,27,1,2,63,12,1319,139,361,0.385,39,128,0.305,100,233,0.429,0.439,95,114,0.833,23,92,115,108,48,16,67,121
2523,6,2008,28,1,2,70,26,1757,182,432,0.421,74,192,0.385,108,240,0.45,0.507,94,126,0.746,30,140,170,166,48,18,78,140
2528,8,2012,31,1,2,51,10,666,57,150,0.38,46,114,0.404,11,36,0.306,0.533,25,30,0.833,6,43,49,19,17,9,10,45
2533,5,2004,24,1,2,42,2,373,33,96,0.344,13,44,0.295,20,52,0.385,0.411,14,23,0.609,24,44,68,14,12,9,19,48
2556,3,2014,22,1,2,68,19,936,126,265,0.475,12,38,0.316,114,227,0.502,0.498,79,96,0.823,32,75,107,114,35,14,43,84
2565,1,1990,23,1,2,31,0,193,19,58,0.328,0,2,0,19,56,0.339,0.328,2,3,0.667,9,19,28,11,3,4,4,27
2565,2,1991,24,1,2,68,5,1011,139,303,0.459,15,43,0.349,124,260,0.477,0.483,26,36,0.722,65,80,145,53,22,13,52,100
2565,3,1992,25,1,2,15,0,136,15,51,0.294,3,15,0.2,12,36,0.333,0.324,8,12,0.667,7,20,27,5,9,2,8,11
2565,3,1992,25,1,2,24,0,190,28,73,0.384,10,26,0.385,18,47,0.383,0.452,8,14,0.571,9,15,24,7,7,6,8,21
2565,3,1992,25,1,2,39,0,326,43,124,0.347,13,41,0.317,30,83,0.361,0.399,16,26,0.615,16,35,51,12,16,8,16,32
2570,1,1980,26,1,2,33,-1,225,36,94,0.383,2,6,0.333,34,88,0.386,0.394,11,19,0.579,11,15,26,20,16,5,17,29
2572,1,2006,23,1,2,51,1,465,53,136,0.39,4,17,0.235,49,119,0.412,0.404,30,43,0.698,16,37,53,45,30,4,34,47
2572,2,2007,24,1,2,47,1,369,56,140,0.4,3,17,0.176,53,123,0.431,0.411,11,21,0.524,14,39,53,45,17,3,25,34
2575,1,1990,22,1,2,17,0,114,21,52,0.404,3,13,0.231,18,39,0.462,0.433,6,9,0.667,5,6,11,5,5,3,10,9
2577,1,2010,23,1,2,31,4,303,45,119,0.378,5,22,0.227,40,97,0.412,0.399,33,46,0.717,21,25,46,16,10,3,19,15
2577,2,2011,24,1,2,26,8,406,78,164,0.476,12,40,0.3,66,124,0.532,0.512,16,22,0.727,25,28,53,30,12,3,40,35
2577,2,2011,24,1,2,34,8,483,94,196,0.48,14,45,0.311,80,151,0.53,0.515,21,28,0.75,26,36,62,32,14,5,46,39
2585,1,1983,22,1,2,31,0,321,37,102,0.363,0,0,-1,37,102,0.363,0.363,21,32,0.656,19,17,36,41,20,2,30,54
2588,2,2014,20,1,2,21,1,201,22,53,0.415,3,8,0.375,19,45,0.422,0.443,15,19,0.789,0,21,21,30,8,1,22,21
2588,2,2014,20,1,2,19,2,242,16,66,0.242,2,10,0.2,14,56,0.25,0.258,11,16,0.688,1,18,19,28,2,4,17,25
2588,2,2014,20,1,2,40,3,443,38,119,0.319,5,18,0.278,33,101,0.327,0.34,26,35,0.743,1,39,40,58,10,5,39,46
2589,1,1983,22,1,2,73,44,1708,332,776,0.428,10,29,0.345,322,747,0.431,0.434,87,125,0.696,74,120,194,150,53,18,137,171
2589,2,1984,23,1,2,68,0,616,148,315,0.47,7,27,0.259,141,288,0.49,0.481,37,44,0.841,28,50,78,63,13,4,62,81
2589,3,1985,24,1,2,19,3,344,73,135,0.541,2,4,0.5,71,131,0.542,0.548,25,35,0.714,22,21,43,14,13,5,14,34
2589,3,1985,24,1,2,21,3,349,74,137,0.54,2,4,0.5,72,133,0.541,0.547,25,35,0.714,22,21,43,14,13,5,15,36
2589,4,1986,25,1,2,82,52,2158,475,958,0.496,4,25,0.16,471,933,0.505,0.498,211,265,0.796,96,139,235,115,71,34,136,241
2589,5,1987,26,1,2,82,0,1650,370,808,0.458,0,10,0,370,798,0.464,0.458,182,234,0.778,68,107,175,105,68,13,117,190
2589,6,1988,27,1,2,47,4,958,248,546,0.454,1,9,0.111,247,537,0.46,0.455,97,121,0.802,41,40,81,61,32,4,80,95
2589,9,1991,30,1,2,82,0,1498,335,757,0.443,0,9,0,335,748,0.448,0.443,145,177,0.819,82,99,181,82,31,8,83,165
2589,10,1992,31,1,2,82,0,1602,364,805,0.452,1,4,0.25,363,801,0.453,0.453,151,197,0.766,91,92,183,113,66,9,114,148
2592,1,1981,24,1,2,26,-1,504,80,160,0.5,0,6,0,80,154,0.519,0.5,28,42,0.667,43,73,116,70,27,13,57,68
2592,2,1983,26,1,2,55,3,514,39,106,0.368,0,2,0,39,104,0.375,0.368,10,15,0.667,27,72,99,46,24,13,20,79
2594,2,2001,23,1,2,82,77,3089,596,1367,0.436,124,314,0.395,472,1053,0.448,0.481,303,358,0.846,42,227,269,403,104,12,239,204
2594,3,2002,24,1,2,78,78,2967,524,1219,0.43,172,444,0.387,352,775,0.454,0.5,284,340,0.835,40,230,270,444,144,13,181,156
2594,8,2007,29,1,2,81,80,2846,514,1063,0.484,162,370,0.438,352,693,0.508,0.56,160,199,0.804,41,190,231,422,81,17,152,170
2594,9,2008,30,1,2,82,34,2579,471,1008,0.467,136,363,0.375,335,645,0.519,0.535,191,223,0.857,30,178,208,264,88,18,92,170
2594,10,2009,31,1,2,74,11,2491,541,1168,0.463,167,456,0.366,374,712,0.525,0.535,198,225,0.88,39,138,177,251,97,20,119,141
2594,11,2010,32,1,2,77,12,2540,456,1041,0.438,136,373,0.365,320,668,0.479,0.503,232,268,0.866,19,121,140,292,94,17,109,142
2594,12,2011,33,1,2,82,10,2564,492,1091,0.451,127,351,0.362,365,740,0.493,0.509,182,214,0.85,24,129,153,334,93,13,167,140
2594,13,2012,34,1,2,63,1,2000,357,830,0.43,138,365,0.378,219,465,0.471,0.513,98,111,0.883,16,133,149,226,73,11,127,69
2594,14,2013,35,1,2,79,24,2124,281,648,0.434,123,331,0.372,158,317,0.498,0.529,114,131,0.87,19,140,159,198,66,11,102,110
2594,16,2015,37,1,2,9,0,202,24,50,0.48,20,39,0.513,4,11,0.364,0.68,8,8,1,1,7,8,9,11,4,10,12
2597,1,1980,22,1,2,82,-1,3029,566,1172,0.483,28,105,0.267,538,1067,0.504,0.495,500,597,0.838,143,186,329,515,114,20,348,262
2597,2,1981,23,1,2,82,-1,2820,543,1097,0.495,18,90,0.2,525,1007,0.521,0.503,445,550,0.809,124,163,287,426,122,20,259,258
2597,3,1982,24,1,2,82,82,2838,560,1194,0.469,25,100,0.25,535,1094,0.489,0.479,363,449,0.808,115,197,312,476,87,16,277,243
2597,6,1985,27,1,2,82,80,2543,501,1029,0.487,5,38,0.132,496,991,0.501,0.489,334,387,0.863,106,164,270,656,95,18,307,250
2597,7,1986,28,1,2,82,82,2919,546,1137,0.48,6,35,0.171,540,1102,0.49,0.483,405,490,0.827,73,231,304,788,112,20,327,231
2597,9,1988,30,1,2,73,73,2653,619,1318,0.47,16,59,0.271,603,1259,0.479,0.476,320,385,0.831,72,160,232,463,59,16,234,173
2597,10,1989,31,1,2,82,82,2517,497,1067,0.466,17,58,0.293,480,1009,0.476,0.474,285,335,0.851,86,156,242,387,108,16,194,236
2597,11,1990,32,1,2,76,71,2350,517,1178,0.439,26,105,0.248,491,1073,0.458,0.45,378,443,0.853,75,146,221,407,60,12,226,194
2597,12,1991,33,1,2,81,81,2955,583,1247,0.468,52,144,0.361,531,1103,0.481,0.488,292,343,0.851,69,160,229,378,85,35,252,231
2602,1,1992,22,1,2,36,0,156,18,51,0.353,2,17,0.118,16,34,0.471,0.373,10,15,0.667,6,16,22,22,4,1,17,20
2620,2,1986,23,1,2,61,20,1281,195,399,0.489,0,2,0,195,397,0.491,0.489,127,157,0.809,58,83,141,132,51,10,90,151
2626,2,2015,23,1,2,9,9,272,28,72,0.389,12,34,0.353,16,38,0.421,0.472,10,16,0.625,4,23,27,11,13,5,10,26
2627,1,1980,25,1,2,39,-1,1239,289,617,0.468,7,19,0.368,282,598,0.472,0.474,254,335,0.758,56,118,174,124,39,38,116,106
2627,2,1981,26,1,2,77,-1,2620,734,1451,0.506,10,39,0.256,724,1412,0.513,0.509,489,615,0.795,107,180,287,231,53,60,250,231
2627,3,1982,27,1,2,61,5,1246,313,644,0.486,4,14,0.286,309,630,0.49,0.489,276,339,0.814,57,91,148,117,34,29,142,149
2627,4,1983,28,1,2,75,64,2155,445,925,0.481,2,10,0.2,443,915,0.484,0.482,298,380,0.784,96,174,270,222,47,33,163,142
2627,5,1984,29,1,2,19,0,349,89,165,0.539,0,1,0,89,164,0.543,0.539,62,73,0.849,18,26,44,13,10,13,27,30
2633,1,2012,21,1,2,66,29,1608,318,718,0.443,111,268,0.414,207,450,0.46,0.52,79,91,0.868,24,137,161,133,49,20,103,155
2633,2,2013,22,1,2,82,82,2936,508,1205,0.422,211,526,0.401,297,679,0.437,0.509,132,157,0.841,32,274,306,183,86,45,157,237
2633,3,2014,23,1,2,81,81,2868,559,1259,0.444,223,535,0.417,336,724,0.464,0.533,147,185,0.795,38,211,249,181,74,37,135,234
2633,4,2015,24,1,2,8,8,270,63,135,0.467,26,53,0.491,37,82,0.451,0.563,42,48,0.875,3,23,26,27,11,5,21,13
2639,1,2010,22,1,2,73,17,1872,398,883,0.451,117,313,0.374,281,570,0.493,0.517,144,177,0.814,72,139,211,114,58,11,76,127
2639,2,2011,23,1,2,46,0,745,137,334,0.41,35,93,0.376,102,241,0.423,0.463,50,66,0.758,25,106,131,43,19,4,37,50
2639,2,2011,23,1,2,27,23,1030,213,473,0.45,53,147,0.361,160,326,0.491,0.506,95,118,0.805,36,91,127,92,45,5,56,60
2639,2,2011,23,1,2,73,23,1775,350,807,0.434,88,240,0.367,262,567,0.462,0.488,145,184,0.788,61,197,258,135,64,9,93,110
2639,3,2012,24,1,2,51,51,1780,352,803,0.438,107,310,0.345,245,493,0.497,0.505,141,163,0.865,84,104,188,98,71,12,84,111
2639,4,2013,25,1,2,72,8,1726,332,774,0.429,141,379,0.372,191,395,0.484,0.52,111,126,0.881,50,131,181,91,61,4,68,105
2639,5,2014,26,1,2,26,1,620,110,266,0.414,52,137,0.38,58,129,0.45,0.511,48,60,0.8,18,56,74,30,27,3,29,36
2639,5,2014,26,1,2,46,26,1121,142,373,0.381,57,179,0.318,85,194,0.438,0.457,42,52,0.808,39,85,124,47,31,8,38,74
2639,5,2014,26,1,2,72,27,1741,252,639,0.394,109,316,0.345,143,323,0.443,0.48,90,112,0.804,57,141,198,77,58,11,67,110
2639,6,2015,27,1,2,7,0,101,21,44,0.477,4,12,0.333,17,32,0.531,0.523,5,7,0.714,3,6,9,3,1,2,2,6
2641,3,1986,24,1,2,70,27,1754,310,684,0.453,1,24,0.042,309,660,0.468,0.454,75,90,0.833,21,100,121,193,93,5,102,157
2641,14,1997,35,1,2,21,0,334,28,74,0.378,8,20,0.4,20,54,0.37,0.432,6,8,0.75,5,19,24,40,15,3,13,29
2655,1,1981,23,1,2,75,-1,1768,399,806,0.495,9,29,0.31,390,777,0.502,0.501,161,226,0.712,32,111,143,273,59,10,219,234
2655,2,1982,24,1,2,77,1,1909,511,979,0.522,25,59,0.424,486,920,0.528,0.535,227,306,0.742,43,91,134,283,64,17,214,269
2655,3,1983,25,1,2,81,81,2474,626,1250,0.501,22,76,0.289,604,1174,0.514,0.51,324,411,0.788,42,183,225,365,80,17,271,255
2655,4,1984,26,1,2,78,72,2556,593,1125,0.527,12,38,0.316,581,1087,0.534,0.532,390,465,0.839,57,136,193,373,70,23,297,251
2655,5,1985,27,1,2,70,65,2237,450,914,0.492,39,105,0.371,411,809,0.508,0.514,306,355,0.862,35,142,177,363,65,24,224,211
2655,6,1987,29,1,2,52,12,1058,197,437,0.451,22,67,0.328,175,370,0.473,0.476,133,167,0.796,16,69,85,188,18,8,112,78
2655,7,1988,30,1,2,29,15,522,72,171,0.421,9,27,0.333,63,144,0.438,0.447,58,72,0.806,8,39,47,108,11,6,50,35
2660,1,2002,25,1,2,65,13,1075,135,341,0.396,37,126,0.294,98,215,0.456,0.45,82,105,0.781,47,75,122,40,25,9,49,64
2660,2,2003,26,1,2,17,0,109,16,36,0.444,7,13,0.538,9,23,0.391,0.542,14,20,0.7,3,9,12,3,4,2,8,9
2684,1,2009,24,1,2,30,1,282,52,121,0.43,8,23,0.348,44,98,0.449,0.463,26,33,0.788,19,12,31,12,5,1,14,14
2685,1,1983,23,1,2,78,59,1830,299,647,0.462,14,30,0.467,285,617,0.462,0.473,43,64,0.672,75,141,216,195,56,6,70,235
2685,2,1984,24,1,2,63,21,1228,225,450,0.5,6,16,0.375,219,434,0.505,0.507,25,33,0.758,43,87,130,138,63,8,54,124
2685,3,1985,25,1,2,77,46,1819,293,606,0.483,29,72,0.403,264,534,0.494,0.507,38,48,0.792,74,114,188,199,75,15,64,195
2685,4,1986,26,1,2,77,23,1788,349,740,0.472,41,91,0.451,308,649,0.475,0.499,79,100,0.79,70,99,169,192,65,8,70,167
2685,5,1987,27,1,2,70,15,1691,325,691,0.47,68,161,0.422,257,530,0.485,0.52,77,101,0.762,49,86,135,166,116,13,78,169
2685,6,1988,28,1,2,71,4,1248,193,455,0.424,69,167,0.413,124,288,0.431,0.5,51,71,0.718,32,87,119,117,53,6,47,158
2685,7,1989,29,1,2,81,24,1824,263,579,0.454,118,296,0.399,145,283,0.512,0.556,43,55,0.782,55,121,176,132,88,6,59,163
2685,8,1990,30,1,2,81,2,1725,253,606,0.417,95,245,0.388,158,361,0.438,0.496,66,86,0.767,57,117,174,173,74,8,73,159
2685,9,1991,31,1,2,65,13,1194,191,434,0.44,64,153,0.418,127,281,0.452,0.514,17,27,0.63,33,72,105,111,44,9,46,120
2685,10,1992,32,1,2,24,0,415,60,129,0.465,19,48,0.396,41,81,0.506,0.539,16,20,0.8,8,29,37,27,21,3,14,39
2685,11,1993,33,1,2,69,0,909,143,295,0.485,52,131,0.397,91,164,0.555,0.573,18,22,0.818,16,55,71,82,24,6,18,65
2689,5,1986,26,1,2,73,0,1324,165,379,0.435,0,9,0,165,370,0.446,0.435,39,53,0.736,64,137,201,165,70,6,80,150
2690,1,2011,22,1,2,78,14,1797,225,529,0.425,14,44,0.318,211,485,0.435,0.439,101,125,0.808,42,264,306,159,49,14,80,138
2690,5,2015,26,1,2,8,1,174,28,59,0.475,1,9,0.111,27,50,0.54,0.483,10,11,0.909,3,23,26,24,5,2,17,17
2705,2,2005,23,1,2,77,77,2974,630,1318,0.478,13,45,0.289,617,1273,0.485,0.483,581,762,0.762,110,287,397,520,121,82,321,230
2705,3,2006,24,1,2,75,75,2892,699,1413,0.495,13,76,0.171,686,1337,0.513,0.499,629,803,0.783,107,323,430,503,146,58,268,217
2705,4,2007,25,1,2,51,50,1931,472,962,0.491,21,79,0.266,451,883,0.511,0.502,432,535,0.807,51,188,239,384,107,62,216,117
2705,5,2008,26,1,2,51,49,1954,439,937,0.469,22,77,0.286,417,860,0.485,0.48,354,467,0.758,45,169,214,354,87,37,224,137
2705,6,2009,27,1,2,79,79,3048,854,1739,0.491,88,278,0.317,766,1461,0.524,0.516,590,771,0.765,89,309,398,589,173,106,272,178
2705,7,2010,28,1,2,77,77,2792,719,1511,0.476,73,243,0.3,646,1268,0.509,0.5,534,702,0.761,107,266,373,501,142,82,252,181
2705,8,2011,29,1,2,76,76,2823,692,1384,0.5,63,206,0.306,629,1178,0.534,0.523,494,652,0.758,123,362,485,346,111,87,237,197
2705,9,2012,30,1,2,49,49,1625,416,837,0.497,15,56,0.268,401,781,0.513,0.506,235,297,0.791,73,164,237,225,82,63,129,110
2705,10,2013,31,1,2,69,69,2391,569,1093,0.521,17,66,0.258,552,1027,0.537,0.528,308,425,0.725,86,258,344,352,128,56,194,140
2705,11,2014,32,1,2,54,53,1775,415,761,0.545,9,32,0.281,406,729,0.557,0.551,189,258,0.733,60,181,241,252,79,29,161,106
2705,12,2015,33,1,2,8,8,259,63,124,0.508,5,11,0.455,58,113,0.513,0.528,27,39,0.692,10,18,28,51,10,5,23,12
2709,1,2013,21,1,2,61,48,1756,336,815,0.412,63,203,0.31,273,612,0.446,0.451,159,213,0.746,22,127,149,183,59,16,121,113
2709,2,2014,22,1,2,70,24,2072,430,993,0.433,92,250,0.368,338,743,0.455,0.479,161,235,0.685,32,163,195,209,63,17,154,153
2709,3,2015,23,1,2,7,3,173,25,67,0.373,5,11,0.455,20,56,0.357,0.41,11,17,0.647,3,7,10,14,9,0,9,14
2716,5,1988,26,1,2,52,0,940,114,291,0.392,0,6,0,114,285,0.4,0.392,82,105,0.781,43,84,127,100,62,10,69,105
2716,9,1992,30,1,2,74,4,1541,161,381,0.423,0,10,0,161,371,0.434,0.423,65,105,0.619,85,153,238,205,63,18,79,134
2716,10,1993,31,1,2,9,2,144,3,19,0.158,0,1,0,3,18,0.167,0.158,2,6,0.333,4,15,19,9,10,0,13,12
2718,2,2010,22,1,2,27,13,739,117,226,0.518,50,116,0.431,67,110,0.609,0.628,37,47,0.787,15,68,83,37,23,3,26,79
2718,2,2010,22,1,2,35,13,768,120,232,0.517,50,116,0.431,70,116,0.603,0.625,39,49,0.796,15,73,88,40,23,3,28,83
2718,3,2011,23,1,2,61,1,784,104,236,0.441,59,153,0.386,45,83,0.542,0.566,31,44,0.705,16,106,122,34,21,6,37,81
2718,4,2012,24,1,2,32,8,620,68,171,0.398,36,113,0.319,32,58,0.552,0.503,17,20,0.85,9,71,80,37,19,7,35,84
2733,1,1994,23,1,2,48,0,386,60,115,0.522,14,28,0.5,46,87,0.529,0.583,28,34,0.824,6,32,38,71,15,3,30,41
2733,2,1995,24,1,2,80,30,1435,206,469,0.439,71,196,0.362,135,273,0.495,0.515,40,52,0.769,18,75,93,121,37,16,71,135
2733,3,1996,25,1,2,33,8,523,49,115,0.426,19,54,0.352,30,61,0.492,0.509,36,46,0.783,11,37,48,95,22,4,34,49
2733,3,1996,25,1,2,44,8,610,61,148,0.412,22,66,0.333,39,82,0.476,0.486,42,52,0.808,13,42,55,106,25,4,41,53
2733,4,1997,26,1,2,59,16,1041,148,325,0.455,57,148,0.385,91,177,0.514,0.543,49,62,0.79,21,86,107,113,28,3,61,75
2733,5,1998,27,1,2,19,0,108,13,24,0.542,3,8,0.375,10,16,0.625,0.604,9,11,0.818,2,13,15,14,3,1,10,11
2733,5,1998,27,1,2,19,0,127,11,29,0.379,3,14,0.214,8,15,0.533,0.431,17,17,1,3,6,9,21,5,0,17,17
2733,5,1998,27,1,2,38,0,235,24,53,0.453,6,22,0.273,18,31,0.581,0.509,26,28,0.929,5,19,24,35,8,1,27,28
2733,6,1999,28,1,2,33,13,506,35,95,0.368,12,38,0.316,23,57,0.404,0.432,19,23,0.826,10,40,50,58,10,3,32,63
2755,1,2008,22,1,2,18,0,146,21,48,0.438,4,12,0.333,17,36,0.472,0.479,7,13,0.538,4,16,20,15,5,0,14,16
2757,1,1998,23,1,2,66,36,1539,201,498,0.404,44,137,0.321,157,361,0.435,0.448,65,83,0.783,47,80,127,78,53,25,72,143
2757,2,1999,24,1,2,38,6,761,73,184,0.397,37,97,0.381,36,87,0.414,0.497,22,32,0.688,35,54,89,30,25,18,34,87
2773,1,2009,22,1,2,56,19,1166,113,246,0.459,32,93,0.344,81,153,0.529,0.524,41,58,0.707,31,99,130,101,47,25,69,81
2773,2,2010,23,1,2,12,0,144,12,33,0.364,7,19,0.368,5,14,0.357,0.47,5,6,0.833,1,17,18,11,6,6,4,13
2779,1,2006,19,1,2,61,18,1070,139,348,0.399,65,182,0.357,74,166,0.446,0.493,61,71,0.859,29,101,130,34,21,14,43,90
2779,5,2011,24,1,2,46,1,1094,152,340,0.447,55,132,0.417,97,208,0.466,0.528,94,122,0.77,36,111,147,53,28,9,58,101
2779,6,2012,25,1,2,47,26,1140,115,272,0.423,37,109,0.339,78,163,0.479,0.491,57,72,0.792,42,126,168,40,31,17,46,86
2782,1,2010,23,1,2,69,19,1368,236,458,0.515,2,15,0.133,234,443,0.528,0.517,44,64,0.688,42,150,192,101,39,25,65,126
2787,3,2002,25,1,2,74,69,2348,487,1039,0.469,66,172,0.384,421,867,0.486,0.5,215,290,0.741,121,323,444,204,113,25,191,208
2787,4,2003,26,1,2,75,65,2396,437,990,0.441,38,130,0.292,399,860,0.464,0.461,226,313,0.722,98,296,394,246,123,18,215,220
2787,5,2004,27,1,2,13,10,404,68,175,0.389,1,8,0.125,67,167,0.401,0.391,21,27,0.778,21,40,61,35,20,3,32,38
2787,5,2004,27,1,2,59,17,1468,295,675,0.437,21,61,0.344,274,614,0.446,0.453,117,156,0.75,57,142,199,104,71,16,129,159
2787,5,2004,27,1,2,72,27,1872,363,850,0.427,22,69,0.319,341,781,0.437,0.44,138,183,0.754,78,182,260,139,91,19,161,197
2787,6,2005,28,1,2,69,19,1489,272,617,0.441,36,104,0.346,236,513,0.46,0.47,141,188,0.75,49,180,229,80,85,27,90,165
2787,7,2006,29,1,2,52,41,1684,284,613,0.463,10,45,0.222,274,568,0.482,0.471,129,190,0.679,142,259,401,144,94,25,126,156
2787,9,2008,31,1,2,22,0,438,77,157,0.49,4,12,0.333,73,145,0.503,0.503,35,53,0.66,21,50,71,17,24,8,27,44
2787,9,2008,31,1,2,51,7,1124,175,412,0.425,8,38,0.211,167,374,0.447,0.434,111,174,0.638,63,197,260,80,51,24,76,113
2787,9,2008,31,1,2,73,7,1562,252,569,0.443,12,50,0.24,240,519,0.462,0.453,146,227,0.643,84,247,331,97,75,32,103,157
2788,1,1998,23,1,2,39,2,395,48,116,0.414,1,6,0.167,47,110,0.427,0.418,31,43,0.721,22,46,68,34,15,4,31,40
2792,2,2004,24,1,2,81,68,2179,262,612,0.428,69,181,0.381,193,431,0.448,0.484,153,206,0.743,60,236,296,183,101,7,129,176
2792,3,2005,25,1,2,55,32,1125,137,320,0.428,32,99,0.323,105,221,0.475,0.478,109,141,0.773,20,119,139,84,39,5,58,105
2792,3,2005,25,1,2,71,32,1317,149,371,0.402,34,110,0.309,115,261,0.441,0.447,129,169,0.763,26,141,167,103,44,5,73,121
2794,8,2001,30,1,2,82,82,3106,523,1239,0.422,97,258,0.376,426,981,0.434,0.461,271,339,0.799,64,160,224,361,128,16,171,220
2794,9,2002,31,1,2,67,63,2487,364,910,0.4,85,256,0.332,279,654,0.427,0.447,138,188,0.734,44,99,143,236,74,15,119,147
2794,10,2003,32,1,2,73,73,2710,449,1037,0.433,134,316,0.424,315,721,0.437,0.498,185,237,0.781,38,137,175,251,109,9,132,173
2794,11,2004,33,1,2,61,60,2001,311,800,0.389,92,285,0.323,219,515,0.425,0.446,137,182,0.753,28,106,134,175,71,14,100,147
2794,12,2005,34,1,2,26,26,934,133,342,0.389,28,80,0.35,105,262,0.401,0.43,67,76,0.882,12,73,85,109,35,1,54,65
2794,12,2005,34,1,2,54,53,1840,201,498,0.404,90,235,0.383,111,263,0.422,0.494,95,113,0.841,26,117,143,156,61,8,59,150
2794,12,2005,34,1,2,80,79,2774,334,840,0.398,118,315,0.375,216,525,0.411,0.468,162,189,0.857,38,190,228,265,96,9,113,215
2794,13,2006,35,1,2,71,59,2372,226,561,0.403,99,271,0.365,127,290,0.438,0.491,151,187,0.807,24,154,178,204,59,6,120,212
2794,14,2007,36,1,2,35,5,352,22,75,0.293,9,38,0.237,13,37,0.351,0.353,20,28,0.714,3,32,35,37,12,4,17,32
2797,1,2008,23,1,2,64,2,269,21,49,0.429,0,4,0,21,45,0.467,0.429,17,26,0.654,26,22,48,13,12,4,9,61
2797,2,2009,24,1,2,53,3,269,14,34,0.412,1,1,1,13,33,0.394,0.426,14,30,0.467,24,32,56,19,18,4,13,35
2797,3,2010,25,1,2,39,1,142,12,21,0.571,0,1,0,12,20,0.6,0.571,6,10,0.6,8,19,27,9,8,0,7,25
2797,4,2011,26,1,2,6,3,116,9,21,0.429,1,4,0.25,8,17,0.471,0.452,3,5,0.6,2,9,11,10,7,0,2,13
2800,1,2005,21,1,2,39,7,507,66,155,0.426,24,67,0.358,42,88,0.477,0.503,19,27,0.704,14,51,65,53,21,8,24,69
2800,3,2007,23,1,2,69,47,2219,306,717,0.427,65,178,0.365,241,539,0.447,0.472,168,197,0.853,32,176,208,304,74,34,140,152
2800,5,2009,25,1,2,64,64,2152,285,624,0.457,91,228,0.399,194,396,0.49,0.53,90,108,0.833,31,172,203,226,94,13,92,125
2800,6,2010,26,1,2,60,3,1500,194,436,0.445,25,77,0.325,169,359,0.471,0.474,115,142,0.81,29,140,169,196,55,28,90,86
2801,1,1990,22,1,2,52,0,378,53,135,0.393,3,11,0.273,50,124,0.403,0.404,26,32,0.813,24,46,70,18,10,6,31,61
2801,2,1991,23,1,2,75,1,824,118,246,0.48,0,1,0,118,245,0.482,0.48,58,84,0.69,56,80,136,48,35,23,41,115
2801,3,1992,24,1,2,80,72,2540,463,894,0.518,4,23,0.174,459,871,0.527,0.52,186,231,0.805,107,150,257,281,66,26,120,239
2801,4,1993,25,1,2,80,80,3104,646,1249,0.517,2,23,0.087,644,1226,0.525,0.518,249,296,0.841,89,158,247,235,85,21,165,279
2801,5,1994,26,1,2,72,61,2182,434,891,0.487,1,8,0.125,433,883,0.49,0.488,187,231,0.81,61,170,231,172,65,24,137,236
2801,6,1995,27,1,2,71,65,2328,351,762,0.461,11,61,0.18,340,701,0.485,0.468,206,246,0.837,60,167,227,185,65,24,126,250
2801,7,1996,28,1,2,73,16,1639,175,393,0.445,1,13,0.077,174,380,0.458,0.447,114,144,0.792,48,113,161,119,30,17,81,228
2801,8,1997,29,1,2,68,66,1920,226,484,0.467,15,45,0.333,211,439,0.481,0.482,64,94,0.681,37,111,148,113,61,24,66,218
2801,9,1998,30,1,2,38,10,688,64,171,0.374,0,2,0,64,169,0.379,0.374,29,40,0.725,23,59,82,45,11,5,21,97
2801,10,1999,31,1,2,14,2,294,31,65,0.477,0,2,0,31,63,0.492,0.477,19,25,0.76,5,20,25,19,16,7,12,38
2801,11,2000,32,1,2,38,0,581,59,145,0.407,0,3,0,59,142,0.415,0.407,34,40,0.85,18,53,71,43,12,8,19,80
2801,12,2001,33,1,2,15,6,171,11,38,0.289,0,2,0,11,36,0.306,0.289,6,7,0.857,4,11,15,14,3,4,4,21
2806,1,1980,29,1,2,82,-1,2665,692,1317,0.525,26,93,0.28,666,1224,0.544,0.535,382,443,0.862,46,141,187,416,119,35,207,162
2806,2,1981,30,1,2,36,-1,1078,221,500,0.442,6,25,0.24,215,475,0.453,0.448,153,184,0.832,11,57,68,148,46,14,78,70
2806,3,1982,31,1,2,18,12,451,86,194,0.443,2,8,0.25,84,186,0.452,0.448,36,47,0.766,9,13,22,100,19,8,47,61
2806,4,1983,32,1,2,80,59,1978,318,693,0.459,14,48,0.292,304,645,0.471,0.469,148,184,0.804,19,96,115,439,87,16,196,180
2806,5,1984,33,1,2,59,2,865,144,313,0.46,7,26,0.269,137,287,0.477,0.471,117,142,0.824,8,35,43,148,41,6,77,69
2818,2,2003,22,1,2,72,19,1563,260,638,0.408,32,134,0.239,228,504,0.452,0.433,98,125,0.784,43,170,213,121,45,32,156,134
2822,1,1985,22,1,2,39,0,234,52,124,0.419,4,11,0.364,48,113,0.425,0.435,21,31,0.677,15,21,36,29,5,2,30,24
2822,2,1986,23,1,2,43,4,343,74,168,0.44,6,21,0.286,68,147,0.463,0.458,19,23,0.826,17,27,44,53,18,2,25,24
2832,1,1981,23,1,2,47,-1,782,149,306,0.487,2,6,0.333,147,300,0.49,0.49,50,65,0.769,29,77,106,68,47,6,48,98
2832,2,1982,24,1,2,23,4,266,25,71,0.352,0,1,0,25,70,0.357,0.352,4,7,0.571,13,27,40,19,12,1,14,31
2841,2,1981,26,1,2,80,-1,2238,330,715,0.462,1,10,0.1,329,705,0.467,0.462,137,163,0.84,86,196,282,272,102,23,175,170
2844,5,2009,29,1,2,41,14,636,77,213,0.362,27,72,0.375,50,141,0.355,0.425,37,46,0.804,20,50,70,37,22,7,37,55
2844,9,2013,33,1,2,61,21,1095,145,316,0.459,17,51,0.333,128,265,0.483,0.486,81,109,0.743,32,73,105,91,37,18,49,98
2862,2,1997,24,1,2,72,67,2435,374,820,0.456,2,8,0.25,372,812,0.458,0.457,328,436,0.752,126,203,329,129,72,13,139,213
2862,10,2005,32,1,2,34,18,583,55,145,0.379,11,33,0.333,44,112,0.393,0.417,38,53,0.717,16,61,77,50,22,2,26,67
2862,10,2005,32,1,2,21,21,739,87,185,0.47,17,40,0.425,70,145,0.483,0.516,74,108,0.685,28,67,95,42,16,2,34,80
2862,10,2005,32,1,2,55,39,1322,142,330,0.43,28,73,0.384,114,257,0.444,0.473,112,161,0.696,44,128,172,92,38,4,60,147
2875,4,2009,22,1,2,81,0,1919,336,844,0.398,63,220,0.286,273,624,0.438,0.435,304,385,0.79,36,129,165,242,85,14,151,128
2875,6,2011,24,1,2,75,0,1747,323,795,0.406,88,253,0.348,235,542,0.434,0.462,293,356,0.823,32,117,149,252,47,17,102,128
2875,8,2013,26,1,2,39,9,1119,187,443,0.422,72,196,0.367,115,247,0.466,0.503,105,121,0.868,8,72,80,139,44,10,74,55
2875,10,2015,28,1,2,10,0,185,33,81,0.407,9,28,0.321,24,53,0.453,0.463,28,38,0.737,4,7,11,8,11,0,11,11
2882,1,2004,21,1,2,57,0,772,115,303,0.38,10,39,0.256,105,264,0.398,0.396,44,56,0.786,23,49,72,76,28,2,51,87
2882,9,2012,29,1,2,52,1,1472,260,611,0.426,93,239,0.389,167,372,0.449,0.502,72,80,0.9,23,76,99,160,51,7,86,103
2884,3,1982,27,1,2,82,69,2732,639,1383,0.462,9,54,0.167,630,1329,0.474,0.465,387,465,0.832,117,208,325,488,199,43,290,302
2884,5,1984,29,1,2,76,63,2230,418,939,0.445,25,81,0.309,393,858,0.458,0.458,263,318,0.827,67,200,267,449,162,26,219,274
2886,2,2011,24,1,2,80,9,1626,268,572,0.469,102,241,0.423,166,331,0.502,0.558,100,134,0.746,45,171,216,121,28,3,57,124
2886,3,2012,25,1,2,33,13,747,106,255,0.416,33,107,0.308,73,148,0.493,0.48,29,40,0.725,27,66,93,60,20,3,33,34
2887,1,1983,25,1,2,44,0,346,56,135,0.415,0,3,0,56,132,0.424,0.415,35,53,0.66,15,23,38,37,20,4,38,42
2898,2,2011,23,1,2,10,0,206,29,73,0.397,4,12,0.333,25,61,0.41,0.425,5,10,0.5,3,33,36,31,5,0,25,21
2898,2,2011,23,1,2,21,0,290,43,115,0.374,6,22,0.273,37,93,0.398,0.4,14,21,0.667,4,47,51,38,9,0,33,25
2898,3,2012,24,1,2,12,0,181,20,57,0.351,8,19,0.421,12,38,0.316,0.421,6,12,0.5,2,26,28,10,4,1,10,16
2898,3,2012,24,1,2,18,0,369,65,141,0.461,8,27,0.296,57,114,0.5,0.489,21,34,0.618,11,63,74,55,16,6,33,19
2898,3,2012,24,1,2,30,0,550,85,198,0.429,16,46,0.348,69,152,0.454,0.47,27,46,0.587,13,89,102,65,20,7,43,35
2901,1,1980,28,1,2,30,-1,603,153,356,0.43,3,16,0.188,150,340,0.441,0.434,40,50,0.8,14,31,45,39,10,10,49,66
2901,1,1980,28,1,2,28,-1,771,206,461,0.447,8,19,0.421,198,442,0.448,0.456,76,88,0.864,24,30,54,87,26,9,43,71
2901,1,1980,28,1,2,58,-1,1374,359,817,0.439,11,35,0.314,348,782,0.445,0.446,116,138,0.841,38,61,99,126,36,19,92,137
2901,2,1981,29,1,2,9,-1,112,18,56,0.321,1,6,0.167,17,50,0.34,0.33,5,6,0.833,0,7,7,17,4,1,12,13
2907,1,1980,24,1,2,16,-1,143,7,25,0.28,0,0,-1,7,25,0.28,0.28,3,6,0.5,6,10,16,12,2,0,8,11
2917,2,1993,26,1,2,39,0,340,61,139,0.439,4,19,0.211,57,120,0.475,0.453,17,22,0.773,17,32,49,13,10,10,15,40
2919,1,1987,23,1,2,77,9,1612,259,602,0.43,13,52,0.25,246,550,0.447,0.441,149,201,0.741,70,86,156,155,93,19,128,169
2919,2,1988,24,1,2,61,22,1419,218,545,0.4,10,40,0.25,208,505,0.412,0.409,99,132,0.75,44,57,101,119,47,22,104,125
2919,3,1989,25,1,2,33,6,372,54,115,0.47,2,6,0.333,52,109,0.477,0.478,27,34,0.794,12,25,37,73,9,2,35,43
2919,4,1990,26,1,2,78,2,1856,220,491,0.448,0,13,0,220,478,0.46,0.448,87,112,0.777,62,133,195,208,89,18,127,154
2919,5,1991,27,1,2,25,0,563,53,138,0.384,1,9,0.111,52,129,0.403,0.388,29,41,0.707,24,51,75,46,19,5,42,66
2919,6,1992,28,1,2,81,72,2127,266,572,0.465,1,18,0.056,265,554,0.478,0.466,105,146,0.719,80,189,269,247,123,21,124,162
2919,8,1994,30,1,2,50,36,1005,136,283,0.481,4,12,0.333,132,271,0.487,0.488,34,51,0.667,30,104,134,104,42,6,53,85
2919,9,1995,31,1,2,52,9,515,50,122,0.41,4,22,0.182,46,100,0.46,0.426,18,24,0.75,11,49,60,56,19,6,27,60
2919,10,1996,32,1,2,60,3,695,88,212,0.415,15,34,0.441,73,178,0.41,0.45,32,41,0.78,17,39,56,58,20,4,42,66
2919,11,1997,33,1,2,65,2,929,89,214,0.416,25,71,0.352,64,143,0.448,0.474,33,40,0.825,23,51,74,80,44,5,37,108
2919,12,1998,34,1,2,58,2,546,66,140,0.471,3,7,0.429,63,133,0.474,0.482,15,29,0.517,19,60,79,37,21,3,37,58
2926,1,1980,27,1,2,80,-1,2623,535,1116,0.479,38,102,0.373,497,1014,0.49,0.496,184,214,0.86,48,175,223,362,101,28,186,208
2926,2,1981,28,1,2,69,-1,1771,331,697,0.475,18,51,0.353,313,646,0.485,0.488,119,137,0.869,32,108,140,229,70,10,136,185
2926,3,1982,29,1,2,61,13,1829,404,806,0.501,36,93,0.387,368,713,0.516,0.524,123,156,0.788,51,119,170,253,57,9,118,187
2926,4,1983,30,1,2,57,12,1361,255,587,0.434,22,68,0.324,233,519,0.449,0.453,73,85,0.859,35,75,110,156,45,4,81,132
2936,1,1984,24,1,2,78,1,1071,160,318,0.503,2,5,0.4,158,313,0.505,0.506,28,46,0.609,14,57,71,71,17,0,32,82
2936,2,1985,25,1,2,41,22,1168,187,352,0.531,2,7,0.286,185,345,0.536,0.534,30,41,0.732,16,57,73,125,28,7,57,58
2936,3,1986,26,1,2,81,79,2760,467,881,0.53,5,16,0.313,462,865,0.534,0.533,104,135,0.77,51,119,170,306,81,14,114,118
2936,4,1987,27,1,2,71,65,2049,398,792,0.503,4,12,0.333,394,780,0.505,0.505,100,127,0.787,30,94,124,211,39,16,88,107
2936,5,1988,28,1,2,82,82,2412,376,787,0.478,0,0,-1,376,787,0.478,0.478,71,89,0.798,39,131,170,302,50,18,82,117
2936,9,1992,32,1,2,24,0,115,8,19,0.421,0,0,-1,8,19,0.421,0.421,1,2,0.5,1,8,9,11,2,0,3,4
2937,1,1982,23,1,2,19,0,238,36,105,0.343,0,6,0,36,99,0.364,0.343,20,28,0.714,22,22,44,11,9,1,11,34
2937,1,1982,23,1,2,29,5,692,143,276,0.518,3,18,0.167,140,258,0.543,0.524,73,91,0.802,29,61,90,47,22,8,60,74
2937,1,1982,23,1,2,48,5,930,179,381,0.47,3,24,0.125,176,357,0.493,0.474,93,119,0.782,51,83,134,58,31,9,71,108
2937,3,1984,25,1,2,81,81,2236,467,945,0.494,3,21,0.143,464,924,0.502,0.496,223,271,0.823,94,181,275,166,64,32,126,207
2937,4,1985,26,1,2,80,79,2545,515,1061,0.485,7,33,0.212,508,1028,0.494,0.489,166,214,0.776,99,180,279,236,84,52,120,187
2937,5,1986,27,1,2,78,34,1749,355,817,0.435,5,37,0.135,350,780,0.449,0.438,187,239,0.782,80,164,244,114,57,19,107,171
2937,6,1987,28,1,2,54,0,657,121,310,0.39,7,25,0.28,114,285,0.4,0.402,109,139,0.784,39,55,94,34,19,11,34,83
2943,1,1981,22,1,2,81,-1,949,165,373,0.442,1,5,0.2,164,368,0.446,0.444,49,64,0.766,33,64,97,75,36,12,54,95
2943,2,1982,23,1,2,7,0,145,30,68,0.441,0,1,0,30,67,0.448,0.441,23,32,0.719,5,8,13,16,7,2,9,21
2943,2,1982,23,1,2,76,74,2186,508,1001,0.507,7,24,0.292,501,977,0.513,0.511,198,254,0.78,97,137,234,206,135,33,144,199
2943,2,1982,23,1,2,83,74,2331,538,1069,0.503,7,25,0.28,531,1044,0.509,0.507,221,286,0.773,102,145,247,222,142,35,153,220
2943,3,1983,24,1,2,81,3,2426,584,1154,0.506,7,33,0.212,577,1121,0.515,0.509,298,377,0.79,84,164,248,254,137,59,174,203
2943,4,1984,25,1,2,71,12,1838,389,816,0.477,2,8,0.25,387,808,0.479,0.478,247,302,0.818,62,113,175,175,83,28,115,174
2943,5,1985,26,1,2,78,3,1998,530,1068,0.496,5,21,0.238,525,1047,0.501,0.499,264,330,0.8,69,129,198,143,117,28,139,216
2943,6,1986,27,1,2,81,51,2417,510,1073,0.475,2,13,0.154,508,1060,0.479,0.476,242,289,0.837,94,132,226,197,92,37,145,215
2943,7,1987,28,1,2,74,66,2126,494,1130,0.437,34,123,0.276,460,1007,0.457,0.452,240,290,0.828,68,94,162,196,100,16,168,201
2943,8,1988,29,1,2,80,77,2534,562,1263,0.445,18,78,0.231,544,1185,0.459,0.452,296,341,0.868,64,126,190,273,109,26,186,210
2943,9,1989,30,1,2,81,79,2259,410,936,0.438,31,89,0.348,379,847,0.447,0.455,195,237,0.823,51,143,194,206,89,18,136,195
2943,10,1990,31,1,2,61,11,972,160,405,0.395,12,41,0.293,148,364,0.407,0.41,62,86,0.721,25,63,88,66,42,11,49,100
2943,11,1991,32,1,2,11,3,125,21,54,0.389,1,6,0.167,20,48,0.417,0.398,10,12,0.833,2,9,11,10,5,4,7,11
2943,11,1991,32,1,2,15,3,171,26,77,0.338,1,7,0.143,25,70,0.357,0.344,11,13,0.846,3,10,13,15,5,5,12,18
2947,1,2006,21,1,2,7,0,135,21,51,0.412,6,17,0.353,15,34,0.441,0.471,14,16,0.875,3,15,18,5,1,0,8,8
2947,2,2007,22,1,2,19,0,190,24,60,0.4,6,20,0.3,18,40,0.45,0.45,13,18,0.722,7,14,21,15,9,1,6,6
2952,1,2006,21,1,2,39,0,370,29,81,0.358,1,15,0.067,28,66,0.424,0.364,11,22,0.5,8,22,30,12,4,3,21,42
2952,2,2007,22,1,2,63,23,1137,110,251,0.438,19,59,0.322,91,192,0.474,0.476,44,73,0.603,38,137,175,55,30,10,43,120
2952,3,2008,23,1,2,15,0,176,21,42,0.5,5,9,0.556,16,33,0.485,0.56,5,9,0.556,5,17,22,13,2,4,11,22
2952,3,2008,23,1,2,41,10,1056,115,287,0.401,27,101,0.267,88,186,0.473,0.448,41,58,0.707,35,90,125,67,26,17,39,105
2952,3,2008,23,1,2,56,10,1232,136,329,0.413,32,110,0.291,104,219,0.475,0.462,46,67,0.687,40,107,147,80,28,21,50,127
2964,1,2013,19,1,2,35,0,272,33,86,0.384,4,16,0.25,29,70,0.414,0.407,21,29,0.724,13,15,28,43,8,4,29,34
2964,2,2014,20,1,2,72,16,1765,345,808,0.427,40,188,0.213,305,620,0.492,0.452,209,326,0.641,69,159,228,217,78,16,204,151
2964,3,2015,21,1,2,9,9,295,62,141,0.44,16,44,0.364,46,97,0.474,0.496,43,70,0.614,9,29,38,57,20,3,40,30
2977,9,2002,30,1,2,27,2,757,129,314,0.411,34,98,0.347,95,216,0.44,0.465,65,77,0.844,9,76,85,113,14,4,40,35
2977,10,2003,31,1,2,73,1,2026,342,831,0.412,118,312,0.378,224,519,0.432,0.483,110,144,0.764,35,173,208,312,42,4,123,86
2977,12,2005,33,1,2,53,34,1619,214,561,0.381,100,257,0.389,114,304,0.375,0.471,58,74,0.784,20,141,161,227,44,0,92,70
2986,1,2011,24,1,2,70,1,860,95,233,0.408,25,86,0.291,70,147,0.476,0.461,34,44,0.773,12,61,73,151,22,4,70,83
2986,2,2012,25,1,2,66,26,1706,225,523,0.43,43,135,0.319,182,388,0.469,0.471,96,117,0.821,23,150,173,359,60,8,148,126
2986,4,2014,27,1,2,61,5,1314,212,508,0.417,93,239,0.389,119,269,0.442,0.509,65,76,0.855,15,124,139,228,25,4,101,105
2986,4,2014,27,1,2,79,23,1779,277,658,0.421,109,289,0.377,168,369,0.455,0.504,95,108,0.88,20,153,173,323,31,5,128,143
2995,7,2005,29,1,2,71,34,1410,146,325,0.449,5,15,0.333,141,310,0.455,0.457,76,91,0.835,17,90,107,135,41,1,62,138
2995,8,2006,30,1,2,80,6,1234,107,245,0.437,1,6,0.167,106,239,0.444,0.439,59,81,0.728,16,75,91,123,42,1,52,140
3001,1,1986,22,1,2,57,0,432,59,162,0.364,1,4,0.25,58,158,0.367,0.367,65,70,0.929,11,37,48,69,17,4,49,59
3019,2,2004,24,1,2,77,24,1603,161,416,0.387,50,147,0.34,111,269,0.413,0.447,71,92,0.772,38,158,196,134,62,16,77,122
3019,3,2005,25,1,2,58,8,993,85,210,0.405,31,91,0.341,54,119,0.454,0.479,35,48,0.729,12,109,121,114,40,13,51,92
3019,4,2006,26,1,2,82,24,2059,219,521,0.42,26,87,0.299,193,434,0.445,0.445,155,200,0.775,48,172,220,223,73,13,125,178
3019,5,2007,27,1,2,79,19,2135,236,517,0.456,40,112,0.357,196,405,0.484,0.495,159,204,0.779,47,217,264,254,73,27,119,177
3019,6,2008,28,1,2,81,41,2517,381,799,0.477,39,120,0.325,342,679,0.504,0.501,214,260,0.823,76,273,349,208,93,31,170,171
3019,8,2010,30,1,2,30,28,1129,207,443,0.467,45,117,0.385,162,326,0.497,0.518,137,158,0.867,17,79,96,98,34,4,53,65
3019,8,2010,30,1,2,51,28,1695,230,548,0.42,73,192,0.38,157,356,0.441,0.486,116,147,0.789,18,156,174,125,65,22,70,101
3019,8,2010,30,1,2,81,56,2824,437,991,0.441,118,309,0.382,319,682,0.468,0.501,253,305,0.83,35,235,270,223,99,26,123,166
3019,9,2011,31,1,2,73,70,2554,373,898,0.415,83,219,0.379,290,679,0.427,0.462,195,240,0.813,27,239,266,252,72,28,137,157
3019,12,2014,34,1,2,60,0,1281,109,296,0.368,47,121,0.388,62,175,0.354,0.448,33,45,0.733,12,105,117,103,35,11,40,92
3019,12,2014,34,1,2,78,8,1726,150,413,0.363,63,163,0.387,87,250,0.348,0.439,40,52,0.769,20,143,163,147,47,19,54,124
3026,1,2006,25,1,2,16,0,113,16,33,0.485,2,3,0.667,14,30,0.467,0.515,7,10,0.7,4,19,23,3,5,0,8,20
3034,1,2003,23,1,2,75,4,1025,64,207,0.309,13,44,0.295,51,163,0.313,0.341,53,78,0.679,64,120,184,65,45,12,39,91
3038,1,2003,26,1,2,27,0,256,29,93,0.312,4,26,0.154,25,67,0.373,0.333,21,29,0.724,9,16,25,22,14,1,21,33
3066,1,1980,31,1,2,69,-1,1860,276,688,0.401,2,11,0.182,274,677,0.405,0.403,85,118,0.72,51,115,166,250,47,23,163,197
3068,1,1991,22,1,2,82,73,2336,503,1183,0.425,125,334,0.374,378,849,0.445,0.478,153,204,0.75,62,173,235,134,62,25,127,203
3070,1,1984,22,1,2,74,49,1637,334,690,0.484,8,34,0.235,326,656,0.497,0.49,112,139,0.806,50,114,164,177,81,19,116,174
3070,2,1985,23,1,2,81,65,2305,541,1003,0.539,26,60,0.433,515,943,0.546,0.552,187,228,0.82,57,153,210,244,100,17,138,197
3070,3,1986,24,1,2,76,62,2190,507,989,0.513,22,61,0.361,485,928,0.523,0.524,138,176,0.784,55,134,189,164,85,15,110,167
3070,4,1987,25,1,2,82,82,2729,554,1134,0.489,65,149,0.436,489,985,0.496,0.517,224,251,0.892,63,223,286,281,125,18,144,163
3070,5,1988,26,1,2,81,81,3048,710,1348,0.527,62,179,0.346,648,1169,0.554,0.55,272,317,0.858,76,257,333,335,155,27,161,204
3070,6,1989,27,1,2,74,73,2605,588,1198,0.491,77,193,0.399,511,1005,0.508,0.523,195,226,0.863,72,230,302,231,114,27,157,181
3070,7,1990,28,1,2,77,77,2593,472,1005,0.47,93,220,0.423,379,785,0.483,0.516,160,209,0.766,51,191,242,274,77,31,122,180
3070,8,1991,29,1,2,82,82,2630,501,1051,0.477,71,219,0.324,430,832,0.517,0.51,118,148,0.797,54,192,246,177,95,21,85,146
3070,9,1992,30,1,2,82,82,2679,460,1005,0.458,54,157,0.344,406,848,0.479,0.485,244,291,0.838,74,236,310,226,105,28,119,140
3070,10,1993,31,1,2,58,53,1677,296,659,0.449,44,135,0.326,252,524,0.481,0.483,156,184,0.848,27,107,134,157,55,13,70,98
3070,11,1994,32,1,2,67,2,1197,256,548,0.467,27,74,0.365,229,474,0.483,0.492,157,195,0.805,19,91,110,133,62,9,103,80
3070,13,1996,34,1,2,80,0,1894,271,676,0.401,74,221,0.335,197,455,0.433,0.456,203,243,0.835,40,152,192,123,63,22,100,126
3070,14,1997,35,1,2,79,8,1440,163,379,0.43,73,188,0.388,90,191,0.471,0.526,127,151,0.841,21,97,118,99,46,16,53,72
3077,3,1995,24,1,2,60,41,1604,291,669,0.435,22,73,0.301,269,596,0.451,0.451,174,223,0.78,77,137,214,107,72,25,83,173
3077,5,1997,26,1,2,80,79,2456,373,942,0.396,79,222,0.356,294,720,0.408,0.438,254,290,0.876,59,179,238,165,124,45,154,185
3087,1,2007,22,1,2,71,4,868,109,256,0.426,15,42,0.357,94,214,0.439,0.455,23,45,0.511,35,118,153,60,33,11,60,100
3087,2,2008,23,1,2,69,22,1436,180,421,0.428,29,88,0.33,151,333,0.453,0.462,75,104,0.721,50,205,255,129,61,30,93,128
3087,3,2009,24,1,2,23,22,718,73,175,0.417,9,37,0.243,64,138,0.464,0.443,40,48,0.833,28,91,119,46,40,26,27,54
3087,4,2010,25,1,2,82,82,2348,194,441,0.44,41,131,0.313,153,310,0.494,0.486,60,89,0.674,76,311,387,145,97,46,90,154
3087,5,2011,26,1,2,79,79,2049,157,333,0.471,28,102,0.275,129,231,0.558,0.514,59,79,0.747,65,281,346,111,97,38,55,171
3087,6,2012,27,1,2,42,42,914,67,155,0.432,31,71,0.437,36,84,0.429,0.532,38,43,0.884,21,107,128,47,37,17,40,78
3087,7,2013,28,1,2,81,81,2229,224,466,0.481,108,258,0.419,116,208,0.558,0.597,57,69,0.826,58,259,317,125,103,44,64,177
3087,8,2014,29,1,2,61,61,1584,141,340,0.415,48,152,0.316,93,188,0.495,0.485,53,69,0.768,50,170,220,94,79,17,55,90
3091,6,2013,26,1,2,61,0,1652,276,676,0.408,33,107,0.308,243,569,0.427,0.433,291,347,0.839,27,142,169,230,48,7,104,91
3113,1,1999,24,1,2,18,5,185,15,39,0.385,2,7,0.286,13,32,0.406,0.41,8,13,0.615,6,16,22,16,3,0,7,12
3118,9,1988,30,1,2,81,11,1949,474,986,0.481,5,21,0.238,469,965,0.486,0.483,206,240,0.858,71,151,222,162,58,14,118,197
3123,2,2013,22,1,2,45,45,996,109,275,0.396,51,127,0.402,58,148,0.392,0.489,36,47,0.766,31,105,136,75,43,7,37,99
3123,3,2014,23,1,2,74,58,1962,183,484,0.378,76,228,0.333,107,256,0.418,0.457,53,71,0.746,81,227,308,129,92,13,79,209
3123,4,2015,24,1,2,10,10,265,47,93,0.505,16,30,0.533,31,63,0.492,0.591,14,19,0.737,7,28,35,32,7,2,15,32
3124,1,2013,24,1,2,77,16,1840,236,635,0.372,85,288,0.295,151,347,0.435,0.439,108,150,0.72,41,134,175,286,54,27,147,117
3124,2,2014,25,1,2,63,0,664,76,237,0.321,30,102,0.294,46,135,0.341,0.384,68,90,0.756,21,60,81,68,26,16,48,36
3124,3,2015,26,1,2,7,0,125,18,54,0.333,9,26,0.346,9,28,0.321,0.417,23,27,0.852,2,5,7,24,3,0,10,9
3132,3,1982,32,1,2,67,34,1447,251,573,0.438,0,5,0,251,568,0.442,0.438,246,286,0.86,26,83,109,222,40,6,107,109
3157,1,2014,23,1,2,24,0,224,18,57,0.316,7,25,0.28,11,32,0.344,0.377,11,15,0.733,2,12,14,34,9,1,18,27
3164,1,1983,22,1,2,63,1,515,89,238,0.374,9,41,0.22,80,197,0.406,0.393,38,59,0.644,34,34,68,52,36,7,42,93
3165,1,2003,22,1,2,36,0,274,39,103,0.379,7,25,0.28,32,78,0.41,0.413,7,10,0.7,8,23,31,14,14,3,20,31
3165,2,2004,23,1,2,22,0,165,21,60,0.35,4,12,0.333,17,48,0.354,0.383,7,14,0.5,10,15,25,14,7,1,11,20
3166,2,2013,25,1,2,20,0,257,27,78,0.346,7,19,0.368,20,59,0.339,0.391,20,25,0.8,3,25,28,37,5,0,13,17
3166,2,2013,25,1,2,23,0,263,27,78,0.346,7,19,0.368,20,59,0.339,0.391,20,25,0.8,3,25,28,38,5,0,14,17
3166,3,2014,26,1,2,48,1,392,44,117,0.376,10,42,0.238,34,75,0.453,0.419,12,20,0.6,4,40,44,50,10,1,22,19
3169,1,1985,22,1,2,31,0,151,30,58,0.517,0,2,0,30,56,0.536,0.517,13,21,0.619,5,7,12,16,3,0,11,18
3174,1,1980,33,1,2,8,-1,135,33,72,0.458,1,5,0.2,32,67,0.478,0.465,7,8,0.875,2,12,14,7,3,2,9,21
3178,1,1993,22,1,2,80,6,1266,125,289,0.433,2,14,0.143,123,275,0.447,0.436,95,120,0.792,32,64,96,196,48,16,68,96
3178,3,1995,24,1,2,64,17,1073,116,264,0.439,47,108,0.435,69,156,0.442,0.528,41,63,0.651,14,59,73,146,32,22,50,119
3182,2,1984,22,1,2,61,20,1297,238,436,0.546,1,6,0.167,237,430,0.551,0.547,123,163,0.755,54,116,170,82,33,22,78,165
3182,3,1985,23,1,2,80,80,2762,682,1271,0.537,3,19,0.158,679,1252,0.542,0.538,400,504,0.794,174,253,427,216,77,52,230,317
3182,4,1986,24,1,2,11,9,339,100,181,0.552,1,2,0.5,99,179,0.553,0.555,58,84,0.69,20,21,41,31,9,13,33,35
3182,5,1987,25,1,2,52,42,1658,338,757,0.446,9,33,0.273,329,724,0.454,0.452,178,228,0.781,60,122,182,204,46,23,126,184
3182,6,1988,26,1,2,35,18,899,174,364,0.478,8,23,0.348,166,341,0.487,0.489,87,113,0.77,35,68,103,89,21,17,48,108
3182,7,1989,27,1,2,29,20,600,111,276,0.402,3,15,0.2,108,261,0.414,0.408,64,95,0.674,30,51,81,60,19,8,44,64
3182,7,1989,27,1,2,36,18,695,105,220,0.477,4,16,0.25,101,204,0.495,0.486,65,93,0.699,31,55,86,68,24,15,44,100
3182,7,1989,27,1,2,65,38,1295,216,496,0.435,7,31,0.226,209,465,0.449,0.443,129,188,0.686,61,106,167,128,43,23,88,164
3185,1,2005,21,1,2,38,0,433,44,113,0.389,6,22,0.273,38,91,0.418,0.416,33,48,0.688,19,33,52,39,23,5,25,50
3185,2,2006,22,1,2,23,0,127,15,27,0.556,2,4,0.5,13,23,0.565,0.593,6,12,0.5,3,11,14,9,8,0,4,20
3190,1,2005,19,1,2,76,56,1859,295,748,0.394,81,281,0.288,214,467,0.458,0.449,111,161,0.689,39,113,152,142,55,11,109,135
3190,2,2006,20,1,2,55,25,989,144,366,0.393,52,140,0.371,92,226,0.407,0.464,83,101,0.822,19,91,110,58,37,4,54,90
3190,3,2007,21,1,2,63,24,1471,284,644,0.441,149,382,0.39,135,262,0.515,0.557,102,126,0.81,30,113,143,91,49,9,85,147
3190,4,2008,22,1,2,74,0,1421,311,674,0.461,157,390,0.403,154,284,0.542,0.578,128,178,0.719,43,109,152,128,62,12,112,144
3190,5,2009,23,1,2,81,18,2245,424,950,0.446,180,453,0.397,244,497,0.491,0.541,205,272,0.754,43,254,297,227,78,14,150,190
3190,6,2010,24,1,2,75,0,2082,428,1033,0.414,158,467,0.338,270,566,0.477,0.491,142,201,0.706,28,206,234,183,99,20,139,174
3190,8,2012,26,1,2,35,1,967,165,405,0.407,67,193,0.347,98,212,0.462,0.49,39,55,0.709,29,107,136,84,54,6,46,87
3190,9,2013,27,1,2,80,0,2678,527,1249,0.422,155,436,0.356,372,813,0.458,0.484,237,311,0.762,64,361,425,218,100,24,134,226
3190,11,2015,29,1,2,9,0,234,34,79,0.43,8,28,0.286,26,51,0.51,0.481,10,13,0.769,1,24,25,33,7,1,17,20
3198,1,1987,22,1,2,42,4,461,57,150,0.38,3,9,0.333,54,141,0.383,0.39,21,28,0.75,13,19,32,43,25,3,30,74
3200,1,1992,22,1,2,48,5,708,100,246,0.407,2,21,0.095,98,225,0.436,0.411,45,56,0.804,30,51,81,99,44,1,63,98
3200,2,1993,23,1,2,69,33,1546,261,570,0.458,8,23,0.348,253,547,0.463,0.465,109,127,0.858,26,80,106,186,58,9,103,178
3200,3,1994,24,1,2,59,2,829,116,288,0.403,21,60,0.35,95,228,0.417,0.439,48,64,0.75,29,47,76,104,37,4,49,88
3200,3,1994,24,1,2,66,2,877,124,306,0.405,21,60,0.35,103,246,0.419,0.44,63,84,0.75,34,50,84,109,40,5,50,96
3207,1,1987,23,1,2,28,0,168,33,79,0.418,0,2,0,33,77,0.429,0.418,12,21,0.571,17,17,34,22,1,1,19,30
3207,2,1988,24,1,2,15,6,191,37,93,0.398,0,0,-1,37,93,0.398,0.398,21,28,0.75,16,14,30,11,5,6,12,23
3207,2,1988,24,1,2,57,12,1358,288,569,0.506,13,41,0.317,275,528,0.521,0.518,157,201,0.781,110,107,217,144,86,36,95,137
3207,2,1988,24,1,2,72,18,1549,325,662,0.491,13,41,0.317,312,621,0.502,0.501,178,229,0.777,126,121,247,155,91,42,107,160
3207,3,1989,25,1,2,80,5,1597,311,715,0.435,7,37,0.189,304,678,0.448,0.44,174,218,0.798,128,202,330,140,88,40,129,165
3207,6,1992,28,1,2,55,5,877,116,318,0.365,8,21,0.381,108,297,0.364,0.377,70,91,0.769,40,76,116,57,36,13,62,85
3209,1,1980,27,1,2,51,-1,1552,325,685,0.474,7,22,0.318,318,663,0.48,0.48,135,171,0.789,28,118,146,187,62,15,121,154
3209,2,1981,28,1,2,76,-1,2378,519,1057,0.491,4,18,0.222,515,1039,0.496,0.493,237,313,0.757,49,107,156,372,84,18,176,231
3209,3,1982,29,1,2,26,2,596,87,186,0.468,0,3,0,87,183,0.475,0.468,40,55,0.727,17,52,69,74,22,8,39,62
3209,3,1982,29,1,2,48,39,1446,253,575,0.44,5,24,0.208,248,551,0.45,0.444,123,168,0.732,34,83,117,233,45,19,116,151
3209,3,1982,29,1,2,74,41,2042,340,761,0.447,5,27,0.185,335,734,0.456,0.45,163,223,0.731,51,135,186,307,67,27,155,213
3209,4,1983,30,1,2,79,17,1238,175,400,0.438,3,8,0.375,172,392,0.439,0.441,101,133,0.759,27,103,130,216,44,8,102,113
3210,1,1980,31,1,2,82,-1,2677,599,1326,0.452,10,53,0.189,589,1273,0.463,0.456,233,283,0.823,93,163,256,363,125,7,200,190
3210,2,1981,32,1,2,82,-1,2199,486,1043,0.466,1,28,0.036,485,1015,0.478,0.466,221,271,0.815,46,147,193,357,113,14,195,132
3210,3,1982,33,1,2,82,40,2033,348,748,0.465,3,11,0.273,345,737,0.468,0.467,122,151,0.808,53,102,155,255,91,1,124,199
3210,4,1983,34,1,2,15,0,142,29,66,0.439,0,2,0,29,64,0.453,0.439,13,14,0.929,2,6,8,14,2,0,9,17
3210,4,1983,34,1,2,65,16,1264,244,499,0.489,3,16,0.188,241,483,0.499,0.492,101,117,0.863,35,53,88,192,54,0,89,122
3210,4,1983,34,1,2,80,16,1406,273,565,0.483,3,18,0.167,270,547,0.494,0.486,114,131,0.87,37,59,96,206,56,0,98,139
3220,1,1992,22,1,2,61,59,1806,297,654,0.454,40,125,0.32,257,529,0.486,0.485,95,127,0.748,81,107,188,278,59,19,152,162
3220,2,1993,23,1,2,48,43,1610,279,619,0.451,53,132,0.402,226,487,0.464,0.494,155,197,0.787,56,141,197,267,50,16,129,148
3220,3,1994,24,1,2,78,77,2776,491,1076,0.456,91,262,0.347,400,814,0.491,0.499,273,327,0.835,156,196,352,394,84,35,202,217
3220,4,1995,25,1,2,78,59,2603,417,976,0.427,135,404,0.334,282,572,0.493,0.496,295,349,0.845,100,170,270,267,60,32,151,216
3220,4,1995,25,1,2,80,61,2665,428,1005,0.426,137,416,0.329,291,589,0.494,0.494,312,371,0.841,104,172,276,274,62,33,155,225
3220,5,1996,26,1,2,80,80,2856,494,1143,0.432,140,423,0.331,354,720,0.492,0.493,318,385,0.826,124,202,326,224,68,17,151,207
3220,6,1997,27,1,2,72,72,2818,491,1145,0.429,130,388,0.335,361,757,0.477,0.486,333,393,0.847,90,148,238,305,62,23,176,173
3220,7,1998,28,1,2,73,73,2857,489,1101,0.444,97,276,0.351,392,825,0.475,0.488,389,455,0.855,133,176,309,292,75,29,176,219
3220,8,1999,29,1,2,36,36,1314,217,540,0.402,47,139,0.338,170,401,0.424,0.445,191,225,0.849,50,101,151,118,36,11,99,100
3220,9,2000,30,1,2,82,81,2689,420,900,0.467,96,241,0.398,324,659,0.492,0.52,289,340,0.85,123,190,313,209,71,31,117,214
3220,10,2001,31,1,2,81,36,2542,359,788,0.456,78,230,0.339,281,558,0.504,0.505,309,347,0.89,87,185,272,213,48,24,137,203
3220,11,2002,32,1,2,77,76,2211,310,682,0.455,116,246,0.472,194,436,0.445,0.54,159,181,0.878,45,148,193,151,54,15,108,158
3220,12,2003,33,1,2,53,18,1032,113,291,0.388,39,118,0.331,74,173,0.428,0.455,95,114,0.833,21,78,99,70,28,9,43,79
3220,13,2004,34,1,2,71,4,929,119,293,0.406,43,107,0.402,76,186,0.409,0.48,77,83,0.928,27,54,81,56,15,6,42,91
3220,14,2005,35,1,2,13,0,114,9,30,0.3,3,15,0.2,6,15,0.4,0.35,2,3,0.667,2,14,16,14,2,0,3,8
3220,14,2005,35,1,2,37,1,636,93,218,0.427,38,90,0.422,55,128,0.43,0.514,67,77,0.87,13,36,49,57,12,7,24,74
3220,14,2005,35,1,2,50,1,750,102,248,0.411,41,105,0.39,61,143,0.427,0.494,69,80,0.863,15,50,65,71,14,7,27,82
3223,1,2014,22,1,2,77,12,1231,129,336,0.384,57,178,0.32,72,158,0.456,0.469,31,41,0.756,19,105,124,68,29,15,44,84
3224,10,2005,31,1,2,81,15,1844,125,327,0.382,13,45,0.289,112,282,0.397,0.402,59,80,0.738,37,118,155,317,67,16,89,189
3226,1,2005,21,1,2,68,7,906,122,328,0.372,30,85,0.353,92,243,0.379,0.418,64,96,0.667,50,71,121,36,26,19,58,116
3226,2,2006,22,1,2,68,45,1310,205,453,0.453,46,129,0.357,159,324,0.491,0.503,86,117,0.735,55,106,161,102,29,23,70,106
3228,3,1982,29,1,2,80,6,1938,363,801,0.453,19,76,0.25,344,725,0.474,0.465,195,254,0.768,37,105,142,301,73,18,217,238
3228,4,1983,30,1,2,41,39,1438,234,534,0.438,23,55,0.418,211,479,0.441,0.46,154,185,0.832,35,67,102,218,61,14,147,158
3228,5,1984,31,1,2,81,81,2624,508,1115,0.456,29,111,0.261,479,1004,0.477,0.469,221,264,0.837,51,128,179,377,117,17,222,278
3228,6,1985,32,1,2,71,12,1490,280,628,0.446,8,28,0.286,272,600,0.453,0.452,132,162,0.815,27,76,103,252,49,9,158,156
3228,7,1986,33,1,2,78,0,1279,240,541,0.444,13,43,0.302,227,498,0.456,0.456,110,125,0.88,29,70,99,180,44,2,85,139
3236,1,1980,22,1,2,40,-1,442,72,153,0.471,0,2,0,72,151,0.477,0.471,54,65,0.831,27,27,54,51,12,6,57,58
3236,3,1982,24,1,2,82,1,1755,270,564,0.479,8,24,0.333,262,540,0.485,0.486,279,327,0.853,99,111,210,206,86,9,111,140
3236,4,1983,25,1,2,48,4,722,91,197,0.462,2,10,0.2,89,187,0.476,0.467,88,113,0.779,27,57,84,78,27,3,55,59
3241,1,2007,24,1,2,31,0,272,23,72,0.319,5,29,0.172,18,43,0.419,0.354,34,42,0.81,5,17,22,28,7,1,29,33
3256,1,1993,22,1,2,77,69,2741,449,968,0.464,73,198,0.369,376,770,0.488,0.502,211,283,0.746,79,192,271,295,126,52,203,166
3256,2,1994,23,1,2,82,82,3533,613,1417,0.433,141,391,0.361,472,1026,0.46,0.482,353,456,0.774,80,321,401,385,180,76,226,158
3256,3,1995,24,1,2,69,69,2771,490,1171,0.418,90,326,0.276,400,845,0.473,0.457,350,448,0.781,58,198,256,279,112,46,230,108
3256,4,1996,25,1,2,78,78,3064,515,1202,0.428,91,282,0.323,424,920,0.461,0.466,352,446,0.789,124,256,380,328,127,45,222,150
3256,5,1997,26,1,2,80,79,3353,649,1444,0.449,147,415,0.354,502,1029,0.488,0.5,493,585,0.843,58,308,366,507,132,45,322,153
3256,6,1998,27,1,2,14,13,547,110,277,0.397,9,48,0.188,101,229,0.441,0.413,70,94,0.745,7,44,51,68,19,5,44,26
3258,1,1996,21,1,2,72,71,2701,452,1091,0.414,93,292,0.318,359,799,0.449,0.457,387,518,0.747,90,175,265,278,76,79,252,179
3258,2,1997,22,1,2,81,81,3166,533,1308,0.407,102,342,0.298,431,966,0.446,0.446,511,667,0.766,156,182,338,253,93,63,316,219
3258,3,1998,23,1,2,22,22,748,128,283,0.452,16,46,0.348,112,237,0.473,0.481,81,101,0.802,28,48,76,67,31,21,74,56
3258,3,1998,23,1,2,57,15,1797,296,692,0.428,31,149,0.208,265,543,0.488,0.45,273,349,0.782,77,113,190,174,58,38,150,119
3258,3,1998,23,1,2,79,37,2545,424,975,0.435,47,195,0.241,377,780,0.483,0.459,354,450,0.787,105,161,266,241,89,59,224,175
3258,4,1999,24,1,2,42,9,1188,181,488,0.371,35,126,0.278,146,362,0.403,0.407,210,247,0.85,26,81,107,118,34,19,121,79
3258,5,2000,25,1,2,82,82,3148,619,1447,0.428,83,288,0.288,536,1159,0.462,0.456,618,758,0.815,118,197,315,365,103,36,311,188
3258,6,2001,26,1,2,80,80,3215,774,1927,0.402,166,473,0.351,608,1454,0.418,0.445,666,810,0.822,99,216,315,410,97,54,326,160
3258,8,2003,28,1,2,70,70,2747,491,1201,0.409,71,245,0.29,420,956,0.439,0.438,455,518,0.878,61,197,258,316,65,28,193,130
3258,10,2005,30,1,2,56,7,1617,274,662,0.414,32,120,0.267,242,542,0.446,0.438,253,298,0.849,38,145,183,127,53,10,106,104
3258,11,2006,31,1,2,55,11,1525,242,603,0.401,36,130,0.277,206,473,0.436,0.431,195,221,0.882,32,121,153,160,37,10,121,96
3258,13,2008,33,1,2,58,13,1412,213,526,0.405,60,184,0.326,153,342,0.447,0.462,132,148,0.892,33,100,133,145,28,10,86,82
3258,14,2009,34,1,2,10,1,162,16,60,0.267,3,19,0.158,13,41,0.317,0.292,7,7,1,5,12,17,12,4,1,9,6
3258,15,2010,35,1,2,42,0,855,129,316,0.408,45,130,0.346,84,186,0.452,0.479,55,69,0.797,19,81,100,70,21,9,66,56
3261,1,1985,23,1,2,74,14,1278,210,458,0.459,4,25,0.16,206,433,0.476,0.463,102,126,0.81,39,75,114,127,47,12,80,205
3261,2,1986,24,1,2,74,17,1331,191,441,0.433,9,53,0.17,182,388,0.469,0.443,107,132,0.811,29,110,139,206,59,8,139,200
3261,3,1987,25,1,2,44,0,375,67,156,0.429,11,29,0.379,56,127,0.441,0.465,31,50,0.62,8,16,24,57,13,0,29,78
3270,1,2011,20,1,2,12,0,115,13,39,0.333,0,5,0,13,34,0.382,0.333,11,14,0.786,1,17,18,21,4,0,16,14
3270,2,2012,21,1,2,42,1,442,47,125,0.376,4,30,0.133,43,95,0.453,0.392,8,17,0.471,12,41,53,46,21,5,36,30
3270,3,2013,22,1,2,78,72,2278,275,598,0.46,62,188,0.33,213,410,0.52,0.512,75,115,0.652,47,257,304,223,81,16,109,162
3270,4,2014,23,1,2,78,78,2752,427,870,0.491,86,244,0.352,341,626,0.545,0.54,140,197,0.711,95,463,558,359,54,7,210,195
3270,5,2015,24,1,2,10,10,347,39,104,0.375,5,20,0.25,34,84,0.405,0.399,16,22,0.727,15,80,95,51,8,1,29,21
3271,1,2001,19,1,2,40,2,293,31,91,0.341,1,12,0.083,30,79,0.38,0.346,26,38,0.684,9,19,28,18,10,2,28,29
3271,2,2002,20,1,2,67,23,1134,143,371,0.385,2,25,0.08,141,346,0.408,0.388,37,53,0.698,44,87,131,116,29,24,68,82
3271,3,2003,21,1,2,61,8,760,114,284,0.401,4,12,0.333,110,272,0.404,0.408,47,68,0.691,22,63,85,40,22,8,49,57
3271,4,2004,22,1,2,54,54,1511,261,586,0.445,7,30,0.233,254,556,0.457,0.451,89,133,0.669,43,135,178,92,28,16,80,86
3271,4,2004,22,1,2,80,78,2444,376,871,0.432,19,71,0.268,357,800,0.446,0.443,138,204,0.676,79,219,298,158,52,17,120,140
3271,5,2005,23,1,2,55,27,1089,174,426,0.408,25,67,0.373,149,359,0.415,0.438,56,101,0.554,38,64,102,69,16,9,57,73
3271,6,2006,24,1,2,82,82,2648,359,781,0.46,2,15,0.133,357,766,0.466,0.461,180,242,0.744,59,182,241,160,58,17,123,178
3271,7,2007,25,1,2,82,82,2419,347,753,0.461,74,183,0.404,273,570,0.479,0.51,152,216,0.704,55,161,216,218,65,19,119,155
3271,8,2008,26,1,2,82,82,2564,301,780,0.386,158,413,0.383,143,367,0.39,0.487,157,197,0.797,37,198,235,252,65,15,102,110
3271,9,2009,27,1,2,32,25,886,72,231,0.312,35,129,0.271,37,102,0.363,0.387,32,60,0.533,11,65,76,98,21,2,32,43
3271,10,2010,28,1,2,24,5,267,17,60,0.283,8,25,0.32,9,35,0.257,0.35,7,10,0.7,4,22,26,12,5,1,6,23
3271,10,2010,28,1,2,40,13,616,29,103,0.282,11,62,0.177,18,41,0.439,0.335,18,25,0.72,7,58,65,44,11,5,24,51
3271,10,2010,28,1,2,64,18,883,46,163,0.282,19,87,0.218,27,76,0.355,0.34,25,35,0.714,11,80,91,56,16,6,30,74
3271,11,2011,29,1,2,72,54,1158,128,330,0.388,94,249,0.378,34,81,0.42,0.53,33,43,0.767,20,86,106,77,21,5,44,71
3271,13,2013,31,1,2,56,31,1158,98,262,0.374,76,209,0.364,22,53,0.415,0.519,12,23,0.522,18,104,122,52,29,6,23,69
3279,1,1993,22,1,2,39,12,865,124,278,0.446,0,4,0,124,274,0.453,0.446,99,119,0.832,39,85,124,49,24,5,44,82
3279,2,1994,23,1,2,82,82,2853,365,811,0.45,2,9,0.222,363,802,0.453,0.451,291,351,0.829,119,230,349,199,116,16,131,165
3279,3,1995,24,1,2,81,51,2329,312,661,0.472,20,68,0.294,292,593,0.492,0.487,267,324,0.824,95,173,268,153,91,18,110,142
3279,4,1996,25,1,2,82,77,2810,379,911,0.416,41,148,0.277,338,763,0.443,0.439,320,379,0.844,125,275,400,241,114,16,157,187
3279,5,1997,26,1,2,52,52,1788,251,603,0.416,70,182,0.385,181,421,0.43,0.474,202,234,0.863,74,143,217,133,60,20,101,119
3279,6,1998,27,1,2,31,15,718,75,225,0.333,10,48,0.208,65,177,0.367,0.356,75,86,0.872,15,50,65,50,21,8,35,52
3279,7,1999,28,1,2,46,32,1194,114,290,0.393,31,106,0.292,83,184,0.451,0.447,61,71,0.859,30,77,107,82,28,15,45,65
3279,8,2000,29,1,2,45,6,691,86,189,0.455,17,56,0.304,69,133,0.519,0.5,64,77,0.831,23,61,84,61,18,12,33,56
3279,9,2001,30,1,2,78,74,2504,245,611,0.401,91,242,0.376,154,369,0.417,0.475,175,207,0.845,65,219,284,168,93,14,90,182
3279,10,2002,31,1,2,50,5,665,70,188,0.372,24,68,0.353,46,120,0.383,0.436,44,52,0.846,20,65,85,42,29,6,30,42
3288,1,2012,23,1,2,22,2,179,13,31,0.419,2,11,0.182,11,20,0.55,0.452,8,11,0.727,5,20,25,37,8,6,11,18
3288,2,2014,25,1,2,21,0,120,7,17,0.412,2,8,0.25,5,9,0.556,0.471,2,3,0.667,2,18,20,12,3,0,5,13
3291,1,2006,23,1,2,61,1,1236,204,492,0.415,82,216,0.38,122,276,0.442,0.498,99,110,0.9,12,104,116,75,27,3,82,118
3291,2,2007,24,1,2,61,0,1034,177,425,0.416,56,155,0.361,121,270,0.448,0.482,61,68,0.897,6,68,74,61,21,2,55,88
3294,1,2008,22,1,2,33,0,270,29,92,0.315,6,25,0.24,23,67,0.343,0.348,9,19,0.474,9,19,28,30,12,6,11,36
3297,1,1997,23,1,2,28,15,759,102,256,0.398,28,92,0.304,74,164,0.451,0.453,65,80,0.813,21,69,90,68,27,5,66,75
3297,2,1998,24,1,2,67,19,1505,199,558,0.357,48,163,0.294,151,395,0.382,0.4,65,84,0.774,35,126,161,167,56,8,106,140
3297,3,1999,25,1,2,33,2,567,89,221,0.403,18,59,0.305,71,162,0.438,0.443,53,65,0.815,12,71,83,64,40,2,36,44
3297,4,2000,26,1,2,68,67,2025,316,730,0.433,73,186,0.392,243,544,0.447,0.483,162,195,0.831,69,254,323,211,105,13,102,190
3297,7,2003,29,1,2,71,10,1275,163,380,0.429,62,160,0.388,101,220,0.459,0.511,70,87,0.805,23,122,145,209,38,7,98,111
3297,9,2005,31,1,2,62,5,1014,114,304,0.375,21,83,0.253,93,221,0.421,0.41,52,64,0.813,11,92,103,115,30,1,64,103
3298,5,1993,26,1,2,78,35,2474,396,816,0.485,4,30,0.133,392,786,0.499,0.488,273,381,0.717,120,217,337,559,131,24,199,153
3303,1,1993,24,1,2,9,0,138,20,61,0.328,2,13,0.154,18,48,0.375,0.344,8,10,0.8,8,6,14,13,8,0,15,13
3308,5,2012,25,1,2,55,48,1644,256,597,0.429,33,104,0.317,223,493,0.452,0.456,267,320,0.834,38,104,142,210,44,10,106,124
3308,6,2013,26,1,2,76,24,2171,304,748,0.406,55,182,0.302,249,566,0.44,0.443,213,272,0.783,43,169,212,270,51,17,134,127
3308,7,2014,27,1,2,73,5,1950,372,853,0.436,24,88,0.273,348,765,0.455,0.45,244,292,0.836,39,130,169,152,54,10,125,131
3314,1,1984,22,1,2,40,1,469,109,214,0.509,0,3,0,109,211,0.517,0.509,40,47,0.851,21,25,46,46,20,0,32,46
3316,6,1989,27,1,2,68,8,1338,307,675,0.455,48,92,0.522,259,583,0.444,0.49,47,57,0.825,18,69,87,137,27,1,87,78
3316,7,1990,28,1,2,63,2,867,148,363,0.408,44,100,0.44,104,263,0.395,0.468,44,52,0.846,15,56,71,102,25,0,52,69
3316,8,1991,29,1,2,24,0,225,43,107,0.402,15,35,0.429,28,72,0.389,0.472,11,11,1,3,6,9,24,7,0,16,11
3318,1,1996,22,1,2,79,3,1150,148,360,0.411,27,78,0.346,121,282,0.429,0.449,99,141,0.702,34,101,135,233,56,21,115,126
3318,2,1997,23,1,2,82,23,2269,253,587,0.431,53,164,0.323,200,423,0.473,0.476,196,319,0.614,76,232,308,390,90,33,181,218
3318,3,1998,24,1,2,46,4,942,87,231,0.377,19,60,0.317,68,171,0.398,0.418,74,131,0.565,25,69,94,171,44,7,93,113
3318,5,2000,26,1,2,73,45,2216,356,815,0.437,122,332,0.367,234,483,0.484,0.512,175,251,0.697,50,238,288,284,91,19,148,201
3318,6,2001,27,1,2,53,42,1684,202,518,0.39,47,172,0.273,155,346,0.448,0.435,135,189,0.714,54,173,227,242,54,8,160,127
3318,8,2003,29,1,2,55,0,1130,135,328,0.412,28,85,0.329,107,243,0.44,0.454,103,148,0.696,58,109,167,177,45,2,82,108
3318,9,2004,30,1,2,53,0,707,71,173,0.41,9,36,0.25,62,137,0.453,0.436,48,69,0.696,30,73,103,89,37,9,39,86
3318,9,2004,30,1,2,27,18,956,131,312,0.42,12,43,0.279,119,269,0.442,0.439,123,157,0.783,70,153,223,144,25,5,66,72
3318,9,2004,30,1,2,80,18,1663,202,485,0.416,21,79,0.266,181,406,0.446,0.438,171,226,0.757,100,226,326,233,62,14,105,158
3335,1,1982,22,1,2,43,0,369,54,100,0.54,2,3,0.667,52,97,0.536,0.55,35,69,0.507,13,16,29,57,16,2,42,65
3335,2,1983,23,1,2,54,2,439,84,172,0.488,4,18,0.222,80,154,0.519,0.5,30,73,0.411,12,35,47,104,34,4,74,78
3366,1,2007,22,1,2,47,5,710,100,259,0.386,48,116,0.414,52,143,0.364,0.479,42,55,0.764,18,51,69,43,20,3,42,85
3374,1,1996,28,1,2,63,27,1275,149,359,0.415,81,191,0.424,68,168,0.405,0.528,57,66,0.864,31,113,144,170,23,5,61,111
3374,2,1997,29,1,2,71,4,1207,148,350,0.423,58,140,0.414,90,210,0.429,0.506,51,58,0.879,35,80,115,94,38,4,65,97
3374,3,1998,30,1,2,59,14,1454,206,452,0.456,62,148,0.419,144,304,0.474,0.524,74,79,0.937,32,110,142,117,41,1,91,94
3375,1,2002,22,1,2,67,8,1417,294,609,0.483,88,198,0.444,206,411,0.501,0.555,91,115,0.791,77,147,224,91,42,7,57,96
3375,2,2003,23,1,2,82,14,2316,455,971,0.469,182,416,0.438,273,555,0.492,0.562,149,185,0.805,98,273,371,117,100,13,74,143
3375,3,2004,24,1,2,82,82,3021,633,1439,0.44,127,363,0.35,506,1076,0.47,0.484,383,441,0.868,118,289,407,185,81,6,116,152
3375,4,2005,25,1,2,75,75,2848,625,1418,0.441,104,293,0.355,521,1125,0.463,0.477,369,432,0.854,72,240,312,172,63,8,133,152
3375,5,2006,26,1,2,80,80,3130,682,1516,0.45,163,413,0.395,519,1103,0.471,0.504,501,571,0.877,78,264,342,229,95,5,170,157
3375,7,2008,28,1,2,72,71,2702,550,1243,0.442,130,359,0.362,420,884,0.475,0.495,402,490,0.82,85,224,309,247,65,13,181,120
3375,8,2009,29,1,2,33,32,1203,249,547,0.455,70,191,0.366,179,356,0.503,0.519,131,161,0.814,24,83,107,88,35,2,53,45
3375,9,2010,30,1,2,18,12,492,75,213,0.352,18,60,0.3,57,153,0.373,0.394,47,66,0.712,11,43,54,39,19,2,15,24
3375,10,2011,31,1,2,10,0,134,18,45,0.4,4,17,0.235,14,28,0.5,0.444,4,4,1,0,8,8,12,2,1,4,4
3375,11,2012,32,1,2,51,2,770,144,360,0.4,42,132,0.318,102,228,0.447,0.458,88,111,0.793,14,63,77,33,13,0,37,29
3377,2,2008,23,1,2,34,0,276,48,108,0.444,17,43,0.395,31,65,0.477,0.523,27,34,0.794,1,22,23,16,4,0,15,29
3377,3,2009,24,1,2,64,5,1111,117,299,0.391,67,179,0.374,50,120,0.417,0.503,81,93,0.871,8,101,109,73,21,1,54,72
3377,4,2010,25,1,2,82,9,1808,243,553,0.439,111,274,0.405,132,279,0.473,0.54,191,222,0.86,17,138,155,158,28,4,63,118
3377,5,2011,26,1,2,59,5,1513,197,447,0.441,87,219,0.397,110,228,0.482,0.538,112,128,0.875,6,107,113,102,29,3,53,80
3377,6,2012,27,1,2,65,22,1765,248,584,0.425,112,268,0.418,136,316,0.43,0.521,143,157,0.911,18,132,150,164,27,6,68,92
3377,7,2013,28,1,2,28,2,804,120,298,0.403,48,151,0.318,72,147,0.49,0.483,56,61,0.918,8,44,52,76,9,4,33,47
3377,7,2013,28,1,2,50,11,1575,262,582,0.45,117,300,0.39,145,282,0.514,0.551,115,129,0.891,9,110,119,220,29,5,105,70
3377,7,2013,28,1,2,78,13,2379,382,880,0.434,165,451,0.366,217,429,0.506,0.528,171,190,0.9,17,154,171,296,38,9,138,117
3377,8,2014,29,1,2,35,34,987,181,398,0.455,73,185,0.395,108,213,0.507,0.546,97,106,0.915,9,65,74,78,28,3,42,65
3377,9,2015,30,1,2,8,8,242,31,76,0.408,13,43,0.302,18,33,0.545,0.493,33,37,0.892,1,16,17,14,4,0,13,11
3378,1,1980,24,1,2,24,-1,298,59,138,0.428,0,9,0,59,129,0.457,0.428,24,34,0.706,18,34,52,19,4,9,19,27
3387,1,1981,23,1,2,59,-1,597,84,185,0.454,0,5,0,84,180,0.467,0.454,22,39,0.564,27,33,60,71,33,5,78,111
3398,1,1996,23,1,2,62,0,845,113,292,0.387,42,122,0.344,71,170,0.418,0.459,35,42,0.833,28,46,74,68,32,4,42,67
3398,2,1997,24,1,2,27,0,412,53,120,0.442,19,48,0.396,34,72,0.472,0.521,27,32,0.844,11,21,32,32,20,2,22,35
3398,2,1997,24,1,2,41,0,495,59,139,0.424,20,57,0.351,39,82,0.476,0.496,34,39,0.872,14,25,39,40,20,2,30,40
3398,3,1998,25,1,2,10,0,215,36,84,0.429,6,26,0.231,30,58,0.517,0.464,4,7,0.571,7,20,27,17,5,0,15,17
3398,3,1998,25,1,2,47,4,696,94,209,0.45,25,67,0.373,69,142,0.486,0.51,44,54,0.815,30,43,73,44,29,1,33,58
3398,3,1998,25,1,2,57,4,911,130,293,0.444,31,93,0.333,99,200,0.495,0.497,48,61,0.787,37,63,100,61,34,1,48,75
3402,2,1999,25,1,2,10,1,123,11,44,0.25,1,7,0.143,10,37,0.27,0.261,11,19,0.579,7,6,13,10,4,2,15,16
3402,2,1999,25,1,2,13,1,156,13,52,0.25,1,7,0.143,12,45,0.267,0.26,16,25,0.64,9,8,17,11,5,2,20,21
3405,1,1980,23,1,2,52,-1,988,159,348,0.457,1,3,0.333,158,345,0.458,0.458,28,45,0.622,55,68,123,107,24,15,64,97
3405,2,1981,24,1,2,77,-1,1313,227,464,0.489,0,1,0,227,463,0.49,0.489,84,108,0.778,83,93,176,152,36,10,110,102
3405,3,1982,25,1,2,77,0,1040,140,310,0.452,2,2,1,138,308,0.448,0.455,69,88,0.784,55,63,118,109,36,9,79,109
3405,4,1983,26,1,2,77,1,1755,259,559,0.463,0,6,0,259,553,0.468,0.463,71,111,0.64,98,149,247,168,71,18,99,164
3405,5,1984,27,1,2,69,12,1571,221,473,0.467,0,4,0,221,469,0.471,0.467,79,103,0.767,62,103,165,155,49,23,100,145
3405,6,1985,28,1,2,74,20,1531,183,404,0.453,1,3,0.333,182,401,0.454,0.454,76,89,0.854,60,95,155,157,37,15,78,143
3405,7,1986,29,1,2,82,61,2224,335,736,0.455,1,9,0.111,334,727,0.459,0.456,123,147,0.837,69,182,251,372,58,8,136,153
3405,8,1987,30,1,2,78,14,1396,218,467,0.467,6,17,0.353,212,450,0.471,0.473,59,74,0.797,51,92,143,241,49,7,85,106
3406,1,2002,21,1,2,80,75,2629,464,1090,0.426,82,246,0.333,382,844,0.453,0.463,141,210,0.671,124,216,340,236,106,31,160,195
3406,2,2003,22,1,2,82,82,2698,476,1161,0.41,123,334,0.368,353,827,0.427,0.463,207,271,0.764,111,267,378,247,90,23,179,201
3406,3,2004,23,1,2,78,78,2936,563,1284,0.438,77,273,0.282,486,1011,0.481,0.468,258,377,0.684,124,400,524,226,86,41,196,182
3406,4,2005,24,1,2,72,72,2724,610,1368,0.446,125,370,0.338,485,998,0.486,0.492,214,309,0.693,125,299,424,281,105,32,169,156
3406,5,2006,25,1,2,75,75,2877,641,1438,0.446,183,477,0.384,458,961,0.477,0.509,276,410,0.673,105,333,438,232,97,37,167,206
3406,6,2007,26,1,2,51,49,1675,306,734,0.417,110,301,0.365,196,433,0.453,0.492,92,140,0.657,71,188,259,172,54,32,82,129
3406,8,2009,28,1,2,14,14,491,97,220,0.441,27,59,0.458,70,161,0.435,0.502,41,55,0.745,13,45,58,36,14,3,24,43
3406,8,2009,28,1,2,58,57,1919,368,754,0.488,102,266,0.383,266,488,0.545,0.556,112,144,0.778,64,197,261,110,62,25,71,103
3406,8,2009,28,1,2,72,71,2410,465,974,0.477,129,325,0.397,336,649,0.518,0.544,153,199,0.769,77,242,319,146,76,28,95,146
3406,9,2010,29,1,2,79,76,2485,473,998,0.474,157,400,0.393,316,598,0.528,0.553,136,184,0.739,81,323,404,143,66,33,92,169
3406,10,2011,30,1,2,25,25,796,183,389,0.47,62,148,0.419,121,241,0.502,0.55,55,72,0.764,33,78,111,36,27,3,30,46
3406,10,2011,30,1,2,55,55,1919,289,667,0.433,127,331,0.384,162,336,0.482,0.528,61,87,0.701,34,186,220,111,66,10,65,116
3406,10,2011,30,1,2,80,80,2715,472,1056,0.447,189,479,0.395,283,577,0.49,0.536,116,159,0.73,67,264,331,147,93,13,95,162
3406,11,2012,31,1,2,54,54,1591,243,596,0.408,102,277,0.368,141,319,0.442,0.493,41,69,0.594,36,158,194,107,53,22,60,91
3406,12,2013,32,1,2,33,33,936,135,336,0.402,57,167,0.341,78,169,0.462,0.487,20,33,0.606,19,108,127,51,40,15,26,57
3407,1,2008,23,1,2,27,1,132,16,44,0.364,7,19,0.368,9,25,0.36,0.443,2,2,1,1,8,9,2,3,0,6,13
3408,1,1980,24,1,2,82,-1,3060,502,1063,0.472,27,110,0.245,475,953,0.498,0.485,223,338,0.66,151,388,539,832,265,35,359,260
3408,2,1981,25,1,2,79,-1,3175,523,1116,0.469,23,102,0.225,500,1014,0.493,0.479,224,338,0.663,173,372,545,627,232,35,302,258
3412,9,2012,30,1,2,53,53,1750,242,550,0.44,49,152,0.322,193,398,0.485,0.485,106,119,0.891,19,122,141,252,56,16,96,136
3412,10,2013,31,1,2,82,82,2474,367,811,0.453,66,212,0.311,301,599,0.503,0.493,139,164,0.848,41,165,206,311,82,15,130,187
3415,1,1994,22,1,2,79,60,2415,522,1115,0.468,54,150,0.36,468,965,0.485,0.492,215,265,0.811,118,197,315,202,54,28,218,194
3415,2,1995,23,1,2,75,67,2645,558,1249,0.447,139,396,0.351,419,853,0.491,0.502,277,339,0.817,90,159,249,245,69,23,232,194
3415,3,1996,24,1,2,75,68,2594,560,1206,0.464,102,275,0.371,458,931,0.492,0.507,248,296,0.838,99,210,309,213,48,23,201,204
3415,4,1997,25,1,2,76,68,2563,456,983,0.464,99,257,0.385,357,726,0.492,0.514,212,261,0.812,94,210,304,198,45,19,212,199
3415,5,1998,26,1,2,74,66,2786,551,1302,0.423,135,420,0.321,416,882,0.472,0.475,221,267,0.828,99,247,346,231,55,19,187,188
3415,6,1999,27,1,2,47,41,1385,249,605,0.412,42,111,0.378,207,494,0.419,0.446,111,147,0.755,59,137,196,104,25,9,95,100
3415,7,2000,28,1,2,60,47,2084,449,1072,0.419,56,180,0.311,393,892,0.441,0.445,204,260,0.785,63,195,258,219,41,6,168,132
3415,8,2001,29,1,2,67,6,1206,201,472,0.426,34,92,0.37,167,380,0.439,0.462,71,83,0.855,44,112,156,111,27,7,98,105
3415,9,2002,30,1,2,10,1,173,37,81,0.457,6,15,0.4,31,66,0.47,0.494,13,17,0.765,10,23,33,12,3,2,14,11
3416,1,1989,23,1,2,79,79,2717,649,1386,0.468,33,90,0.367,616,1296,0.475,0.48,410,506,0.81,158,310,468,334,82,13,269,223
3416,2,1990,24,1,2,78,78,2799,640,1287,0.497,34,95,0.358,606,1192,0.508,0.51,406,469,0.866,98,262,360,223,98,24,201,210
3416,3,1991,25,1,2,77,77,3027,703,1424,0.494,40,115,0.348,663,1309,0.506,0.508,394,465,0.847,147,305,452,238,126,34,230,207
3416,4,1992,26,1,2,80,80,3095,685,1465,0.468,103,268,0.384,582,1197,0.486,0.503,330,406,0.813,62,257,319,411,92,34,247,231
3416,5,1993,27,1,2,45,45,1728,371,782,0.474,48,130,0.369,323,652,0.495,0.505,197,233,0.845,18,136,154,221,53,9,130,137
3416,6,1994,28,1,2,78,78,2897,635,1428,0.445,127,312,0.407,508,1116,0.455,0.489,426,511,0.834,70,216,286,313,103,17,216,211
3416,7,1995,29,1,2,82,82,3172,668,1497,0.446,156,424,0.368,512,1073,0.477,0.498,375,445,0.843,69,288,357,311,91,29,234,227
3416,8,1996,30,1,2,81,81,2946,611,1368,0.447,225,515,0.437,386,853,0.453,0.529,425,491,0.866,54,215,269,255,125,19,220,233
3416,9,1997,31,1,2,81,81,3125,717,1578,0.454,204,477,0.428,513,1101,0.466,0.519,457,531,0.861,59,260,319,338,118,24,237,211
3416,10,1998,32,1,2,70,70,2569,543,1220,0.445,130,334,0.389,413,886,0.466,0.498,407,471,0.864,50,179,229,279,88,15,181,154
3416,11,1999,33,1,2,50,50,1912,331,803,0.412,70,221,0.317,261,582,0.448,0.456,251,293,0.857,30,142,172,122,64,10,136,121
3416,12,2000,34,1,2,74,69,2397,447,1049,0.426,93,241,0.386,354,808,0.438,0.47,298,340,0.876,37,176,213,185,110,13,154,191
3416,13,2001,35,1,2,37,30,1216,205,504,0.407,45,133,0.338,160,371,0.431,0.451,143,160,0.894,15,94,109,111,43,7,84,86
3416,14,2002,36,1,2,64,2,709,100,247,0.405,18,62,0.29,82,185,0.443,0.441,42,44,0.955,14,80,94,57,18,6,40,61
3418,1,2001,20,1,2,76,28,1358,232,525,0.442,50,151,0.331,182,374,0.487,0.49,99,158,0.627,105,152,257,62,42,7,64,98
3418,2,2002,21,1,2,81,0,2152,400,926,0.432,133,349,0.381,267,577,0.463,0.504,143,187,0.765,113,221,334,128,78,21,102,142
3418,3,2003,22,1,2,59,13,1368,203,546,0.372,61,198,0.308,142,348,0.408,0.428,85,124,0.685,98,183,281,52,35,10,64,92
3418,4,2004,23,1,2,65,64,2338,425,1068,0.398,120,341,0.352,305,727,0.42,0.454,151,204,0.74,146,268,414,139,67,19,141,130
3418,5,2005,24,1,2,79,78,2839,407,1045,0.389,226,631,0.358,181,414,0.437,0.498,136,184,0.739,91,388,479,158,96,27,102,197
3418,9,2009,28,1,2,72,51,1894,262,667,0.393,120,329,0.365,142,338,0.42,0.483,89,117,0.761,71,248,319,117,47,7,74,132
3430,1,2013,20,1,2,61,26,1418,145,390,0.372,28,86,0.326,117,304,0.385,0.408,59,108,0.546,16,93,109,127,26,9,74,122
3430,2,2014,21,1,2,69,4,1339,192,474,0.405,36,99,0.364,156,375,0.416,0.443,110,173,0.636,26,103,129,160,45,9,77,134
3430,3,2015,22,1,2,8,0,170,27,47,0.574,5,12,0.417,22,35,0.629,0.628,8,13,0.615,1,13,14,21,5,3,8,17
3435,2,2015,23,1,2,4,4,119,8,14,0.571,0,3,0,8,11,0.727,0.571,8,10,0.8,4,20,24,11,3,3,9,15
3445,1,2005,24,1,2,31,1,328,36,81,0.444,3,8,0.375,33,73,0.452,0.463,18,26,0.692,14,34,48,30,11,4,20,42
3445,3,2007,26,1,2,21,0,241,16,54,0.296,0,2,0,16,52,0.308,0.296,19,22,0.864,9,33,42,17,13,1,16,28
3445,3,2007,26,1,2,31,0,278,19,62,0.306,0,2,0,19,60,0.317,0.306,23,27,0.852,10,38,48,19,17,2,16,32
3447,1,1997,22,1,2,41,6,681,69,182,0.379,34,89,0.382,35,93,0.376,0.473,16,26,0.615,23,48,71,65,28,9,34,85
3447,2,1998,23,1,2,16,0,143,23,63,0.365,7,24,0.292,16,39,0.41,0.421,1,2,0.5,0,13,13,10,7,1,15,21
3447,2,1998,23,1,2,19,0,271,42,111,0.378,17,42,0.405,25,69,0.362,0.455,7,14,0.5,9,24,33,29,12,3,18,29
3447,2,1998,23,1,2,35,0,414,65,174,0.374,24,66,0.364,41,108,0.38,0.443,8,16,0.5,9,37,46,39,19,4,33,50
3455,1,1983,22,1,2,35,0,147,35,97,0.361,1,11,0.091,34,86,0.395,0.366,30,45,0.667,6,11,17,21,4,2,13,18
3484,2,1996,23,1,2,80,37,2134,290,604,0.48,32,108,0.296,258,496,0.52,0.507,191,277,0.69,46,214,260,495,53,39,234,229
3484,12,2006,33,1,2,26,23,747,110,239,0.46,28,57,0.491,82,182,0.451,0.519,82,101,0.812,13,69,82,68,10,3,50,55
3493,1,2005,23,1,2,78,19,1659,161,373,0.432,1,4,0.25,160,369,0.434,0.433,74,110,0.673,59,151,210,109,51,22,54,165
3493,2,2006,24,1,2,67,45,1515,130,308,0.422,0,7,0,130,301,0.432,0.422,57,75,0.76,38,132,170,79,51,16,47,155
3493,3,2007,25,1,2,81,43,1700,177,379,0.467,2,10,0.2,175,369,0.474,0.47,68,87,0.782,60,130,190,86,70,32,33,179
3493,4,2008,26,1,2,76,44,1505,131,335,0.391,9,21,0.429,122,314,0.389,0.404,40,60,0.667,54,118,172,88,43,33,29,132
3493,6,2010,28,1,2,25,0,261,17,55,0.309,1,8,0.125,16,47,0.34,0.318,3,6,0.5,6,16,22,5,6,2,8,35
3495,1,2013,21,1,2,73,2,1239,186,457,0.407,65,196,0.332,121,261,0.464,0.478,30,42,0.714,35,109,144,53,43,14,48,122
3495,2,2014,22,1,2,81,62,2159,318,751,0.423,161,408,0.395,157,343,0.458,0.531,82,98,0.837,43,209,252,79,64,27,88,183
3510,3,1992,29,1,2,65,0,538,75,188,0.399,11,47,0.234,64,141,0.454,0.428,32,42,0.762,15,39,54,109,15,1,49,64
3516,9,2002,31,1,2,66,40,1998,222,584,0.38,77,226,0.341,145,358,0.405,0.446,115,140,0.821,79,216,295,136,64,19,110,205
3518,1,2009,23,1,2,75,19,1803,243,575,0.423,78,209,0.373,165,366,0.451,0.49,46,66,0.697,34,199,233,66,38,37,75,128
3518,2,2010,24,1,2,82,64,2491,297,702,0.423,124,302,0.411,173,400,0.433,0.511,56,89,0.629,41,305,346,112,56,65,93,159
3518,3,2011,25,1,2,67,21,1754,217,515,0.421,93,223,0.417,124,292,0.425,0.512,80,106,0.755,33,184,217,62,41,35,69,107
3518,5,2014,28,1,2,38,0,418,30,90,0.333,16,47,0.34,14,43,0.326,0.422,3,5,0.6,5,39,44,24,5,9,20,31
3529,8,2012,29,1,2,59,0,1080,146,332,0.44,17,59,0.288,129,273,0.473,0.465,39,55,0.709,26,76,102,227,37,1,77,69
3529,9,2013,30,1,2,39,0,719,113,238,0.475,13,49,0.265,100,189,0.529,0.502,24,33,0.727,17,61,78,138,16,2,53,39
3529,9,2013,30,1,2,66,9,1457,210,476,0.441,34,102,0.333,176,374,0.471,0.477,84,103,0.816,34,107,141,302,41,3,108,90
3529,10,2014,31,1,2,31,12,588,68,160,0.425,17,40,0.425,51,120,0.425,0.478,20,24,0.833,10,47,57,110,22,3,42,46
3529,10,2014,31,1,2,41,12,643,78,178,0.438,19,42,0.452,59,136,0.434,0.492,25,30,0.833,10,49,59,116,23,4,47,50
3531,1,1989,26,1,2,9,0,144,26,63,0.413,1,5,0.2,25,58,0.431,0.421,4,6,0.667,4,9,13,20,7,0,13,18
3531,1,1989,26,1,2,23,0,473,73,149,0.49,2,10,0.2,71,139,0.511,0.497,14,20,0.7,6,30,36,97,19,3,42,62
3531,1,1989,26,1,2,32,0,617,99,212,0.467,3,15,0.2,96,197,0.487,0.474,18,26,0.692,10,39,49,117,26,3,55,80
3531,2,1990,27,1,2,14,0,131,12,39,0.308,2,5,0.4,10,34,0.294,0.333,4,6,0.667,3,10,13,28,2,1,12,19
3531,2,1990,27,1,2,23,0,252,51,104,0.49,2,9,0.222,49,95,0.516,0.5,24,31,0.774,6,22,28,26,25,0,15,34
3531,2,1990,27,1,2,40,0,387,64,146,0.438,4,15,0.267,60,131,0.458,0.452,28,37,0.757,9,32,41,54,27,1,27,53
3531,3,1991,28,1,2,48,1,514,104,231,0.45,7,29,0.241,97,202,0.48,0.465,55,64,0.859,20,35,55,86,28,5,39,77
3548,1,2003,21,1,2,59,39,1381,168,428,0.393,21,78,0.269,147,350,0.42,0.417,49,62,0.79,36,126,162,130,57,33,81,145
3556,1,2008,22,1,2,75,2,1158,210,478,0.439,40,100,0.4,170,378,0.45,0.481,101,124,0.815,23,92,115,63,35,7,94,130
3556,2,2009,23,1,2,82,5,1837,336,756,0.444,56,164,0.341,280,592,0.473,0.481,164,193,0.85,31,119,150,95,39,20,92,140
3556,3,2010,24,1,2,74,23,1421,233,558,0.418,69,170,0.406,164,388,0.423,0.479,104,130,0.8,20,82,102,48,28,8,56,147
3556,4,2011,25,1,2,64,40,2034,412,935,0.441,105,271,0.387,307,664,0.462,0.497,186,228,0.816,26,148,174,75,45,17,90,144
3556,5,2012,26,1,2,22,3,518,76,193,0.394,30,85,0.353,46,108,0.426,0.472,32,39,0.821,11,25,36,10,14,6,24,51
3556,5,2012,26,1,2,40,32,1211,240,591,0.406,73,197,0.371,167,394,0.424,0.468,112,130,0.862,20,77,97,46,30,11,59,90
3556,5,2012,26,1,2,62,35,1729,316,784,0.403,103,282,0.365,213,502,0.424,0.469,144,169,0.852,31,102,133,56,44,17,83,141
3556,6,2013,27,1,2,59,17,1411,224,542,0.413,75,210,0.357,149,332,0.449,0.482,105,128,0.82,24,106,130,84,36,14,50,84
3556,7,2014,28,1,2,64,9,1810,387,889,0.435,135,350,0.386,252,539,0.468,0.511,235,285,0.825,29,137,166,95,46,12,95,156
3558,4,2013,27,1,2,56,3,693,58,148,0.392,16,52,0.308,42,96,0.438,0.446,23,43,0.535,26,97,123,42,15,8,33,62
